State,County,Year,AgeGroup_Zero,Population,Total_male,Total_female,male_percentage
AL,Autauga ,2015,0,54864,26728,28136,48.71682706
AL,Autauga ,2016,0,55243,26970,28273,48.82066506
AL,Autauga ,2017,0,55390,27010,28380,48.76331468
AL,Autauga ,2018,0,55533,27006,28527,48.630544
AL,Autauga ,2019,0,55869,27092,28777,48.49200809
AL,Baldwin ,2015,0,202939,98892,104047,48.72991392
AL,Baldwin ,2016,0,207601,100969,106632,48.63608557
AL,Baldwin ,2017,0,212521,103218,109303,48.56837677
AL,Baldwin ,2018,0,217855,105702,112153,48.51942806
AL,Baldwin ,2019,0,223234,108247,114987,48.49037333
AL,Barbour ,2015,0,26283,13971,12312,53.15603242
AL,Barbour ,2016,0,25806,13626,12180,52.80167403
AL,Barbour ,2017,0,25157,13230,11927,52.58973646
AL,Barbour ,2018,0,24872,13148,11724,52.8626568
AL,Barbour ,2019,0,24686,13064,11622,52.92068379
AL,Bibb ,2015,0,22566,12109,10457,53.66037401
AL,Bibb ,2016,0,22586,12070,10516,53.44018418
AL,Bibb ,2017,0,22550,12056,10494,53.46341463
AL,Bibb ,2018,0,22367,11900,10467,53.20337998
AL,Bibb ,2019,0,22394,11929,10465,53.2687327
AL,Blount ,2015,0,57526,28348,29178,49.27858707
AL,Blount ,2016,0,57494,28287,29207,49.19991651
AL,Blount ,2017,0,57787,28449,29338,49.23079585
AL,Blount ,2018,0,57771,28435,29336,49.22019698
AL,Blount ,2019,0,57826,28472,29354,49.23736727
AL,Bullock ,2015,0,10400,5642,4758,54.25
AL,Bullock ,2016,0,10389,5653,4736,54.41332178
AL,Bullock ,2017,0,10176,5514,4662,54.18632075
AL,Bullock ,2018,0,10174,5535,4639,54.40338117
AL,Bullock ,2019,0,10101,5508,4593,54.52925453
AL,Butler ,2015,0,20162,9396,10766,46.60251959
AL,Butler ,2016,0,20012,9310,10702,46.52208675
AL,Butler ,2017,0,19888,9289,10599,46.70655672
AL,Butler ,2018,0,19631,9140,10491,46.5590138
AL,Butler ,2019,0,19448,9024,10424,46.40065817
AL,Calhoun ,2015,0,115469,55532,59937,48.09256164
AL,Calhoun ,2016,0,114973,55284,59689,48.08433284
AL,Calhoun ,2017,0,114710,55146,59564,48.07427426
AL,Calhoun ,2018,0,114331,54941,59390,48.05433347
AL,Calhoun ,2019,0,113605,54481,59124,47.956516
AL,Chambers ,2015,0,33996,16352,17644,48.09977644
AL,Chambers ,2016,0,33745,16183,17562,47.95673433
AL,Chambers ,2017,0,33707,16152,17555,47.91882992
AL,Chambers ,2018,0,33600,16087,17513,47.87797619
AL,Chambers ,2019,0,33254,15895,17359,47.79876105
AL,Cherokee ,2015,0,25732,12793,12939,49.71630654
AL,Cherokee ,2016,0,25768,12790,12978,49.63520646
AL,Cherokee ,2017,0,25805,12821,12984,49.68416973
AL,Cherokee ,2018,0,26014,12879,13135,49.50795725
AL,Cherokee ,2019,0,26196,12926,13270,49.34341121
AL,Chilton ,2015,0,43700,21534,22166,49.27688787
AL,Chilton ,2016,0,43866,21537,22329,49.09725072
AL,Chilton ,2017,0,44120,21700,22420,49.18404352
AL,Chilton ,2018,0,44163,21684,22479,49.09992528
AL,Chilton ,2019,0,44428,21800,22628,49.06815522
AL,Choctaw ,2015,0,13231,6293,6938,47.56254251
AL,Choctaw ,2016,0,13045,6204,6841,47.55845151
AL,Choctaw ,2017,0,12925,6131,6794,47.43520309
AL,Choctaw ,2018,0,12833,6067,6766,47.27655264
AL,Choctaw ,2019,0,12589,5938,6651,47.16816268
AL,Clarke ,2015,0,24698,11672,13026,47.25888736
AL,Clarke ,2016,0,24340,11509,12831,47.28430567
AL,Clarke ,2017,0,24063,11345,12718,47.14707227
AL,Clarke ,2018,0,23918,11313,12605,47.29910528
AL,Clarke ,2019,0,23622,11153,12469,47.2144611
AL,Clay ,2015,0,13415,6599,6816,49.19120388
AL,Clay ,2016,0,13393,6558,6835,48.9658777
AL,Clay ,2017,0,13350,6537,6813,48.96629213
AL,Clay ,2018,0,13294,6486,6808,48.78892734
AL,Clay ,2019,0,13235,6447,6788,48.71174915
AL,Cleburne ,2015,0,14914,7361,7553,49.35630951
AL,Cleburne ,2016,0,14848,7376,7472,49.67672414
AL,Cleburne ,2017,0,14899,7365,7534,49.43284784
AL,Cleburne ,2018,0,15010,7410,7600,49.36708861
AL,Cleburne ,2019,0,14910,7340,7570,49.22870557
AL,Coffee ,2015,0,50963,25280,25683,49.60461511
AL,Coffee ,2016,0,51202,25263,25939,49.33986954
AL,Coffee ,2017,0,51853,25525,26328,49.22569572
AL,Coffee ,2018,0,51950,25525,26425,49.13378248
AL,Coffee ,2019,0,52342,25742,26600,49.18039051
AL,Colbert ,2015,0,54417,26104,28313,47.9703034
AL,Colbert ,2016,0,54497,26226,28271,48.12374993
AL,Colbert ,2017,0,54695,26217,28478,47.93308346
AL,Colbert ,2018,0,55004,26331,28673,47.87106392
AL,Colbert ,2019,0,55241,26408,28833,47.80507232
AL,Conecuh ,2015,0,12678,6097,6581,48.09118157
AL,Conecuh ,2016,0,12500,5987,6513,47.896
AL,Conecuh ,2017,0,12431,5954,6477,47.89638806
AL,Conecuh ,2018,0,12292,5877,6415,47.81158477
AL,Conecuh ,2019,0,12067,5758,6309,47.7169139
AL,Coosa ,2015,0,10934,5495,5439,50.25608195
AL,Coosa ,2016,0,10819,5471,5348,50.5684444
AL,Coosa ,2017,0,10724,5369,5355,50.06527415
AL,Coosa ,2018,0,10643,5333,5310,50.10805224
AL,Coosa ,2019,0,10663,5335,5328,50.03282378
AL,Covington ,2015,0,37556,18116,19440,48.23729897
AL,Covington ,2016,0,37382,18040,19342,48.25852014
AL,Covington ,2017,0,37062,17865,19197,48.20301117
AL,Covington ,2018,0,36953,17874,19079,48.36955051
AL,Covington ,2019,0,37049,17927,19122,48.38727091
AL,Crenshaw ,2015,0,13850,6764,7086,48.83754513
AL,Crenshaw ,2016,0,13916,6773,7143,48.670595
AL,Crenshaw ,2017,0,13858,6694,7164,48.3042286
AL,Crenshaw ,2018,0,13825,6665,7160,48.20976492
AL,Crenshaw ,2019,0,13772,6685,7087,48.54051699
AL,Cullman ,2015,0,81761,40432,41329,49.45144996
AL,Cullman ,2016,0,82450,40709,41741,49.37416616
AL,Cullman ,2017,0,82867,40936,41931,49.39964039
AL,Cullman ,2018,0,83418,41225,42193,49.41978949
AL,Cullman ,2019,0,83768,41408,42360,49.43176392
AL,Dale ,2015,0,49365,24368,24997,49.36290894
AL,Dale ,2016,0,49362,24368,24994,49.365909
AL,Dale ,2017,0,49342,24342,25000,49.33322524
AL,Dale ,2018,0,49143,24156,24987,49.15450827
AL,Dale ,2019,0,49172,24214,24958,49.24347189
AL,Dallas ,2015,0,40936,18900,22036,46.16963064
AL,Dallas ,2016,0,40080,18507,21573,46.1751497
AL,Dallas ,2017,0,39238,18120,21118,46.17972374
AL,Dallas ,2018,0,38294,17691,20603,46.19783778
AL,Dallas ,2019,0,37196,17178,20018,46.1823852
AL,DeKalb ,2015,0,71087,35200,35887,49.51678929
AL,DeKalb ,2016,0,71104,35246,35858,49.56964446
AL,DeKalb ,2017,0,71437,35486,35951,49.6745384
AL,DeKalb ,2018,0,71407,35455,35952,49.6519949
AL,DeKalb ,2019,0,71513,35577,35936,49.74899669
AL,Elmore ,2015,0,80872,39202,41670,48.47413196
AL,Elmore ,2016,0,81204,39366,41838,48.47790749
AL,Elmore ,2017,0,81422,39433,41989,48.43039965
AL,Elmore ,2018,0,81011,39083,41928,48.24406562
AL,Elmore ,2019,0,81209,39236,41973,48.31484195
AL,Escambia ,2015,0,37661,19340,18321,51.35285839
AL,Escambia ,2016,0,37475,19308,18167,51.52234823
AL,Escambia ,2017,0,36993,18749,18244,50.68256157
AL,Escambia ,2018,0,36524,18407,18117,50.39699923
AL,Escambia ,2019,0,36633,18425,18208,50.29618104
AL,Etowah ,2015,0,102998,49781,53217,48.33200645
AL,Etowah ,2016,0,102855,49743,53112,48.36225755
AL,Etowah ,2017,0,103007,49812,53195,48.35787859
AL,Etowah ,2018,0,102611,49677,52934,48.41293818
AL,Etowah ,2019,0,102268,49496,52772,48.39832597
AL,Fayette ,2015,0,16696,8255,8441,49.44298035
AL,Fayette ,2016,0,16563,8168,8395,49.31473767
AL,Fayette ,2017,0,16466,8047,8419,48.87039961
AL,Fayette ,2018,0,16445,8016,8429,48.74429918
AL,Fayette ,2019,0,16302,7937,8365,48.68727763
AL,Franklin ,2015,0,31515,15826,15689,50.21735681
AL,Franklin ,2016,0,31611,15831,15780,50.08066812
AL,Franklin ,2017,0,31542,15826,15716,50.17437068
AL,Franklin ,2018,0,31298,15745,15553,50.30672886
AL,Franklin ,2019,0,31362,15782,15580,50.32204579
AL,Geneva ,2015,0,26631,13056,13575,49.0255717
AL,Geneva ,2016,0,26494,12942,13552,48.84879595
AL,Geneva ,2017,0,26385,12874,13511,48.79287474
AL,Geneva ,2018,0,26306,12839,13467,48.80635596
AL,Geneva ,2019,0,26271,12827,13444,48.82570134
AL,Greene ,2015,0,8508,4016,4492,47.20263282
AL,Greene ,2016,0,8482,4016,4466,47.34732374
AL,Greene ,2017,0,8310,3937,4373,47.37665463
AL,Greene ,2018,0,8209,3878,4331,47.24083323
AL,Greene ,2019,0,8111,3829,4282,47.20749599
AL,Hale ,2015,0,15015,7094,7921,47.24608725
AL,Hale ,2016,0,14828,6996,7832,47.1810089
AL,Hale ,2017,0,14801,7026,7775,47.46976556
AL,Hale ,2018,0,14749,7008,7741,47.51508577
AL,Hale ,2019,0,14651,6950,7701,47.43703501
AL,Henry ,2015,0,17101,8283,8818,48.43576399
AL,Henry ,2016,0,17072,8278,8794,48.48875351
AL,Henry ,2017,0,17115,8295,8820,48.46625767
AL,Henry ,2018,0,17173,8301,8872,48.33750655
AL,Henry ,2019,0,17205,8309,8896,48.29410055
AL,Houston ,2015,0,104260,50037,54223,47.9925187
AL,Houston ,2016,0,104218,50012,54206,47.98787158
AL,Houston ,2017,0,104378,50115,54263,48.01299124
AL,Houston ,2018,0,104770,50328,54442,48.03665171
AL,Houston ,2019,0,105882,50628,55254,47.81549272
AL,Jackson ,2015,0,52195,25682,26513,49.20394674
AL,Jackson ,2016,0,51988,25589,26399,49.22097407
AL,Jackson ,2017,0,51828,25450,26378,49.10473103
AL,Jackson ,2018,0,51621,25335,26286,49.07886325
AL,Jackson ,2019,0,51626,25367,26259,49.13609422
AL,Jefferson ,2015,0,660455,312541,347914,47.32207342
AL,Jefferson ,2016,0,660343,312797,347546,47.36886739
AL,Jefferson ,2017,0,659599,311867,347732,47.28130273
AL,Jefferson ,2018,0,659429,311656,347773,47.26149441
AL,Jefferson ,2019,0,658573,311232,347341,47.25854233
AL,Lamar ,2015,0,13927,6819,7108,48.96244705
AL,Lamar ,2016,0,13928,6796,7132,48.79379667
AL,Lamar ,2017,0,13882,6777,7105,48.81861403
AL,Lamar ,2018,0,13882,6781,7101,48.84742832
AL,Lamar ,2019,0,13805,6760,7045,48.9677653
AL,Lauderdale ,2015,0,92459,44237,48222,47.84499075
AL,Lauderdale ,2016,0,92425,44204,48221,47.82688666
AL,Lauderdale ,2017,0,92564,44338,48226,47.89983147
AL,Lauderdale ,2018,0,92604,44465,48139,48.01628439
AL,Lauderdale ,2019,0,92729,44490,48239,47.97851805
AL,Lawrence ,2015,0,33135,16139,16996,48.70680549
AL,Lawrence ,2016,0,33227,16204,17023,48.76756854
AL,Lawrence ,2017,0,33063,16121,16942,48.75843087
AL,Lawrence ,2018,0,32941,16053,16888,48.7325825
AL,Lawrence ,2019,0,32924,16034,16890,48.70003645
AL,Lee ,2015,0,156954,77512,79442,49.38517018
AL,Lee ,2016,0,159168,78469,80699,49.29948231
AL,Lee ,2017,0,161440,79543,81897,49.27093657
AL,Lee ,2018,0,163656,80429,83227,49.14515814
AL,Lee ,2019,0,164542,80840,83702,49.13031323
AL,Limestone ,2015,0,91565,45876,45689,50.10211325
AL,Limestone ,2016,0,92847,46496,46351,50.07808545
AL,Limestone ,2017,0,94130,47118,47012,50.05630511
AL,Limestone ,2018,0,96177,48099,48078,50.01091737
AL,Limestone ,2019,0,98915,49444,49471,49.98635192
AL,Lowndes ,2015,0,10350,4910,5440,47.43961353
AL,Lowndes ,2016,0,10248,4846,5402,47.28727557
AL,Lowndes ,2017,0,10097,4768,5329,47.22194711
AL,Lowndes ,2018,0,9974,4678,5296,46.90194506
AL,Lowndes ,2019,0,9726,4570,5156,46.9874563
AL,Macon ,2015,0,19296,8874,10422,45.98880597
AL,Macon ,2016,0,19060,8710,10350,45.69779643
AL,Macon ,2017,0,18793,8604,10189,45.78300431
AL,Macon ,2018,0,18321,8347,9974,45.55974019
AL,Macon ,2019,0,18068,8218,9850,45.48372814
AL,Madison ,2015,0,352977,172493,180484,48.86805656
AL,Madison ,2016,0,356729,174200,182529,48.8325872
AL,Madison ,2017,0,361762,176697,185065,48.8434385
AL,Madison ,2018,0,367004,179277,187727,48.84878639
AL,Madison ,2019,0,372909,182366,190543,48.90361992
AL,Marengo ,2015,0,19766,9342,10424,47.26297683
AL,Marengo ,2016,0,19525,9219,10306,47.21638924
AL,Marengo ,2017,0,19396,9123,10273,47.03547123
AL,Marengo ,2018,0,19056,8956,10100,46.99832074
AL,Marengo ,2019,0,18863,8839,10024,46.85893018
AL,Marion ,2015,0,30119,14961,15158,49.67296391
AL,Marion ,2016,0,29960,14835,15125,49.51602136
AL,Marion ,2017,0,29792,14734,15058,49.45622986
AL,Marion ,2018,0,29750,14676,15074,49.33109244
AL,Marion ,2019,0,29709,14626,15083,49.2308728
AL,Marshall ,2015,0,94585,46561,48024,49.22662156
AL,Marshall ,2016,0,95113,46863,48250,49.27086728
AL,Marshall ,2017,0,95572,47089,48483,49.2707069
AL,Marshall ,2018,0,96170,47474,48696,49.36466674
AL,Marshall ,2019,0,96774,47717,49057,49.30766528
AL,Mobile ,2015,0,414462,198021,216441,47.77784212
AL,Mobile ,2016,0,414945,198101,216844,47.74150791
AL,Mobile ,2017,0,414045,197453,216592,47.68877779
AL,Mobile ,2018,0,413908,197039,216869,47.60454014
AL,Mobile ,2019,0,413210,196374,216836,47.52401926
AL,Monroe ,2015,0,21717,10381,11336,47.80126168
AL,Monroe ,2016,0,21548,10305,11243,47.82346389
AL,Monroe ,2017,0,21290,10151,11139,47.67966181
AL,Monroe ,2018,0,21062,10020,11042,47.57382965
AL,Monroe ,2019,0,20733,9869,10864,47.60044374
AL,Montgomery ,2015,0,227279,107658,119621,47.36821264
AL,Montgomery ,2016,0,227170,107437,119733,47.29365673
AL,Montgomery ,2017,0,227265,107170,120095,47.15640332
AL,Montgomery ,2018,0,226504,106731,119773,47.12102215
AL,Montgomery ,2019,0,226486,106394,120092,46.97597202
AL,Morgan ,2015,0,119257,58769,60488,49.27928759
AL,Morgan ,2016,0,119006,58586,60420,49.22945062
AL,Morgan ,2017,0,118918,58528,60390,49.21710759
AL,Morgan ,2018,0,119203,58713,60490,49.25463285
AL,Morgan ,2019,0,119679,58888,60791,49.20495659
AL,Perry ,2015,0,9640,4550,5090,47.19917012
AL,Perry ,2016,0,9532,4501,5031,47.21989089
AL,Perry ,2017,0,9302,4338,4964,46.63513223
AL,Perry ,2018,0,9070,4228,4842,46.61521499
AL,Perry ,2019,0,8923,4152,4771,46.53143562
AL,Pickens ,2015,0,20776,10476,10300,50.42356565
AL,Pickens ,2016,0,20325,10139,10186,49.88437884
AL,Pickens ,2017,0,20204,10089,10115,49.93565631
AL,Pickens ,2018,0,19980,9986,9994,49.97997998
AL,Pickens ,2019,0,19930,10014,9916,50.24586051
AL,Pike ,2015,0,33496,16080,17416,48.00573203
AL,Pike ,2016,0,33464,16094,17370,48.09347358
AL,Pike ,2017,0,33349,16093,17256,48.25631953
AL,Pike ,2018,0,33242,16031,17211,48.22513688
AL,Pike ,2019,0,33114,15919,17195,48.07332246
AL,Randolph ,2015,0,22594,10928,11666,48.36682305
AL,Randolph ,2016,0,22504,10912,11592,48.48915748
AL,Randolph ,2017,0,22687,11046,11641,48.68867633
AL,Randolph ,2018,0,22727,11087,11640,48.7833854
AL,Randolph ,2019,0,22722,11078,11644,48.75451105
AL,Russell ,2015,0,58844,28645,30199,48.67955951
AL,Russell ,2016,0,58185,28154,30031,48.38704133
AL,Russell ,2017,0,56985,27423,29562,48.12319031
AL,Russell ,2018,0,57784,27735,30049,47.99771563
AL,Russell ,2019,0,57961,27767,30194,47.90635082
AL,St. Clair ,2015,0,86546,43265,43281,49.99075636
AL,St. Clair ,2016,0,87306,43493,43813,49.81673654
AL,St. Clair ,2017,0,87926,43654,44272,49.64856811
AL,St. Clair ,2018,0,88654,44006,44648,49.6379182
AL,St. Clair ,2019,0,89512,44352,45160,49.54866387
AL,Shelby ,2015,0,208959,101366,107593,48.50999478
AL,Shelby ,2016,0,211282,102227,109055,48.38415009
AL,Shelby ,2017,0,213633,103308,110325,48.35769755
AL,Shelby ,2018,0,215583,104172,111411,48.32106428
AL,Shelby ,2019,0,217702,105203,112499,48.32431489
AL,Sumter ,2015,0,13206,6011,7195,45.51718916
AL,Sumter ,2016,0,12967,5925,7042,45.69291278
AL,Sumter ,2017,0,12749,5830,6919,45.72907679
AL,Sumter ,2018,0,12634,5766,6868,45.63875257
AL,Sumter ,2019,0,12427,5684,6743,45.73911644
AL,Talladega ,2015,0,81128,39260,41868,48.39266345
AL,Talladega ,2016,0,80552,38993,41559,48.40724004
AL,Talladega ,2017,0,80142,38742,41400,48.34169349
AL,Talladega ,2018,0,80137,38489,41648,48.02900034
AL,Talladega ,2019,0,79978,38479,41499,48.11198079
AL,Tallapoosa ,2015,0,40605,19739,20866,48.61223987
AL,Tallapoosa ,2016,0,40586,19746,20840,48.65224462
AL,Tallapoosa ,2017,0,40613,19774,20839,48.68884347
AL,Tallapoosa ,2018,0,40535,19691,20844,48.5777723
AL,Tallapoosa ,2019,0,40367,19562,20805,48.46037605
AL,Tuscaloosa ,2015,0,204767,98829,105938,48.26412459
AL,Tuscaloosa ,2016,0,206464,99549,106915,48.21615391
AL,Tuscaloosa ,2017,0,207618,100121,107497,48.22366076
AL,Tuscaloosa ,2018,0,208319,100406,107913,48.19819604
AL,Tuscaloosa ,2019,0,209355,100780,108575,48.13832963
AL,Walker ,2015,0,64931,31632,33299,48.71632964
AL,Walker ,2016,0,64533,31522,33011,48.84632669
AL,Walker ,2017,0,63895,31223,32672,48.86610846
AL,Walker ,2018,0,63669,31062,32607,48.78669368
AL,Walker ,2019,0,63521,30982,32539,48.77442106
AL,Washington ,2015,0,16832,8215,8617,48.80584601
AL,Washington ,2016,0,16621,8161,8460,49.10053547
AL,Washington ,2017,0,16522,8114,8408,49.11027721
AL,Washington ,2018,0,16402,8077,8325,49.24399463
AL,Washington ,2019,0,16326,8001,8325,49.00771775
AL,Wilcox ,2015,0,10896,5188,5708,47.61380323
AL,Wilcox ,2016,0,10844,5145,5699,47.44559203
AL,Wilcox ,2017,0,10691,5085,5606,47.56337106
AL,Wilcox ,2018,0,10599,5030,5569,47.45730729
AL,Wilcox ,2019,0,10373,4922,5451,47.45011086
AL,Winston ,2015,0,23930,11806,12124,49.33556206
AL,Winston ,2016,0,23907,11805,12102,49.37884302
AL,Winston ,2017,0,23760,11727,12033,49.35606061
AL,Winston ,2018,0,23693,11678,12015,49.28881948
AL,Winston ,2019,0,23629,11627,12002,49.20648356
AK,Aleutians East,2015,0,3373,2271,1102,67.32878743
AK,Aleutians East,2016,0,3363,2268,1095,67.43978591
AK,Aleutians East,2017,0,3455,2345,1110,67.87264834
AK,Aleutians East,2018,0,3395,2297,1098,67.65832106
AK,Aleutians East,2019,0,3337,2253,1084,67.51573269
AK,Aleutians West,2015,0,5781,3847,1934,66.54558035
AK,Aleutians West,2016,0,5705,3778,1927,66.22261174
AK,Aleutians West,2017,0,5729,3795,1934,66.24192704
AK,Aleutians West,2018,0,5640,3716,1924,65.88652482
AK,Aleutians West,2019,0,5634,3716,1918,65.95669152
AK,Anchorage,2015,0,297547,151980,145567,51.07764488
AK,Anchorage,2016,0,297249,151591,145658,50.99798485
AK,Anchorage,2017,0,294338,149817,144521,50.89964599
AK,Anchorage,2018,0,290521,147758,142763,50.85966247
AK,Anchorage,2019,0,288000,146468,141532,50.85694444
AK,Bethel,2015,0,17955,9304,8651,51.81843498
AK,Bethel,2016,0,18022,9341,8681,51.83109533
AK,Bethel,2017,0,18090,9369,8721,51.79104478
AK,Bethel,2018,0,18219,9399,8820,51.58900049
AK,Bethel,2019,0,18386,9485,8901,51.58816491
AK,Bristol Bay,2015,0,904,485,419,53.65044248
AK,Bristol Bay,2016,0,902,486,416,53.88026608
AK,Bristol Bay,2017,0,869,463,406,53.27963176
AK,Bristol Bay,2018,0,880,464,416,52.72727273
AK,Bristol Bay,2019,0,836,438,398,52.3923445
AK,Denali,2015,0,1933,1071,862,55.4061045
AK,Denali,2016,0,2055,1160,895,56.44768856
AK,Denali,2017,0,2084,1175,909,56.38195777
AK,Denali,2018,0,2032,1149,883,56.54527559
AK,Denali,2019,0,2097,1173,924,55.93705293
AK,Dillingham,2015,0,4988,2546,2442,51.042502
AK,Dillingham,2016,0,4970,2522,2448,50.7444668
AK,Dillingham,2017,0,4940,2500,2440,50.60728745
AK,Dillingham,2018,0,4991,2529,2462,50.67120817
AK,Dillingham,2019,0,4916,2493,2423,50.71196094
AK,Fairbanks North Star,2015,0,99636,53904,45732,54.10092738
AK,Fairbanks North Star,2016,0,100633,54573,46060,54.22972584
AK,Fairbanks North Star,2017,0,99675,53908,45767,54.08377226
AK,Fairbanks North Star,2018,0,98565,53144,45421,53.91771927
AK,Fairbanks North Star,2019,0,96849,52095,44754,53.78992039
AK,Haines,2015,0,2516,1237,1279,49.16534181
AK,Haines,2016,0,2531,1236,1295,48.83445279
AK,Haines,2017,0,2524,1227,1297,48.6133122
AK,Haines,2018,0,2488,1223,1265,49.15594855
AK,Haines,2019,0,2530,1261,1269,49.84189723
AK,Hoonah-Angoon,2015,0,2132,1122,1010,52.62664165
AK,Hoonah-Angoon,2016,0,2121,1115,1006,52.56954267
AK,Hoonah-Angoon,2017,0,2139,1137,1002,53.15568022
AK,Hoonah-Angoon,2018,0,2155,1149,1006,53.31786543
AK,Hoonah-Angoon,2019,0,2148,1143,1005,53.2122905
AK,Juneau City,2015,0,32615,16623,15992,50.96734631
AK,Juneau City,2016,0,32412,16538,15874,51.02431198
AK,Juneau City,2017,0,32098,16360,15738,50.96890772
AK,Juneau City,2018,0,32037,16307,15730,50.90052127
AK,Juneau City,2019,0,31974,16263,15711,50.86320135
AK,Kenai Peninsula,2015,0,58034,30397,27637,52.37791639
AK,Kenai Peninsula,2016,0,58458,30563,27895,52.28198023
AK,Kenai Peninsula,2017,0,58558,30540,28018,52.15342054
AK,Kenai Peninsula,2018,0,58561,30558,28003,52.18148597
AK,Kenai Peninsula,2019,0,58708,30623,28085,52.16154527
AK,Ketchikan Gateway,2015,0,13702,7050,6652,51.45234272
AK,Ketchikan Gateway,2016,0,13707,7051,6656,51.44086963
AK,Ketchikan Gateway,2017,0,13834,7091,6743,51.25777071
AK,Ketchikan Gateway,2018,0,13856,7084,6772,51.12586605
AK,Ketchikan Gateway,2019,0,13901,7108,6793,51.13301201
AK,Kodiak Island,2015,0,13767,7324,6443,53.1996804
AK,Kodiak Island,2016,0,13728,7268,6460,52.94289044
AK,Kodiak Island,2017,0,13512,7143,6369,52.86412078
AK,Kodiak Island,2018,0,13250,7021,6229,52.98867925
AK,Kodiak Island,2019,0,12998,6898,6100,53.06970303
AK,Kusilvak,2015,0,8194,4298,3896,52.4530144
AK,Kusilvak,2016,0,8181,4307,3874,52.64637575
AK,Kusilvak,2017,0,8236,4334,3902,52.62263235
AK,Kusilvak,2018,0,8323,4392,3931,52.7694341
AK,Kusilvak,2019,0,8314,4378,3936,52.65816695
AK,Lake Peninsula,2015,0,1595,825,770,51.72413793
AK,Lake Peninsula,2016,0,1600,818,782,51.125
AK,Lake Peninsula,2017,0,1612,835,777,51.79900744
AK,Lake Peninsula,2018,0,1596,817,779,51.19047619
AK,Lake Peninsula,2019,0,1592,813,779,51.0678392
AK,Matanuska-Susitna,2015,0,101062,52922,48140,52.36587441
AK,Matanuska-Susitna,2016,0,104119,54387,49732,52.23542293
AK,Matanuska-Susitna,2017,0,106232,55234,50998,51.99374953
AK,Matanuska-Susitna,2018,0,107115,55614,51501,51.91989917
AK,Matanuska-Susitna,2019,0,108317,56208,52109,51.89213143
AK,Nome,2015,0,9893,5239,4654,52.95663601
AK,Nome,2016,0,9966,5256,4710,52.73931367
AK,Nome,2017,0,10025,5302,4723,52.88778055
AK,Nome,2018,0,10053,5310,4743,52.82005372
AK,Nome,2019,0,10004,5267,4737,52.64894042
AK,North Slope,2015,0,9788,6064,3724,61.95341234
AK,North Slope,2016,0,9694,6054,3640,62.45100062
AK,North Slope,2017,0,9795,6076,3719,62.0316488
AK,North Slope,2018,0,9850,6110,3740,62.03045685
AK,North Slope,2019,0,9832,6131,3701,62.35760781
AK,Northwest Arctic,2015,0,7772,4185,3587,53.84714359
AK,Northwest Arctic,2016,0,7691,4159,3532,54.07619295
AK,Northwest Arctic,2017,0,7795,4199,3596,53.86786402
AK,Northwest Arctic,2018,0,7694,4140,3554,53.8081622
AK,Northwest Arctic,2019,0,7621,4099,3522,53.78559244
AK,Petersburg,2015,0,3253,1709,1544,52.5361205
AK,Petersburg,2016,0,3260,1722,1538,52.82208589
AK,Petersburg,2017,0,3264,1719,1545,52.66544118
AK,Petersburg,2018,0,3244,1696,1548,52.2811344
AK,Petersburg,2019,0,3266,1696,1570,51.92896509
AK,Prince of Wales-Hyder,2015,0,6508,3567,2941,54.80946527
AK,Prince of Wales-Hyder,2016,0,6519,3591,2928,55.08513576
AK,Prince of Wales-Hyder,2017,0,6444,3543,2901,54.98137803
AK,Prince of Wales-Hyder,2018,0,6360,3482,2878,54.74842767
AK,Prince of Wales-Hyder,2019,0,6203,3406,2797,54.90891504
AK,Sitka City,2015,0,8778,4467,4311,50.8885851
AK,Sitka City,2016,0,8736,4449,4287,50.9271978
AK,Sitka City,2017,0,8641,4405,4236,50.97789608
AK,Sitka City,2018,0,8554,4349,4205,50.84171148
AK,Sitka City,2019,0,8493,4329,4164,50.9713882
AK,Skagway,2015,0,1088,572,516,52.57352941
AK,Skagway,2016,0,1132,595,537,52.56183746
AK,Skagway,2017,0,1167,603,564,51.67095116
AK,Skagway,2018,0,1169,615,554,52.60906758
AK,Skagway,2019,0,1183,620,563,52.40912933
AK,Southeast Fairbanks,2015,0,6812,3783,3029,55.53435115
AK,Southeast Fairbanks,2016,0,6857,3790,3067,55.27198483
AK,Southeast Fairbanks,2017,0,6892,3822,3070,55.4556007
AK,Southeast Fairbanks,2018,0,6937,3819,3118,55.0526164
AK,Southeast Fairbanks,2019,0,6893,3793,3100,55.02683882
AK,Valdez-Cordova,2015,0,9319,4914,4405,52.73097972
AK,Valdez-Cordova,2016,0,9314,4898,4416,52.58750268
AK,Valdez-Cordova,2017,0,9220,4823,4397,52.31019523
AK,Valdez-Cordova,2018,0,9161,4818,4343,52.59251173
AK,Valdez-Cordova,2019,0,9202,4879,4323,53.02108237
AK,Wrangell City,2015,0,2453,1265,1188,51.56950673
AK,Wrangell City,2016,0,2496,1294,1202,51.84294872
AK,Wrangell City,2017,0,2521,1324,1197,52.51884173
AK,Wrangell City,2018,0,2538,1322,1216,52.08825847
AK,Wrangell City,2019,0,2502,1301,1201,51.99840128
AK,Yakutat City,2015,0,635,359,276,56.53543307
AK,Yakutat City,2016,0,612,341,271,55.71895425
AK,Yakutat City,2017,0,602,332,270,55.14950166
AK,Yakutat City,2018,0,596,334,262,56.04026846
AK,Yakutat City,2019,0,579,321,258,55.44041451
AK,Yukon-Koyukuk,2015,0,5465,2910,2555,53.24794145
AK,Yukon-Koyukuk,2016,0,5423,2884,2539,53.18089618
AK,Yukon-Koyukuk,2017,0,5409,2858,2551,52.83786282
AK,Yukon-Koyukuk,2018,0,5359,2831,2528,52.82701997
AK,Yukon-Koyukuk,2019,0,5230,2760,2470,52.77246654
AZ,Apache ,2015,0,71012,35157,35855,49.50853377
AZ,Apache ,2016,0,71381,35235,36146,49.36187501
AZ,Apache ,2017,0,71545,35313,36232,49.35774687
AZ,Apache ,2018,0,71731,35284,36447,49.18933237
AZ,Apache ,2019,0,71887,35482,36405,49.35802023
AZ,Cochise ,2015,0,126454,64266,62188,50.82164265
AZ,Cochise ,2016,0,125686,64054,61632,50.96351224
AZ,Cochise ,2017,0,124864,63288,61576,50.68554587
AZ,Cochise ,2018,0,126411,64120,62291,50.72343388
AZ,Cochise ,2019,0,125922,63757,62165,50.63213735
AZ,Coconino ,2015,0,138962,68713,70249,49.44733093
AZ,Coconino ,2016,0,140407,69330,71077,49.37788002
AZ,Coconino ,2017,0,141001,69679,71322,49.41738002
AZ,Coconino ,2018,0,142523,70440,72083,49.4236018
AZ,Coconino ,2019,0,143476,70721,72755,49.29117065
AZ,Gila ,2015,0,52978,26249,26729,49.54698177
AZ,Gila ,2016,0,53356,26449,26907,49.57080741
AZ,Gila ,2017,0,53578,26513,27065,49.48486319
AZ,Gila ,2018,0,53801,26651,27150,49.53625397
AZ,Gila ,2019,0,54018,26789,27229,49.59272835
AZ,Graham ,2015,0,37860,20318,17542,53.6661384
AZ,Graham ,2016,0,37807,20250,17557,53.56150977
AZ,Graham ,2017,0,37481,19942,17539,53.20562418
AZ,Graham ,2018,0,37995,20241,17754,53.27279905
AZ,Graham ,2019,0,38837,20809,18028,53.58034864
AZ,Greenlee ,2015,0,9577,4944,4633,51.62368174
AZ,Greenlee ,2016,0,9643,4973,4670,51.57108784
AZ,Greenlee ,2017,0,9443,4876,4567,51.63613258
AZ,Greenlee ,2018,0,9448,4861,4587,51.45004234
AZ,Greenlee ,2019,0,9498,4916,4582,51.7582649
AZ,La Paz ,2015,0,20466,10538,9928,51.49027656
AZ,La Paz ,2016,0,20648,10645,10003,51.55462999
AZ,La Paz ,2017,0,20706,10634,10072,51.35709456
AZ,La Paz ,2018,0,21039,10794,10245,51.30471981
AZ,La Paz ,2019,0,21108,10820,10288,51.26018571
AZ,Maricopa ,2015,0,4172905,2064000,2108905,49.46194558
AZ,Maricopa ,2016,0,4256143,2104920,2151223,49.45604506
AZ,Maricopa ,2017,0,4327184,2140106,2187078,49.45724517
AZ,Maricopa ,2018,0,4402403,2176549,2225854,49.44002173
AZ,Maricopa ,2019,0,4485414,2217230,2268184,49.43200338
AZ,Mohave ,2015,0,204574,103162,101412,50.42771809
AZ,Mohave ,2016,0,205412,103594,101818,50.43230191
AZ,Mohave ,2017,0,207017,104483,102534,50.47073429
AZ,Mohave ,2018,0,209292,105782,103510,50.54278233
AZ,Mohave ,2019,0,212181,107347,104834,50.59218309
AZ,Navajo ,2015,0,107638,53877,53761,50.05388432
AZ,Navajo ,2016,0,108467,54357,54110,50.11385951
AZ,Navajo ,2017,0,109079,54522,54557,49.98395658
AZ,Navajo ,2018,0,110242,55148,55094,50.02449157
AZ,Navajo ,2019,0,110924,55469,55455,50.00631063
AZ,Pima ,2015,0,1009103,496781,512322,49.22995968
AZ,Pima ,2016,0,1016707,500525,516182,49.23001415
AZ,Pima ,2017,0,1026391,505056,521335,49.20697863
AZ,Pima ,2018,0,1036554,510189,526365,49.21972227
AZ,Pima ,2019,0,1047279,515596,531683,49.23196207
AZ,Pinal ,2015,0,405614,212180,193434,52.31081767
AZ,Pinal ,2016,0,417193,217219,199974,52.06678923
AZ,Pinal ,2017,0,431564,224764,206800,52.0812672
AZ,Pinal ,2018,0,446806,232802,214004,52.10359753
AZ,Pinal ,2019,0,462789,240960,221829,52.06692467
AZ,Santa Cruz ,2015,0,46542,22272,24270,47.85355163
AZ,Santa Cruz ,2016,0,46400,22280,24120,48.01724138
AZ,Santa Cruz ,2017,0,46566,22408,24158,48.12094661
AZ,Santa Cruz ,2018,0,46395,22412,23983,48.30692963
AZ,Santa Cruz ,2019,0,46498,22415,24083,48.20637447
AZ,Yavapai ,2015,0,220805,108012,112793,48.91737053
AZ,Yavapai ,2016,0,224575,109881,114694,48.92842035
AZ,Yavapai ,2017,0,228082,111571,116511,48.91705615
AZ,Yavapai ,2018,0,231772,113304,118468,48.88597415
AZ,Yavapai ,2019,0,235099,114880,120219,48.8645209
AZ,Yuma ,2015,0,205186,105345,99841,51.34122211
AZ,Yuma ,2016,0,207247,106648,100599,51.45936974
AZ,Yuma ,2017,0,209507,107719,101788,51.41546583
AZ,Yuma ,2018,0,211612,108807,102805,51.41816154
AZ,Yuma ,2019,0,213787,110106,103681,51.50266387
AR,Arkansas ,2015,0,18330,8853,9477,48.29787234
AR,Arkansas ,2016,0,18154,8749,9405,48.19323565
AR,Arkansas ,2017,0,17872,8660,9212,48.45568487
AR,Arkansas ,2018,0,17726,8557,9169,48.27372222
AR,Arkansas ,2019,0,17486,8437,9049,48.25002859
AR,Ashley ,2015,0,20838,10090,10748,48.42115366
AR,Ashley ,2016,0,20530,9958,10572,48.50462737
AR,Ashley ,2017,0,20311,9853,10458,48.51065925
AR,Ashley ,2018,0,20012,9715,10297,48.54587248
AR,Ashley ,2019,0,19657,9580,10077,48.7358193
AR,Baxter ,2015,0,41138,19824,21314,48.18902232
AR,Baxter ,2016,0,41131,19844,21287,48.24584863
AR,Baxter ,2017,0,41308,19954,21354,48.305413
AR,Baxter ,2018,0,41624,20144,21480,48.39515664
AR,Baxter ,2019,0,41932,20346,21586,48.52141563
AR,Benton ,2015,0,251591,124485,127106,49.47911491
AR,Benton ,2016,0,259212,128503,130709,49.57447958
AR,Benton ,2017,0,266585,132350,134235,49.64645423
AR,Benton ,2018,0,272266,135349,136917,49.71204631
AR,Benton ,2019,0,279141,138868,140273,49.74833507
AR,Boone ,2015,0,37119,18354,18765,49.44637517
AR,Boone ,2016,0,37259,18377,18882,49.32231139
AR,Boone ,2017,0,37459,18470,18989,49.30724259
AR,Boone ,2018,0,37385,18416,18969,49.26039856
AR,Boone ,2019,0,37432,18447,18985,49.28136354
AR,Bradley ,2015,0,10999,5357,5642,48.70442768
AR,Bradley ,2016,0,10959,5350,5609,48.81832284
AR,Bradley ,2017,0,10813,5267,5546,48.70988625
AR,Bradley ,2018,0,10838,5266,5572,48.58830042
AR,Bradley ,2019,0,10763,5271,5492,48.97333457
AR,Calhoun ,2015,0,5200,2644,2556,50.84615385
AR,Calhoun ,2016,0,5143,2603,2540,50.61248299
AR,Calhoun ,2017,0,5201,2616,2585,50.29801961
AR,Calhoun ,2018,0,5227,2648,2579,50.66003444
AR,Calhoun ,2019,0,5189,2622,2567,50.52996724
AR,Carroll ,2015,0,27755,13716,14039,49.41812286
AR,Carroll ,2016,0,27728,13731,13997,49.52034045
AR,Carroll ,2017,0,27865,13804,14061,49.53884802
AR,Carroll ,2018,0,28097,13943,14154,49.62451507
AR,Carroll ,2019,0,28380,14141,14239,49.8273432
AR,Chicot ,2015,0,10970,5443,5527,49.61713765
AR,Chicot ,2016,0,10899,5425,5474,49.77520873
AR,Chicot ,2017,0,10647,5325,5322,50.01408848
AR,Chicot ,2018,0,10442,5275,5167,50.51714231
AR,Chicot ,2019,0,10118,5097,5021,50.37556829
AR,Clark ,2015,0,22513,10688,11825,47.47479234
AR,Clark ,2016,0,22602,10750,11852,47.56216264
AR,Clark ,2017,0,22184,10539,11645,47.50721241
AR,Clark ,2018,0,22313,10577,11736,47.40285932
AR,Clark ,2019,0,22320,10598,11722,47.48207885
AR,Clay ,2015,0,15206,7440,7766,48.92805472
AR,Clay ,2016,0,15060,7371,7689,48.94422311
AR,Clay ,2017,0,14865,7242,7623,48.7184662
AR,Clay ,2018,0,14763,7207,7556,48.81799092
AR,Clay ,2019,0,14551,7102,7449,48.80764209
AR,Cleburne ,2015,0,25355,12484,12871,49.23683692
AR,Cleburne ,2016,0,25173,12412,12761,49.30679697
AR,Cleburne ,2017,0,25059,12342,12717,49.25176583
AR,Cleburne ,2018,0,24994,12314,12680,49.26782428
AR,Cleburne ,2019,0,24919,12241,12678,49.12315904
AR,Cleveland ,2015,0,8284,4081,4203,49.26364075
AR,Cleveland ,2016,0,8245,4055,4190,49.18132201
AR,Cleveland ,2017,0,8162,4031,4131,49.38740505
AR,Cleveland ,2018,0,7995,3966,4029,49.60600375
AR,Cleveland ,2019,0,7956,3938,4018,49.49723479
AR,Columbia ,2015,0,24115,11600,12515,48.10284056
AR,Columbia ,2016,0,24026,11618,12408,48.35594772
AR,Columbia ,2017,0,23695,11464,12231,48.38151509
AR,Columbia ,2018,0,23586,11385,12201,48.27016026
AR,Columbia ,2019,0,23457,11328,12129,48.29262054
AR,Conway ,2015,0,20936,10283,10653,49.1163546
AR,Conway ,2016,0,20874,10266,10608,49.18079908
AR,Conway ,2017,0,20810,10216,10594,49.0917828
AR,Conway ,2018,0,20825,10233,10592,49.13805522
AR,Conway ,2019,0,20846,10260,10586,49.21807541
AR,Craighead ,2015,0,104457,50849,53608,48.67936089
AR,Craighead ,2016,0,105932,51696,54236,48.8011177
AR,Craighead ,2017,0,107188,52156,55032,48.65843191
AR,Craighead ,2018,0,108816,52882,55934,48.5976327
AR,Craighead ,2019,0,110332,53554,56778,48.53895515
AR,Crawford ,2015,0,61904,30477,31427,49.23268286
AR,Crawford ,2016,0,62263,30723,31540,49.34391211
AR,Crawford ,2017,0,62894,31051,31843,49.37036919
AR,Crawford ,2018,0,63379,31268,32111,49.33495322
AR,Crawford ,2019,0,63257,31224,32033,49.36054508
AR,Crittenden ,2015,0,49019,23232,25787,47.39386768
AR,Crittenden ,2016,0,49306,23436,25870,47.53174056
AR,Crittenden ,2017,0,48716,23163,25553,47.54700714
AR,Crittenden ,2018,0,48363,22999,25364,47.55494903
AR,Crittenden ,2019,0,47955,22784,25171,47.51120842
AR,Cross ,2015,0,17255,8359,8896,48.4439293
AR,Cross ,2016,0,17025,8222,8803,48.29368576
AR,Cross ,2017,0,16792,8106,8686,48.27298714
AR,Cross ,2018,0,16630,8028,8602,48.27420325
AR,Cross ,2019,0,16419,7977,8442,48.58395761
AR,Dallas ,2015,0,7530,3700,3830,49.13678619
AR,Dallas ,2016,0,7399,3640,3759,49.19583728
AR,Dallas ,2017,0,7307,3600,3707,49.26782537
AR,Dallas ,2018,0,7152,3522,3630,49.24496644
AR,Dallas ,2019,0,7009,3466,3543,49.45070623
AR,Desha ,2015,0,12029,5622,6407,46.73705212
AR,Desha ,2016,0,11905,5630,6275,47.29105418
AR,Desha ,2017,0,11743,5512,6231,46.93860172
AR,Desha ,2018,0,11507,5422,6085,47.11914487
AR,Desha ,2019,0,11361,5359,6002,47.17014347
AR,Drew ,2015,0,18613,9083,9530,48.79922635
AR,Drew ,2016,0,18553,9042,9511,48.73605347
AR,Drew ,2017,0,18370,8973,9397,48.84594447
AR,Drew ,2018,0,18328,8963,9365,48.90331733
AR,Drew ,2019,0,18219,8873,9346,48.70190461
AR,Faulkner ,2015,0,121241,59311,61930,48.91991983
AR,Faulkner ,2016,0,122206,59828,62378,48.9566797
AR,Faulkner ,2017,0,123530,60410,63120,48.90310046
AR,Faulkner ,2018,0,125138,61191,63947,48.89881571
AR,Faulkner ,2019,0,126007,61487,64520,48.79649543
AR,Franklin ,2015,0,17749,8817,8932,49.67603809
AR,Franklin ,2016,0,17655,8821,8834,49.96318323
AR,Franklin ,2017,0,17809,8894,8915,49.94104105
AR,Franklin ,2018,0,17764,8866,8898,49.9099302
AR,Franklin ,2019,0,17715,8837,8878,49.88427886
AR,Fulton ,2015,0,12138,5998,6140,49.41506014
AR,Fulton ,2016,0,12099,5983,6116,49.4503678
AR,Fulton ,2017,0,12131,5963,6168,49.15505729
AR,Fulton ,2018,0,12308,6044,6264,49.10627234
AR,Fulton ,2019,0,12477,6160,6317,49.37084235
AR,Garland ,2015,0,97814,47247,50567,48.30290143
AR,Garland ,2016,0,98282,47388,50894,48.21635701
AR,Garland ,2017,0,98327,47360,50967,48.16581407
AR,Garland ,2018,0,98966,47605,51361,48.10237859
AR,Garland ,2019,0,99386,47783,51603,48.07820015
AR,Grant ,2015,0,18016,8964,9052,49.75577265
AR,Grant ,2016,0,18064,8987,9077,49.75088574
AR,Grant ,2017,0,18103,8954,9149,49.46141524
AR,Grant ,2018,0,18180,8989,9191,49.44444444
AR,Grant ,2019,0,18265,9015,9250,49.35669313
AR,Greene ,2015,0,44300,21837,22463,49.29345372
AR,Greene ,2016,0,44730,21988,22742,49.15716521
AR,Greene ,2017,0,44993,22172,22821,49.2787767
AR,Greene ,2018,0,45339,22292,23047,49.16738349
AR,Greene ,2019,0,45325,22336,22989,49.27964699
AR,Hempstead ,2015,0,22085,10651,11434,48.2273036
AR,Hempstead ,2016,0,22032,10644,11388,48.31154684
AR,Hempstead ,2017,0,21876,10509,11367,48.03894679
AR,Hempstead ,2018,0,21685,10472,11213,48.2914457
AR,Hempstead ,2019,0,21532,10429,11103,48.43488761
AR,Hot Spring ,2015,0,33497,17402,16095,51.95092098
AR,Hot Spring ,2016,0,33438,17410,16028,52.06651115
AR,Hot Spring ,2017,0,33606,17600,16006,52.37160031
AR,Hot Spring ,2018,0,33672,17646,16026,52.40555952
AR,Hot Spring ,2019,0,33771,17646,16125,52.25193213
AR,Howard ,2015,0,13336,6418,6918,48.12537493
AR,Howard ,2016,0,13350,6421,6929,48.09737828
AR,Howard ,2017,0,13365,6477,6888,48.4624018
AR,Howard ,2018,0,13302,6404,6898,48.14313637
AR,Howard ,2019,0,13202,6373,6829,48.27298894
AR,Independence ,2015,0,37035,18043,18992,48.71877953
AR,Independence ,2016,0,37117,18099,19018,48.76202279
AR,Independence ,2017,0,37391,18233,19158,48.76307133
AR,Independence ,2018,0,37768,18424,19344,48.7820377
AR,Independence ,2019,0,37825,18479,19346,48.85393258
AR,Izard ,2015,0,13487,6989,6498,51.82027137
AR,Izard ,2016,0,13488,7001,6487,51.90539739
AR,Izard ,2017,0,13666,7094,6572,51.90984926
AR,Izard ,2018,0,13582,7050,6532,51.90693565
AR,Izard ,2019,0,13629,7073,6556,51.89669088
AR,Jackson ,2015,0,17365,8565,8800,49.32335157
AR,Jackson ,2016,0,17282,8531,8751,49.36349959
AR,Jackson ,2017,0,17017,8381,8636,49.25074925
AR,Jackson ,2018,0,16753,8303,8450,49.56127261
AR,Jackson ,2019,0,16719,8297,8422,49.62617381
AR,Jefferson ,2015,0,71872,35493,36379,49.38362645
AR,Jefferson ,2016,0,70407,34864,35543,49.51780363
AR,Jefferson ,2017,0,69238,34235,35003,49.44539126
AR,Jefferson ,2018,0,68067,33610,34457,49.37781891
AR,Jefferson ,2019,0,66824,33005,33819,49.39093739
AR,Johnson ,2015,0,26094,12973,13121,49.7164099
AR,Johnson ,2016,0,26127,12970,13157,49.64213266
AR,Johnson ,2017,0,26401,13119,13282,49.69129957
AR,Johnson ,2018,0,26659,13197,13462,49.50298211
AR,Johnson ,2019,0,26578,13157,13421,49.50334863
AR,Lafayette ,2015,0,7010,3407,3603,48.60199715
AR,Lafayette ,2016,0,6888,3357,3531,48.7369338
AR,Lafayette ,2017,0,6797,3313,3484,48.7420921
AR,Lafayette ,2018,0,6679,3288,3391,49.22892649
AR,Lafayette ,2019,0,6624,3238,3386,48.88285024
AR,Lawrence ,2015,0,16696,8239,8457,49.34714902
AR,Lawrence ,2016,0,16639,8222,8417,49.41402729
AR,Lawrence ,2017,0,16571,8184,8387,49.38748416
AR,Lawrence ,2018,0,16432,8111,8321,49.36100292
AR,Lawrence ,2019,0,16406,8036,8370,48.98207973
AR,Lee ,2015,0,9672,5435,4237,56.19313482
AR,Lee ,2016,0,9337,5253,4084,56.2600407
AR,Lee ,2017,0,9127,5156,3971,56.49172784
AR,Lee ,2018,0,8976,5043,3933,56.18315508
AR,Lee ,2019,0,8857,4983,3874,56.26058485
AR,Lincoln ,2015,0,13866,8541,5325,61.59671138
AR,Lincoln ,2016,0,13728,8472,5256,61.71328671
AR,Lincoln ,2017,0,13475,8318,5157,61.72912801
AR,Lincoln ,2018,0,13184,8095,5089,61.40018204
AR,Lincoln ,2019,0,13024,7995,5029,61.38667076
AR,Little River ,2015,0,12402,6062,6340,48.87921303
AR,Little River ,2016,0,12406,6042,6364,48.70224085
AR,Little River ,2017,0,12373,5989,6384,48.40378243
AR,Little River ,2018,0,12297,5933,6364,48.24754005
AR,Little River ,2019,0,12259,5904,6355,48.16053512
AR,Logan ,2015,0,21729,10813,10916,49.76298955
AR,Logan ,2016,0,21732,10818,10914,49.77912755
AR,Logan ,2017,0,21739,10798,10941,49.67109803
AR,Logan ,2018,0,21673,10820,10853,49.92386841
AR,Logan ,2019,0,21466,10700,10766,49.84626852
AR,Lonoke ,2015,0,71359,35334,36025,49.51582842
AR,Lonoke ,2016,0,71803,35513,36290,49.45893626
AR,Lonoke ,2017,0,72778,35986,36792,49.44626123
AR,Lonoke ,2018,0,73391,36181,37210,49.29896036
AR,Lonoke ,2019,0,73309,35960,37349,49.05264019
AR,Madison ,2015,0,15705,7864,7841,50.07322509
AR,Madison ,2016,0,16112,8036,8076,49.87586892
AR,Madison ,2017,0,16299,8148,8151,49.99079698
AR,Madison ,2018,0,16362,8179,8183,49.98777656
AR,Madison ,2019,0,16576,8300,8276,50.07239382
AR,Marion ,2015,0,16215,8046,8169,49.62072155
AR,Marion ,2016,0,16376,8080,8296,49.34049829
AR,Marion ,2017,0,16429,8102,8327,49.31523525
AR,Marion ,2018,0,16665,8182,8483,49.09690969
AR,Marion ,2019,0,16694,8180,8514,48.99964059
AR,Miller ,2015,0,43792,21652,22140,49.44282061
AR,Miller ,2016,0,43713,21553,22160,49.30569853
AR,Miller ,2017,0,43736,21533,22203,49.23404061
AR,Miller ,2018,0,43362,21293,22069,49.10520732
AR,Miller ,2019,0,43257,21294,21963,49.22671475
AR,Mississippi ,2015,0,43729,21268,22461,48.63591667
AR,Mississippi ,2016,0,42900,20884,22016,48.68065268
AR,Mississippi ,2017,0,42112,20533,21579,48.75807371
AR,Mississippi ,2018,0,41236,20067,21169,48.66378892
AR,Mississippi ,2019,0,40651,19795,20856,48.69498905
AR,Monroe ,2015,0,7452,3514,3938,47.15512614
AR,Monroe ,2016,0,7205,3391,3814,47.06453851
AR,Monroe ,2017,0,7013,3291,3722,46.92713532
AR,Monroe ,2018,0,6880,3221,3659,46.81686047
AR,Monroe ,2019,0,6701,3137,3564,46.81390837
AR,Montgomery ,2015,0,9027,4511,4516,49.97230531
AR,Montgomery ,2016,0,8936,4465,4471,49.96642793
AR,Montgomery ,2017,0,8890,4436,4454,49.89876265
AR,Montgomery ,2018,0,8910,4423,4487,49.64085297
AR,Montgomery ,2019,0,8986,4457,4529,49.59937681
AR,Nevada ,2015,0,8508,4229,4279,49.70615891
AR,Nevada ,2016,0,8378,4167,4211,49.7374075
AR,Nevada ,2017,0,8309,4137,4172,49.789385
AR,Nevada ,2018,0,8308,4127,4181,49.67501204
AR,Nevada ,2019,0,8252,4088,4164,49.53950557
AR,Newton ,2015,0,7846,3978,3868,50.70099414
AR,Newton ,2016,0,7848,3988,3860,50.81549439
AR,Newton ,2017,0,7815,3952,3863,50.56941779
AR,Newton ,2018,0,7800,3952,3848,50.66666667
AR,Newton ,2019,0,7753,3917,3836,50.52237843
AR,Ouachita ,2015,0,24316,11532,12784,47.42556342
AR,Ouachita ,2016,0,24013,11390,12623,47.43264065
AR,Ouachita ,2017,0,23817,11311,12506,47.49128774
AR,Ouachita ,2018,0,23620,11181,12439,47.33700254
AR,Ouachita ,2019,0,23382,11049,12333,47.25429818
AR,Perry ,2015,0,10307,5106,5201,49.53914815
AR,Perry ,2016,0,10286,5107,5179,49.65000972
AR,Perry ,2017,0,10346,5128,5218,49.56504929
AR,Perry ,2018,0,10380,5140,5240,49.51830443
AR,Perry ,2019,0,10455,5188,5267,49.62219034
AR,Phillips ,2015,0,19546,9211,10335,47.1247314
AR,Phillips ,2016,0,19050,8983,10067,47.15485564
AR,Phillips ,2017,0,18599,8770,9829,47.15307275
AR,Phillips ,2018,0,18054,8501,9553,47.08651822
AR,Phillips ,2019,0,17782,8343,9439,46.91823192
AR,Pike ,2015,0,10837,5433,5404,50.13380087
AR,Pike ,2016,0,10826,5422,5404,50.0831332
AR,Pike ,2017,0,10735,5379,5356,50.10712622
AR,Pike ,2018,0,10666,5331,5335,49.98124883
AR,Pike ,2019,0,10718,5338,5380,49.80406792
AR,Poinsett ,2015,0,24002,11740,12262,48.91259062
AR,Poinsett ,2016,0,23974,11647,12327,48.58179695
AR,Poinsett ,2017,0,24071,11709,12362,48.64359603
AR,Poinsett ,2018,0,23903,11605,12298,48.55039116
AR,Poinsett ,2019,0,23528,11379,12149,48.36365182
AR,Polk ,2015,0,20194,9891,10303,48.97989502
AR,Polk ,2016,0,20145,9834,10311,48.8160834
AR,Polk ,2017,0,20147,9814,10333,48.71196704
AR,Polk ,2018,0,20019,9765,10254,48.77866027
AR,Polk ,2019,0,19964,9747,10217,48.82288119
AR,Pope ,2015,0,63608,31529,32079,49.56766444
AR,Pope ,2016,0,63897,31611,32286,49.47180619
AR,Pope ,2017,0,63634,31498,32136,49.49869567
AR,Pope ,2018,0,63594,31516,32078,49.55813442
AR,Pope ,2019,0,64072,31778,32294,49.59732801
AR,Prairie ,2015,0,8299,4132,4167,49.78913122
AR,Prairie ,2016,0,8252,4124,4128,49.97576345
AR,Prairie ,2017,0,8248,4124,4124,50
AR,Prairie ,2018,0,8082,4050,4032,50.11135857
AR,Prairie ,2019,0,8062,4049,4013,50.22326966
AR,Pulaski ,2015,0,393576,188744,204832,47.95617619
AR,Pulaski ,2016,0,394151,188594,205557,47.84815972
AR,Pulaski ,2017,0,393280,188107,205173,47.83029902
AR,Pulaski ,2018,0,391918,187147,204771,47.75157048
AR,Pulaski ,2019,0,391911,186981,204930,47.71006683
AR,Randolph ,2015,0,17437,8616,8821,49.41216952
AR,Randolph ,2016,0,17444,8640,8804,49.52992433
AR,Randolph ,2017,0,17665,8753,8912,49.54995754
AR,Randolph ,2018,0,17970,8906,9064,49.56037841
AR,Randolph ,2019,0,17958,8899,9059,49.55451609
AR,St. Francis ,2015,0,26651,14522,12129,54.48951259
AR,St. Francis ,2016,0,26347,14417,11930,54.71970243
AR,St. Francis ,2017,0,25997,14281,11716,54.93326153
AR,St. Francis ,2018,0,25509,14055,11454,55.09820064
AR,St. Francis ,2019,0,24994,13798,11196,55.20524926
AR,Saline ,2015,0,116390,57127,59263,49.08239539
AR,Saline ,2016,0,117656,57730,59926,49.06677093
AR,Saline ,2017,0,119520,58609,60911,49.03698126
AR,Saline ,2018,0,121074,59284,61790,48.96509573
AR,Saline ,2019,0,122437,59792,62645,48.83491102
AR,Scott ,2015,0,10561,5365,5196,50.80011363
AR,Scott ,2016,0,10332,5258,5074,50.89043748
AR,Scott ,2017,0,10369,5266,5103,50.78599672
AR,Scott ,2018,0,10339,5241,5098,50.69155624
AR,Scott ,2019,0,10281,5210,5071,50.67600428
AR,Searcy ,2015,0,7835,3947,3888,50.37651563
AR,Searcy ,2016,0,7968,4013,3955,50.36395582
AR,Searcy ,2017,0,7927,3982,3945,50.23337959
AR,Searcy ,2018,0,7930,3975,3955,50.1261034
AR,Searcy ,2019,0,7881,3950,3931,50.12054308
AR,Sebastian ,2015,0,127385,62432,64953,49.01048004
AR,Sebastian ,2016,0,127385,62333,65052,48.93276288
AR,Sebastian ,2017,0,127786,62456,65330,48.87546367
AR,Sebastian ,2018,0,127570,62338,65232,48.86572078
AR,Sebastian ,2019,0,127827,62479,65348,48.87778012
AR,Sevier ,2015,0,17262,8608,8654,49.86675936
AR,Sevier ,2016,0,16971,8465,8506,49.8792057
AR,Sevier ,2017,0,17103,8583,8520,50.18417821
AR,Sevier ,2018,0,17061,8559,8502,50.16704765
AR,Sevier ,2019,0,17007,8514,8493,50.06173928
AR,Sharp ,2015,0,16808,8260,8548,49.14326511
AR,Sharp ,2016,0,17007,8385,8622,49.30322808
AR,Sharp ,2017,0,17147,8494,8653,49.53636205
AR,Sharp ,2018,0,17290,8552,8738,49.46211683
AR,Sharp ,2019,0,17442,8579,8863,49.18587318
AR,Stone ,2015,0,12386,6088,6298,49.15226869
AR,Stone ,2016,0,12509,6153,6356,49.18858422
AR,Stone ,2017,0,12520,6163,6357,49.22523962
AR,Stone ,2018,0,12454,6126,6328,49.18901558
AR,Stone ,2019,0,12506,6205,6301,49.61618423
AR,Union ,2015,0,40086,19570,20516,48.82003692
AR,Union ,2016,0,39879,19431,20448,48.7248928
AR,Union ,2017,0,39460,19257,20203,48.80131779
AR,Union ,2018,0,39139,19037,20102,48.63946447
AR,Union ,2019,0,38682,18841,19841,48.70740913
AR,Van Buren ,2015,0,16808,8340,8468,49.61922894
AR,Van Buren ,2016,0,16669,8249,8420,49.48707181
AR,Van Buren ,2017,0,16552,8188,8364,49.46834219
AR,Van Buren ,2018,0,16635,8253,8382,49.6122633
AR,Van Buren ,2019,0,16545,8239,8306,49.79752191
AR,Washington ,2015,0,224434,112127,112307,49.95989912
AR,Washington ,2016,0,228482,114208,114274,49.98555685
AR,Washington ,2017,0,232732,116371,116361,50.00214839
AR,Washington ,2018,0,236611,118402,118209,50.04078424
AR,Washington ,2019,0,239187,119577,119610,49.99310163
AR,White ,2015,0,78915,38506,40409,48.79427232
AR,White ,2016,0,78917,38452,40465,48.7246094
AR,White ,2017,0,78844,38469,40375,48.79128405
AR,White ,2018,0,78381,38159,40222,48.68399229
AR,White ,2019,0,78753,38358,40395,48.70671593
AR,Woodruff ,2015,0,6706,3188,3518,47.53951685
AR,Woodruff ,2016,0,6600,3142,3458,47.60606061
AR,Woodruff ,2017,0,6575,3154,3421,47.96958175
AR,Woodruff ,2018,0,6466,3109,3357,48.08227652
AR,Woodruff ,2019,0,6320,3060,3260,48.41772152
AR,Yell ,2015,0,21506,10789,10717,50.16739515
AR,Yell ,2016,0,21502,10788,10714,50.17207702
AR,Yell ,2017,0,21509,10802,10707,50.22083779
AR,Yell ,2018,0,21462,10790,10672,50.27490448
AR,Yell ,2019,0,21341,10689,10652,50.0866876
CA,Alameda ,2015,0,1634538,801625,832913,49.04290998
CA,Alameda ,2016,0,1650950,810926,840024,49.11874981
CA,Alameda ,2017,0,1660196,816390,843806,49.17431436
CA,Alameda ,2018,0,1666756,820231,846525,49.21122228
CA,Alameda ,2019,0,1671329,823247,848082,49.25702839
CA,Alpine ,2015,0,1077,563,514,52.27483751
CA,Alpine ,2016,0,1047,554,493,52.913085
CA,Alpine ,2017,0,1111,606,505,54.54545455
CA,Alpine ,2018,0,1089,582,507,53.44352617
CA,Alpine ,2019,0,1129,609,520,53.94154119
CA,Amador ,2015,0,37031,19665,17366,53.10415598
CA,Amador ,2016,0,37429,19839,17590,53.00435491
CA,Amador ,2017,0,38529,20744,17785,53.8399647
CA,Amador ,2018,0,39405,21435,17970,54.39665017
CA,Amador ,2019,0,39752,21638,18114,54.43248138
CA,Butte ,2015,0,224631,111067,113564,49.4441996
CA,Butte ,2016,0,226231,111821,114410,49.42779725
CA,Butte ,2017,0,228696,112940,115756,49.38433554
CA,Butte ,2018,0,230339,113816,116523,49.41238783
CA,Butte ,2019,0,219186,108473,110713,49.48901846
CA,Calaveras ,2015,0,44965,22450,22515,49.92772156
CA,Calaveras ,2016,0,45322,22591,22731,49.84554962
CA,Calaveras ,2017,0,45681,22762,22919,49.82815613
CA,Calaveras ,2018,0,45698,22747,22951,49.77679548
CA,Calaveras ,2019,0,45905,22847,23058,49.77017754
CA,Colusa ,2015,0,21231,10850,10381,51.10451698
CA,Colusa ,2016,0,21496,10978,10518,51.06996651
CA,Colusa ,2017,0,21579,11006,10573,51.00329024
CA,Colusa ,2018,0,21418,10925,10493,51.00849753
CA,Colusa ,2019,0,21547,10975,10572,50.93516499
CA,Contra Costa ,2015,0,1124405,548866,575539,48.81390602
CA,Contra Costa ,2016,0,1137268,555612,581656,48.85497526
CA,Contra Costa ,2017,0,1145535,559900,585635,48.87672572
CA,Contra Costa ,2018,0,1150519,562835,587684,48.92009606
CA,Contra Costa ,2019,0,1153526,564187,589339,48.9097775
CA,Del Norte ,2015,0,27190,14883,12307,54.73703567
CA,Del Norte ,2016,0,27382,14885,12497,54.36052881
CA,Del Norte ,2017,0,27351,14744,12607,53.90662133
CA,Del Norte ,2018,0,27740,15131,12609,54.54578226
CA,Del Norte ,2019,0,27812,15186,12626,54.60232993
CA,El Dorado ,2015,0,184569,92136,92433,49.91954228
CA,El Dorado ,2016,0,185976,92659,93317,49.82309545
CA,El Dorado ,2017,0,188679,93992,94687,49.81582476
CA,El Dorado ,2018,0,190746,95065,95681,49.83852872
CA,El Dorado ,2019,0,192843,96158,96685,49.86336035
CA,Fresno ,2015,0,969488,483620,485868,49.88406252
CA,Fresno ,2016,0,976830,487152,489678,49.87070422
CA,Fresno ,2017,0,985238,491409,493829,49.87718704
CA,Fresno ,2018,0,991950,494736,497214,49.87509451
CA,Fresno ,2019,0,999101,498648,500453,49.90966879
CA,Glenn ,2015,0,27753,13998,13755,50.43779051
CA,Glenn ,2016,0,27840,14115,13725,50.70043103
CA,Glenn ,2017,0,27926,14175,13751,50.75914918
CA,Glenn ,2018,0,27967,14217,13750,50.83491258
CA,Glenn ,2019,0,28393,14462,13931,50.93508963
CA,Humboldt ,2015,0,135102,67439,67663,49.91709967
CA,Humboldt ,2016,0,136290,67998,68292,49.89214176
CA,Humboldt ,2017,0,136507,67987,68520,49.80477192
CA,Humboldt ,2018,0,136244,67786,68458,49.75338364
CA,Humboldt ,2019,0,135558,67241,68317,49.60312191
CA,Imperial ,2015,0,178937,91405,87532,51.08222447
CA,Imperial ,2016,0,180179,92077,88102,51.10306973
CA,Imperial ,2017,0,181649,93254,88395,51.33746952
CA,Imperial ,2018,0,181523,93119,88404,51.29873349
CA,Imperial ,2019,0,181215,92878,88337,51.2529316
CA,Inyo ,2015,0,18108,9066,9042,50.06626905
CA,Inyo ,2016,0,17922,8998,8924,50.20645017
CA,Inyo ,2017,0,17868,9011,8857,50.43093799
CA,Inyo ,2018,0,17946,9016,8930,50.23960771
CA,Inyo ,2019,0,18039,9036,9003,50.09146848
CA,Kern ,2015,0,876031,449123,426908,51.26793458
CA,Kern ,2016,0,880856,451394,429462,51.24492539
CA,Kern ,2017,0,887356,454692,432664,51.24121548
CA,Kern ,2018,0,893758,457823,435935,51.22449254
CA,Kern ,2019,0,900202,461034,439168,51.21450519
CA,Kings ,2015,0,150085,82865,67220,55.21204651
CA,Kings ,2016,0,149382,82312,67070,55.10168561
CA,Kings ,2017,0,149665,82065,67600,54.83245916
CA,Kings ,2018,0,151382,83208,68174,54.96558376
CA,Kings ,2019,0,152940,84342,68598,55.14711652
CA,Lake ,2015,0,64260,32004,32256,49.80392157
CA,Lake ,2016,0,63903,31850,32053,49.84116552
CA,Lake ,2017,0,64111,31924,32187,49.79488699
CA,Lake ,2018,0,64317,32086,32231,49.88727708
CA,Lake ,2019,0,64386,32194,32192,50.00155313
CA,Lassen ,2015,0,31256,19743,11513,63.16547223
CA,Lassen ,2016,0,30721,19142,11579,62.30916962
CA,Lassen ,2017,0,30920,19377,11543,62.66817594
CA,Lassen ,2018,0,30618,19086,11532,62.33588085
CA,Lassen ,2019,0,30573,19026,11547,62.23138063
CA,Los Angeles ,2015,0,10085416,4969812,5115604,49.27721375
CA,Los Angeles ,2016,0,10105708,4980373,5125335,49.28277168
CA,Los Angeles ,2017,0,10103711,4980981,5122730,49.29853002
CA,Los Angeles ,2018,0,10073906,4966715,5107191,49.30277293
CA,Los Angeles ,2019,0,10039107,4949041,5090066,49.29762179
CA,Madera ,2015,0,153576,74036,79540,48.20805334
CA,Madera ,2016,0,153956,74383,79573,48.31445348
CA,Madera ,2017,0,155423,74914,80509,48.20007335
CA,Madera ,2018,0,156882,75596,81286,48.1865351
CA,Madera ,2019,0,157327,75885,81442,48.23393315
CA,Marin ,2015,0,260916,127406,133510,48.83027488
CA,Marin ,2016,0,260562,127096,133466,48.77764217
CA,Marin ,2017,0,259749,126875,132874,48.84523136
CA,Marin ,2018,0,259662,126961,132701,48.89471698
CA,Marin ,2019,0,258826,126617,132209,48.91973758
CA,Mariposa ,2015,0,17622,8933,8689,50.69231642
CA,Mariposa ,2016,0,17456,8879,8577,50.86503208
CA,Mariposa ,2017,0,17414,8874,8540,50.95899851
CA,Mariposa ,2018,0,17405,8846,8559,50.82447573
CA,Mariposa ,2019,0,17203,8764,8439,50.94460269
CA,Mendocino ,2015,0,87107,43311,43796,49.72160676
CA,Mendocino ,2016,0,87285,43319,43966,49.62937504
CA,Mendocino ,2017,0,87576,43398,44178,49.55467251
CA,Mendocino ,2018,0,87401,43322,44079,49.56693859
CA,Mendocino ,2019,0,86749,43021,43728,49.59250251
CA,Merced ,2015,0,266353,134406,131947,50.46160546
CA,Merced ,2016,0,267628,134757,132871,50.35235476
CA,Merced ,2017,0,271096,136752,134344,50.44412312
CA,Merced ,2018,0,274151,138267,135884,50.4346145
CA,Merced ,2019,0,277680,140185,137495,50.4843705
CA,Modoc ,2015,0,9056,4584,4472,50.61837456
CA,Modoc ,2016,0,8961,4526,4435,50.50775583
CA,Modoc ,2017,0,8876,4446,4430,50.09013069
CA,Modoc ,2018,0,8800,4396,4404,49.95454545
CA,Modoc ,2019,0,8841,4448,4393,50.31105079
CA,Mono ,2015,0,14077,7485,6592,53.17184059
CA,Mono ,2016,0,14273,7558,6715,52.95312828
CA,Mono ,2017,0,14354,7614,6740,53.04444754
CA,Mono ,2018,0,14403,7635,6768,53.00978963
CA,Mono ,2019,0,14444,7658,6786,53.01855442
CA,Monterey ,2015,0,430552,219525,211027,50.98687267
CA,Monterey ,2016,0,433953,221571,212382,51.05875521
CA,Monterey ,2017,0,434534,221680,212854,51.0155707
CA,Monterey ,2018,0,433950,220969,212981,50.92038253
CA,Monterey ,2019,0,434061,221129,212932,50.94422213
CA,Napa ,2015,0,140862,70247,70615,49.8693757
CA,Napa ,2016,0,140840,70115,70725,49.7834422
CA,Napa ,2017,0,139878,69695,70183,49.82556228
CA,Napa ,2018,0,138789,69089,69700,49.77988169
CA,Napa ,2019,0,137744,68535,69209,49.75534325
CA,Nevada ,2015,0,98676,48598,50078,49.25007094
CA,Nevada ,2016,0,98913,48639,50274,49.17351612
CA,Nevada ,2017,0,99367,48848,50519,49.15917759
CA,Nevada ,2018,0,99508,48868,50640,49.10961933
CA,Nevada ,2019,0,99755,49003,50752,49.12335221
CA,Orange ,2015,0,3149280,1555379,1593901,49.38839989
CA,Orange ,2016,0,3164986,1562493,1602493,49.36808567
CA,Orange ,2017,0,3174289,1567002,1607287,49.36544845
CA,Orange ,2018,0,3175973,1567487,1608486,49.35454426
CA,Orange ,2019,0,3175692,1566825,1608867,49.33806553
CA,Placer ,2015,0,372841,181938,190903,48.79774488
CA,Placer ,2016,0,378943,184811,194132,48.77013166
CA,Placer ,2017,0,385115,187925,197190,48.79711255
CA,Placer ,2018,0,392330,191765,200565,48.87849514
CA,Placer ,2019,0,398329,194488,203841,48.82597049
CA,Plumas ,2015,0,18427,9210,9217,49.98100613
CA,Plumas ,2016,0,18665,9329,9336,49.98124833
CA,Plumas ,2017,0,18660,9294,9366,49.80707395
CA,Plumas ,2018,0,18741,9330,9411,49.78389627
CA,Plumas ,2019,0,18807,9357,9450,49.75275164
CA,Riverside ,2015,0,2345816,1166571,1179245,49.72985946
CA,Riverside ,2016,0,2380081,1184681,1195400,49.77481859
CA,Riverside ,2017,0,2414964,1202904,1212060,49.81043196
CA,Riverside ,2018,0,2445789,1219025,1226764,49.8417893
CA,Riverside ,2019,0,2470546,1232012,1238534,49.86800489
CA,Sacramento ,2015,0,1493674,729669,764005,48.85061935
CA,Sacramento ,2016,0,1510987,738114,772873,48.84979156
CA,Sacramento ,2017,0,1527301,746291,781010,48.86338711
CA,Sacramento ,2018,0,1538746,752017,786729,48.87206855
CA,Sacramento ,2019,0,1552058,758897,793161,48.89617527
CA,San Benito ,2015,0,58216,29092,29124,49.97251615
CA,San Benito ,2016,0,59225,29667,29558,50.09202195
CA,San Benito ,2017,0,60164,30121,30043,50.06482282
CA,San Benito ,2018,0,61467,30793,30674,50.09679991
CA,San Benito ,2019,0,62808,31448,31360,50.07005477
CA,San Bernardino ,2015,0,2115411,1052822,1062589,49.76914652
CA,San Bernardino ,2016,0,2131960,1060947,1071013,49.76392615
CA,San Bernardino ,2017,0,2150945,1070810,1080135,49.78323481
CA,San Bernardino ,2018,0,2166753,1078997,1087756,49.79787728
CA,San Bernardino ,2019,0,2180085,1085607,1094478,49.79654463
CA,San Diego ,2015,0,3280850,1651711,1629139,50.34399622
CA,San Diego ,2016,0,3306089,1664729,1641360,50.35342364
CA,San Diego ,2017,0,3321237,1672189,1649048,50.34837923
CA,San Diego ,2018,0,3333861,1678934,1654927,50.360048
CA,San Diego ,2019,0,3338330,1680017,1658313,50.32507272
CA,San Francisco ,2015,0,863010,440323,422687,51.02177263
CA,San Francisco ,2016,0,871512,444409,427103,50.99287216
CA,San Francisco ,2017,0,878040,447916,430124,51.01316569
CA,San Francisco ,2018,0,880696,449090,431606,50.99262402
CA,San Francisco ,2019,0,881549,449221,432328,50.958143
CA,San Joaquin ,2015,0,722271,359616,362655,49.7896219
CA,San Joaquin ,2016,0,732809,365315,367494,49.85132552
CA,San Joaquin ,2017,0,743296,370464,372832,49.84070949
CA,San Joaquin ,2018,0,752491,375009,377482,49.8356791
CA,San Joaquin ,2019,0,762148,380193,381955,49.88440565
CA,San Luis Obispo ,2015,0,280077,142006,138071,50.70248539
CA,San Luis Obispo ,2016,0,281803,142929,138874,50.71947424
CA,San Luis Obispo ,2017,0,282481,143284,139197,50.72341149
CA,San Luis Obispo ,2018,0,283354,143696,139658,50.71253626
CA,San Luis Obispo ,2019,0,283111,143377,139734,50.64338722
CA,San Mateo ,2015,0,765055,376907,388148,49.26534694
CA,San Mateo ,2016,0,767906,379087,388819,49.36632869
CA,San Mateo ,2017,0,768901,379940,388961,49.41338352
CA,San Mateo ,2018,0,768681,380484,388197,49.49829643
CA,San Mateo ,2019,0,766573,379508,387065,49.50709195
CA,Santa Barbara ,2015,0,442229,221615,220614,50.11317666
CA,Santa Barbara ,2016,0,444340,222450,221890,50.06301481
CA,Santa Barbara ,2017,0,445298,222867,222431,50.04895598
CA,Santa Barbara ,2018,0,445780,222850,222930,49.99102696
CA,Santa Barbara ,2019,0,446499,223245,223254,49.99899216
CA,Santa Clara ,2015,0,1916285,966167,950118,50.41875295
CA,Santa Clara ,2016,0,1928368,973257,955111,50.47050148
CA,Santa Clara ,2017,0,1932510,977117,955393,50.56206695
CA,Santa Clara ,2018,0,1932337,978212,954125,50.62326085
CA,Santa Clara ,2019,0,1927852,976847,951005,50.6702278
CA,Santa Cruz ,2015,0,273503,135754,137749,49.63528736
CA,Santa Cruz ,2016,0,274396,136089,138307,49.59583959
CA,Santa Cruz ,2017,0,274856,136220,138636,49.56049713
CA,Santa Cruz ,2018,0,273841,135527,138314,49.49112806
CA,Santa Cruz ,2019,0,273213,135176,138037,49.47641584
CA,Shasta ,2015,0,178314,87580,90734,49.11560506
CA,Shasta ,2016,0,178571,87722,90849,49.1244379
CA,Shasta ,2017,0,179384,88164,91220,49.14819605
CA,Shasta ,2018,0,179709,88342,91367,49.15836157
CA,Shasta ,2019,0,180080,88473,91607,49.12983119
CA,Sierra ,2015,0,2985,1512,1473,50.65326633
CA,Sierra ,2016,0,2951,1487,1464,50.38969841
CA,Sierra ,2017,0,3002,1511,1491,50.33311126
CA,Sierra ,2018,0,2997,1508,1489,50.31698365
CA,Sierra ,2019,0,3005,1509,1496,50.21630616
CA,Siskiyou ,2015,0,43254,21549,21705,49.81966986
CA,Siskiyou ,2016,0,43376,21600,21776,49.79712283
CA,Siskiyou ,2017,0,43622,21700,21922,49.74554124
CA,Siskiyou ,2018,0,43550,21656,21894,49.72675086
CA,Siskiyou ,2019,0,43539,21654,21885,49.7347206
CA,Solano ,2015,0,433409,215303,218106,49.67663339
CA,Solano ,2016,0,438858,218215,220643,49.72337294
CA,Solano ,2017,0,443511,220820,222691,49.78906949
CA,Solano ,2018,0,445725,221843,223882,49.77127152
CA,Solano ,2019,0,447643,222764,224879,49.76376264
CA,Sonoma ,2015,0,500863,244927,255936,48.90099688
CA,Sonoma ,2016,0,502547,245584,256963,48.86786709
CA,Sonoma ,2017,0,502469,245589,256880,48.8764481
CA,Sonoma ,2018,0,498643,243377,255266,48.80786454
CA,Sonoma ,2019,0,494336,241221,253115,48.7969721
CA,Stanislaus ,2015,0,533211,263837,269374,49.48078716
CA,Stanislaus ,2016,0,539255,266723,272532,49.46138654
CA,Stanislaus ,2017,0,544717,269618,275099,49.49689472
CA,Stanislaus ,2018,0,548126,271479,276647,49.52857555
CA,Stanislaus ,2019,0,550660,272956,277704,49.56888098
CA,Sutter ,2015,0,95282,47307,47975,49.6494616
CA,Sutter ,2016,0,95742,47643,48099,49.76186
CA,Sutter ,2017,0,96204,47877,48327,49.76612199
CA,Sutter ,2018,0,96348,47997,48351,49.81629095
CA,Sutter ,2019,0,96971,48303,48668,49.8117994
CA,Tehama ,2015,0,63158,31402,31756,49.71975047
CA,Tehama ,2016,0,63453,31514,31939,49.66510646
CA,Tehama ,2017,0,63847,31668,32179,49.59982458
CA,Tehama ,2018,0,64018,31806,32212,49.68290168
CA,Tehama ,2019,0,65084,32366,32718,49.72958023
CA,Trinity ,2015,0,13094,6742,6352,51.48923171
CA,Trinity ,2016,0,12828,6593,6235,51.3953851
CA,Trinity ,2017,0,12726,6557,6169,51.52443816
CA,Trinity ,2018,0,12567,6446,6121,51.29306915
CA,Trinity ,2019,0,12285,6314,5971,51.3960114
CA,Tulare ,2015,0,457161,228476,228685,49.97714153
CA,Tulare ,2016,0,459235,229573,229662,49.99030997
CA,Tulare ,2017,0,462308,231249,231059,50.02054907
CA,Tulare ,2018,0,464589,232339,232250,50.00957836
CA,Tulare ,2019,0,466195,232989,233206,49.97672648
CA,Tuolumne ,2015,0,53615,27861,25754,51.96493519
CA,Tuolumne ,2016,0,53770,27899,25871,51.88580993
CA,Tuolumne ,2017,0,53976,28002,25974,51.87861272
CA,Tuolumne ,2018,0,54387,28206,26181,51.86165812
CA,Tuolumne ,2019,0,54478,28213,26265,51.78787768
CA,Ventura ,2015,0,845802,418646,427156,49.49692718
CA,Ventura ,2016,0,847323,419522,427801,49.51146139
CA,Ventura ,2017,0,849044,420263,428781,49.498377
CA,Ventura ,2018,0,848142,419784,428358,49.49454219
CA,Ventura ,2019,0,846006,418712,427294,49.4927932
CA,Yolo ,2015,0,212037,103313,108724,48.72404345
CA,Yolo ,2016,0,215627,104850,110777,48.62563594
CA,Yolo ,2017,0,218477,105980,112497,48.50853866
CA,Yolo ,2018,0,220118,106696,113422,48.4721831
CA,Yolo ,2019,0,220500,106876,113624,48.46984127
CA,Yuba ,2015,0,74045,37503,36542,50.6489297
CA,Yuba ,2016,0,74952,37971,36981,50.66042267
CA,Yuba ,2017,0,76578,38775,37803,50.63464703
CA,Yuba ,2018,0,77557,39249,38308,50.60665059
CA,Yuba ,2019,0,78668,39819,38849,50.61651497
CO,Adams ,2015,0,490443,247098,243345,50.38261327
CO,Adams ,2016,0,497734,250876,246858,50.40362925
CO,Adams ,2017,0,503590,254232,249358,50.48392542
CO,Adams ,2018,0,511354,258215,253139,50.49632935
CO,Adams ,2019,0,517421,261615,255806,50.56134173
CO,Alamosa ,2015,0,15894,7950,7944,50.01887505
CO,Alamosa ,2016,0,16053,8058,7995,50.196225
CO,Alamosa ,2017,0,16108,8078,8030,50.14899429
CO,Alamosa ,2018,0,16248,8113,8135,49.93229936
CO,Alamosa ,2019,0,16233,8106,8127,49.93531695
CO,Arapahoe ,2015,0,630984,311131,319853,49.30885728
CO,Arapahoe ,2016,0,638950,315745,323205,49.41622975
CO,Arapahoe ,2017,0,644478,318876,325602,49.47818234
CO,Arapahoe ,2018,0,651797,322907,328890,49.54103808
CO,Arapahoe ,2019,0,656590,325857,330733,49.62868761
CO,Archuleta ,2015,0,12387,6234,6153,50.32695568
CO,Archuleta ,2016,0,12825,6450,6375,50.29239766
CO,Archuleta ,2017,0,13295,6678,6617,50.22940955
CO,Archuleta ,2018,0,13730,6890,6840,50.18208303
CO,Archuleta ,2019,0,14029,7067,6962,50.37422482
CO,Baca ,2015,0,3555,1765,1790,49.64838256
CO,Baca ,2016,0,3530,1760,1770,49.85835694
CO,Baca ,2017,0,3554,1784,1770,50.19696117
CO,Baca ,2018,0,3584,1802,1782,50.27901786
CO,Baca ,2019,0,3581,1797,1784,50.18151354
CO,Bent ,2015,0,5889,3845,2044,65.29122092
CO,Bent ,2016,0,5833,3820,2013,65.48945654
CO,Bent ,2017,0,5827,3794,2033,65.11069161
CO,Bent ,2018,0,5808,3791,2017,65.27203857
CO,Bent ,2019,0,5577,3589,1988,64.35359512
CO,Boulder ,2015,0,318027,159803,158224,50.24824936
CO,Boulder ,2016,0,321250,161517,159733,50.27766537
CO,Boulder ,2017,0,322441,162265,160176,50.32393523
CO,Boulder ,2018,0,324636,163381,161255,50.32744366
CO,Boulder ,2019,0,326196,164297,161899,50.36757042
CO,Broomfield ,2015,0,64866,32157,32709,49.57450745
CO,Broomfield ,2016,0,66513,32962,33551,49.55722941
CO,Broomfield ,2017,0,68263,33979,34284,49.77659933
CO,Broomfield ,2018,0,69324,34519,34805,49.79372223
CO,Broomfield ,2019,0,70465,35045,35420,49.73391045
CO,Chaffee ,2015,0,18612,9932,8680,53.36342145
CO,Chaffee ,2016,0,19110,10210,8900,53.42752486
CO,Chaffee ,2017,0,19666,10451,9215,53.14247941
CO,Chaffee ,2018,0,20041,10612,9429,52.95144953
CO,Chaffee ,2019,0,20356,10786,9570,52.98683435
CO,Cheyenne ,2015,0,1827,911,916,49.86316366
CO,Cheyenne ,2016,0,1850,914,936,49.40540541
CO,Cheyenne ,2017,0,1853,923,930,49.81111711
CO,Cheyenne ,2018,0,1859,942,917,50.67240452
CO,Cheyenne ,2019,0,1831,928,903,50.68268706
CO,Clear Creek ,2015,0,9244,4818,4426,52.12029424
CO,Clear Creek ,2016,0,9353,4920,4433,52.60344275
CO,Clear Creek ,2017,0,9574,5034,4540,52.57990391
CO,Clear Creek ,2018,0,9604,5085,4519,52.94668888
CO,Clear Creek ,2019,0,9700,5135,4565,52.93814433
CO,Conejos ,2015,0,8065,4060,4005,50.34097954
CO,Conejos ,2016,0,8050,4041,4009,50.19875776
CO,Conejos ,2017,0,8139,4096,4043,50.32559282
CO,Conejos ,2018,0,8181,4110,4071,50.23835717
CO,Conejos ,2019,0,8205,4113,4092,50.12797075
CO,Costilla ,2015,0,3576,1843,1733,51.53803132
CO,Costilla ,2016,0,3693,1935,1758,52.39642567
CO,Costilla ,2017,0,3756,1951,1805,51.94355698
CO,Costilla ,2018,0,3812,1972,1840,51.73137461
CO,Costilla ,2019,0,3887,1997,1890,51.37638281
CO,Crowley ,2015,0,5628,4055,1573,72.05046198
CO,Crowley ,2016,0,5285,3691,1594,69.83916746
CO,Crowley ,2017,0,5840,4277,1563,73.23630137
CO,Crowley ,2018,0,5957,4338,1619,72.82189021
CO,Crowley ,2019,0,6061,4454,1607,73.4862234
CO,Custer ,2015,0,4434,2278,2156,51.37573297
CO,Custer ,2016,0,4588,2358,2230,51.39494333
CO,Custer ,2017,0,4857,2506,2351,51.59563517
CO,Custer ,2018,0,4934,2550,2384,51.68220511
CO,Custer ,2019,0,5068,2620,2448,51.69692186
CO,Delta ,2015,0,29913,15015,14898,50.19556714
CO,Delta ,2016,0,30346,15219,15127,50.15158505
CO,Delta ,2017,0,30519,15349,15170,50.29325994
CO,Delta ,2018,0,30884,15490,15394,50.15542028
CO,Delta ,2019,0,31162,15661,15501,50.25672293
CO,Denver ,2015,0,683285,342167,341118,50.07676153
CO,Denver ,2016,0,696159,348861,347298,50.11225884
CO,Denver ,2017,0,704961,353064,351897,50.08277054
CO,Denver ,2018,0,716265,359269,356996,50.15867032
CO,Denver ,2019,0,727211,364478,362733,50.11997893
CO,Dolores ,2015,0,1981,1040,941,52.49873801
CO,Dolores ,2016,0,2056,1082,974,52.62645914
CO,Dolores ,2017,0,2045,1080,965,52.81173594
CO,Dolores ,2018,0,2060,1079,981,52.37864078
CO,Dolores ,2019,0,2055,1079,976,52.50608273
CO,Douglas ,2015,0,322025,160091,161934,49.71384209
CO,Douglas ,2016,0,328219,163609,164610,49.84751035
CO,Douglas ,2017,0,335816,167638,168178,49.91959883
CO,Douglas ,2018,0,342989,171369,171620,49.96340991
CO,Douglas ,2019,0,351154,175425,175729,49.95671415
CO,Eagle ,2015,0,53865,28575,25290,53.04928989
CO,Eagle ,2016,0,54541,28935,25606,53.05183257
CO,Eagle ,2017,0,54929,29084,25845,52.94835151
CO,Eagle ,2018,0,54943,29081,25862,52.92939956
CO,Eagle ,2019,0,55127,29128,25999,52.83799227
CO,Elbert ,2015,0,24630,12391,12239,50.30856679
CO,Elbert ,2016,0,25157,12623,12534,50.17688914
CO,Elbert ,2017,0,25765,12992,12773,50.42499515
CO,Elbert ,2018,0,26303,13250,13053,50.374482
CO,Elbert ,2019,0,26729,13512,13217,50.55183509
CO,El Paso ,2015,0,674001,339952,334049,50.43790736
CO,El Paso ,2016,0,688277,347955,340322,50.55450059
CO,El Paso ,2017,0,700099,353752,346347,50.52885378
CO,El Paso ,2018,0,712089,359311,352778,50.45872075
CO,El Paso ,2019,0,720403,363854,356549,50.50700788
CO,Fremont ,2015,0,46282,26631,19651,57.54072858
CO,Fremont ,2016,0,46976,27114,19862,57.71883515
CO,Fremont ,2017,0,47548,27521,20027,57.88045764
CO,Fremont ,2018,0,47959,27695,20264,57.74724244
CO,Fremont ,2019,0,47839,27530,20309,57.54718953
CO,Garfield ,2015,0,57698,29364,28334,50.8925786
CO,Garfield ,2016,0,58785,29931,28854,50.91605001
CO,Garfield ,2017,0,59032,30063,28969,50.92661607
CO,Garfield ,2018,0,59701,30483,29218,51.05944624
CO,Garfield ,2019,0,60061,30675,29386,51.07307571
CO,Gilpin ,2015,0,5805,3054,2751,52.60981912
CO,Gilpin ,2016,0,5914,3115,2799,52.67162665
CO,Gilpin ,2017,0,6018,3168,2850,52.64207378
CO,Gilpin ,2018,0,6112,3201,2911,52.3723822
CO,Gilpin ,2019,0,6243,3281,2962,52.55486144
CO,Grand ,2015,0,14726,7841,6885,53.24595953
CO,Grand ,2016,0,15179,8060,7119,53.09967719
CO,Grand ,2017,0,15364,8216,7148,53.47565738
CO,Grand ,2018,0,15511,8316,7195,53.61356457
CO,Grand ,2019,0,15734,8414,7320,53.4765476
CO,Gunnison ,2015,0,16104,8692,7412,53.97416791
CO,Gunnison ,2016,0,16414,8879,7535,54.09406604
CO,Gunnison ,2017,0,16863,9124,7739,54.10662397
CO,Gunnison ,2018,0,17167,9258,7909,53.92904992
CO,Gunnison ,2019,0,17462,9442,8020,54.07169855
CO,Hinsdale ,2015,0,764,397,367,51.96335079
CO,Hinsdale ,2016,0,788,406,382,51.52284264
CO,Hinsdale ,2017,0,791,409,382,51.70670038
CO,Hinsdale ,2018,0,808,419,389,51.85643564
CO,Hinsdale ,2019,0,820,422,398,51.46341463
CO,Huerfano ,2015,0,6404,3244,3160,50.6558401
CO,Huerfano ,2016,0,6580,3365,3215,51.13981763
CO,Huerfano ,2017,0,6628,3371,3257,50.85998793
CO,Huerfano ,2018,0,6887,3497,3390,50.7768259
CO,Huerfano ,2019,0,6897,3521,3376,51.05118167
CO,Jackson ,2015,0,1353,714,639,52.77161863
CO,Jackson ,2016,0,1358,713,645,52.50368189
CO,Jackson ,2017,0,1375,719,656,52.29090909
CO,Jackson ,2018,0,1395,721,674,51.68458781
CO,Jackson ,2019,0,1392,717,675,51.50862069
CO,Jefferson ,2015,0,564888,280855,284033,49.7187053
CO,Jefferson ,2016,0,571413,284314,287099,49.75630586
CO,Jefferson ,2017,0,575417,286960,288457,49.86992042
CO,Jefferson ,2018,0,579392,288907,290485,49.86382277
CO,Jefferson ,2019,0,582881,291103,291778,49.94209796
CO,Kiowa ,2015,0,1384,675,709,48.7716763
CO,Kiowa ,2016,0,1342,643,699,47.91356185
CO,Kiowa ,2017,0,1365,657,708,48.13186813
CO,Kiowa ,2018,0,1379,671,708,48.65844815
CO,Kiowa ,2019,0,1406,688,718,48.93314367
CO,Kit Carson ,2015,0,8215,4600,3615,55.99513086
CO,Kit Carson ,2016,0,7626,4040,3586,52.9766588
CO,Kit Carson ,2017,0,7137,3563,3574,49.92293681
CO,Kit Carson ,2018,0,7159,3569,3590,49.85333147
CO,Kit Carson ,2019,0,7097,3552,3545,50.04931661
CO,Lake ,2015,0,7442,3990,3452,53.61461973
CO,Lake ,2016,0,7590,4085,3505,53.82081686
CO,Lake ,2017,0,7750,4177,3573,53.89677419
CO,Lake ,2018,0,7846,4215,3631,53.7216416
CO,Lake ,2019,0,8127,4384,3743,53.94364464
CO,La Plata ,2015,0,54687,27707,26980,50.66469179
CO,La Plata ,2016,0,55316,27976,27340,50.57487888
CO,La Plata ,2017,0,55563,28061,27502,50.50303259
CO,La Plata ,2018,0,56299,28419,27880,50.47869412
CO,La Plata ,2019,0,56221,28345,27876,50.41710393
CO,Larimer ,2015,0,333303,166174,167129,49.85673696
CO,Larimer ,2016,0,338984,169188,169796,49.91032025
CO,Larimer ,2017,0,344084,171713,172371,49.90438381
CO,Larimer ,2018,0,350660,174963,175697,49.89534022
CO,Larimer ,2019,0,356899,177877,179022,49.83959047
CO,Las Animas ,2015,0,14043,7310,6733,52.05440433
CO,Las Animas ,2016,0,14073,7300,6773,51.87237973
CO,Las Animas ,2017,0,14201,7398,6803,52.09492289
CO,Las Animas ,2018,0,14508,7574,6934,52.20567963
CO,Las Animas ,2019,0,14506,7578,6928,52.24045223
CO,Lincoln ,2015,0,5543,3242,2301,58.48818329
CO,Lincoln ,2016,0,5551,3181,2370,57.30499009
CO,Lincoln ,2017,0,5523,3170,2353,57.39634257
CO,Lincoln ,2018,0,5606,3253,2353,58.02711381
CO,Lincoln ,2019,0,5701,3332,2369,58.44588669
CO,Logan ,2015,0,22472,12790,9682,56.91527234
CO,Logan ,2016,0,22435,12814,9621,57.11611322
CO,Logan ,2017,0,22317,12752,9565,57.14029663
CO,Logan ,2018,0,22268,12736,9532,57.19417999
CO,Logan ,2019,0,22409,12829,9580,57.24931947
CO,Mesa ,2015,0,148025,73238,74787,49.47677757
CO,Mesa ,2016,0,149736,74064,75672,49.46305498
CO,Mesa ,2017,0,151170,74753,76417,49.44962625
CO,Mesa ,2018,0,152951,75661,77290,49.46747651
CO,Mesa ,2019,0,154210,76328,77882,49.49614163
CO,Mineral ,2015,0,744,384,360,51.61290323
CO,Mineral ,2016,0,756,380,376,50.26455026
CO,Mineral ,2017,0,753,376,377,49.93359894
CO,Mineral ,2018,0,772,382,390,49.48186528
CO,Mineral ,2019,0,769,387,382,50.32509753
CO,Moffat ,2015,0,12939,6661,6278,51.48002164
CO,Moffat ,2016,0,13144,6747,6397,51.33140596
CO,Moffat ,2017,0,13088,6697,6391,51.16900978
CO,Moffat ,2018,0,13183,6756,6427,51.24781916
CO,Moffat ,2019,0,13283,6793,6490,51.1405556
CO,Montezuma ,2015,0,25716,12704,13012,49.40115103
CO,Montezuma ,2016,0,25994,12822,13172,49.32676772
CO,Montezuma ,2017,0,26112,12878,13234,49.31832108
CO,Montezuma ,2018,0,26152,12878,13274,49.24288773
CO,Montezuma ,2019,0,26183,12915,13268,49.32589848
CO,Montrose ,2015,0,40562,19961,20601,49.21108427
CO,Montrose ,2016,0,41151,20269,20882,49.25518213
CO,Montrose ,2017,0,41753,20558,21195,49.23718056
CO,Montrose ,2018,0,42206,20781,21425,49.2370753
CO,Montrose ,2019,0,42758,21041,21717,49.20950465
CO,Morgan ,2015,0,28252,14153,14099,50.09556846
CO,Morgan ,2016,0,28199,14117,14082,50.06205894
CO,Morgan ,2017,0,28295,14266,14029,50.41880191
CO,Morgan ,2018,0,28769,14574,14195,50.65869512
CO,Morgan ,2019,0,29068,14819,14249,50.98045961
CO,Otero ,2015,0,18182,8959,9223,49.27400726
CO,Otero ,2016,0,18266,8981,9285,49.16785284
CO,Otero ,2017,0,18345,9013,9332,49.13055328
CO,Otero ,2018,0,18338,8980,9358,48.96935326
CO,Otero ,2019,0,18278,8949,9329,48.96049896
CO,Ouray ,2015,0,4608,2309,2299,50.10850694
CO,Ouray ,2016,0,4789,2408,2381,50.28189601
CO,Ouray ,2017,0,4813,2434,2379,50.57136921
CO,Ouray ,2018,0,4822,2434,2388,50.47698051
CO,Ouray ,2019,0,4952,2510,2442,50.68659128
CO,Park ,2015,0,16726,8857,7869,52.95348559
CO,Park ,2016,0,17343,9197,8146,53.03004094
CO,Park ,2017,0,17894,9464,8430,52.88923662
CO,Park ,2018,0,18525,9758,8767,52.67476383
CO,Park ,2019,0,18845,9930,8915,52.69302202
CO,Phillips ,2015,0,4327,2115,2212,48.87913104
CO,Phillips ,2016,0,4280,2096,2184,48.97196262
CO,Phillips ,2017,0,4288,2123,2165,49.51026119
CO,Phillips ,2018,0,4285,2112,2173,49.2882147
CO,Phillips ,2019,0,4265,2090,2175,49.003517
CO,Pitkin ,2015,0,17940,9353,8587,52.13489409
CO,Pitkin ,2016,0,17975,9369,8606,52.12239221
CO,Pitkin ,2017,0,17973,9321,8652,51.86112502
CO,Pitkin ,2018,0,17976,9271,8705,51.57432132
CO,Pitkin ,2019,0,17767,9198,8569,51.77013564
CO,Prowers ,2015,0,11936,5987,5949,50.15918231
CO,Prowers ,2016,0,11926,5995,5931,50.26832131
CO,Prowers ,2017,0,11998,6011,5987,50.10001667
CO,Prowers ,2018,0,12079,6071,6008,50.26078318
CO,Prowers ,2019,0,12172,6141,6031,50.45185672
CO,Pueblo ,2015,0,163006,80330,82676,49.28039459
CO,Pueblo ,2016,0,164774,81173,83601,49.26323328
CO,Pueblo ,2017,0,166283,82000,84283,49.31351972
CO,Pueblo ,2018,0,167422,82533,84889,49.29638877
CO,Pueblo ,2019,0,168424,83072,85352,49.32313685
CO,Rio Blanco ,2015,0,6478,3311,3167,51.11145415
CO,Rio Blanco ,2016,0,6436,3303,3133,51.32069608
CO,Rio Blanco ,2017,0,6352,3257,3095,51.27518892
CO,Rio Blanco ,2018,0,6330,3237,3093,51.13744076
CO,Rio Blanco ,2019,0,6324,3236,3088,51.17014548
CO,Rio Grande ,2015,0,11352,5642,5710,49.70049331
CO,Rio Grande ,2016,0,11337,5598,5739,49.37814237
CO,Rio Grande ,2017,0,11297,5628,5669,49.81853589
CO,Rio Grande ,2018,0,11271,5626,5645,49.91571289
CO,Rio Grande ,2019,0,11267,5633,5634,49.99556226
CO,Routt ,2015,0,24360,12749,11611,52.33579639
CO,Routt ,2016,0,24682,12883,11799,52.19593226
CO,Routt ,2017,0,25171,13132,12039,52.17114934
CO,Routt ,2018,0,25507,13287,12220,52.0915827
CO,Routt ,2019,0,25638,13294,12344,51.85271862
CO,Saguache ,2015,0,6253,3127,3126,50.00799616
CO,Saguache ,2016,0,6412,3225,3187,50.2963194
CO,Saguache ,2017,0,6633,3321,3312,50.06784261
CO,Saguache ,2018,0,6840,3424,3416,50.05847953
CO,Saguache ,2019,0,6824,3393,3431,49.72157093
CO,San Juan ,2015,0,689,383,306,55.58780842
CO,San Juan ,2016,0,691,391,300,56.58465991
CO,San Juan ,2017,0,712,410,302,57.58426966
CO,San Juan ,2018,0,764,429,335,56.15183246
CO,San Juan ,2019,0,728,401,327,55.08241758
CO,San Miguel ,2015,0,7836,4185,3651,53.40735069
CO,San Miguel ,2016,0,8017,4278,3739,53.36160659
CO,San Miguel ,2017,0,8034,4290,3744,53.39805825
CO,San Miguel ,2018,0,8180,4356,3824,53.25183374
CO,San Miguel ,2019,0,8179,4318,3861,52.79374007
CO,Sedgwick ,2015,0,2373,1179,1194,49.68394437
CO,Sedgwick ,2016,0,2400,1186,1214,49.41666667
CO,Sedgwick ,2017,0,2311,1135,1176,49.11293812
CO,Sedgwick ,2018,0,2276,1119,1157,49.16520211
CO,Sedgwick ,2019,0,2248,1117,1131,49.6886121
CO,Summit ,2015,0,30045,16239,13806,54.04892661
CO,Summit ,2016,0,30552,16587,13965,54.29104478
CO,Summit ,2017,0,30820,16702,14118,54.19208306
CO,Summit ,2018,0,30817,16790,14027,54.48291527
CO,Summit ,2019,0,31011,16958,14053,54.68382187
CO,Teller ,2015,0,23388,11874,11514,50.76962545
CO,Teller ,2016,0,24058,12191,11867,50.67337268
CO,Teller ,2017,0,24674,12551,12123,50.86730972
CO,Teller ,2018,0,25113,12742,12371,50.73866125
CO,Teller ,2019,0,25388,12871,12517,50.69717977
CO,Washington ,2015,0,4786,2491,2295,52.04763895
CO,Washington ,2016,0,4834,2528,2306,52.296235
CO,Washington ,2017,0,4921,2558,2363,51.98130461
CO,Washington ,2018,0,4888,2541,2347,51.98445172
CO,Washington ,2019,0,4908,2559,2349,52.1393643
CO,Weld ,2015,0,285819,144199,141620,50.45115965
CO,Weld ,2016,0,295712,149331,146381,50.49879613
CO,Weld ,2017,0,305885,154486,151399,50.5046014
CO,Weld ,2018,0,314815,159094,155721,50.53571145
CO,Weld ,2019,0,324492,164147,160345,50.58583879
CO,Yuma ,2015,0,10037,4983,5054,49.64630866
CO,Yuma ,2016,0,10055,5001,5054,49.73644953
CO,Yuma ,2017,0,9959,4956,5003,49.76403253
CO,Yuma ,2018,0,9947,4952,4995,49.78385443
CO,Yuma ,2019,0,10019,5015,5004,50.0548957
CT,Fairfield ,2015,0,944943,460147,484796,48.69574144
CT,Fairfield ,2016,0,944347,459781,484566,48.68771754
CT,Fairfield ,2017,0,943038,459242,483796,48.69814366
CT,Fairfield ,2018,0,943971,459794,484177,48.70848787
CT,Fairfield ,2019,0,943332,459410,483922,48.70077555
CT,Hartford ,2015,0,896290,435122,461168,48.54701045
CT,Hartford ,2016,0,894141,434256,459885,48.56683677
CT,Hartford ,2017,0,893076,433833,459243,48.57738871
CT,Hartford ,2018,0,892580,433437,459143,48.56001703
CT,Hartford ,2019,0,891720,433204,458516,48.58072041
CT,Litchfield ,2015,0,184122,90916,93206,49.37812972
CT,Litchfield ,2016,0,182793,90310,92483,49.40561181
CT,Litchfield ,2017,0,181667,89749,91918,49.40302862
CT,Litchfield ,2018,0,181095,89526,91569,49.43593142
CT,Litchfield ,2019,0,180333,89293,91040,49.51561833
CT,Middlesex ,2015,0,163724,79837,83887,48.7631624
CT,Middlesex ,2016,0,163292,79596,83696,48.74458026
CT,Middlesex ,2017,0,162942,79376,83566,48.71426643
CT,Middlesex ,2018,0,162870,79348,83522,48.71860993
CT,Middlesex ,2019,0,162436,79060,83376,48.67147677
CT,New Haven ,2015,0,860186,414732,445454,48.21422344
CT,New Haven ,2016,0,857901,413542,444359,48.20393029
CT,New Haven ,2017,0,857748,413560,444188,48.21462714
CT,New Haven ,2018,0,856971,413207,443764,48.21715087
CT,New Haven ,2019,0,854757,412089,442668,48.211246
CT,New London ,2015,0,269636,135000,134636,50.06749841
CT,New London ,2016,0,268403,134571,133832,50.13766612
CT,New London ,2017,0,267419,134088,133331,50.14153819
CT,New London ,2018,0,266285,133446,132839,50.11397563
CT,New London ,2019,0,265206,133006,132200,50.15195735
CT,Tolland ,2015,0,151734,76095,75639,50.15026296
CT,Tolland ,2016,0,151162,75650,75512,50.04564639
CT,Tolland ,2017,0,151009,75533,75476,50.01887305
CT,Tolland ,2018,0,150689,75411,75278,50.04413063
CT,Tolland ,2019,0,150721,75396,75325,50.02355345
CT,Windham ,2015,0,116487,57829,58658,49.6441663
CT,Windham ,2016,0,116102,57525,58577,49.5469501
CT,Windham ,2017,0,116398,57677,58721,49.55153869
CT,Windham ,2018,0,117059,57954,59105,49.50836758
CT,Windham ,2019,0,116782,57959,58823,49.63007998
DE,Kent ,2015,0,173128,83476,89652,48.2163486
DE,Kent ,2016,0,174542,84097,90445,48.18152651
DE,Kent ,2017,0,176499,84991,91508,48.1538139
DE,Kent ,2018,0,178540,86049,92491,48.19592248
DE,Kent ,2019,0,180786,87058,93728,48.15527751
DE,New Castle ,2015,0,553488,268150,285338,48.44730148
DE,New Castle ,2016,0,555058,268696,286362,48.40863477
DE,New Castle ,2017,0,555976,269008,286968,48.38482237
DE,New Castle ,2018,0,557550,269862,287688,48.40139898
DE,New Castle ,2019,0,558753,270456,288297,48.4034985
DE,Sussex ,2015,0,214636,104013,110623,48.46018375
DE,Sussex ,2016,0,219321,106147,113174,48.39801022
DE,Sussex ,2017,0,224348,108590,115758,48.40248186
DE,Sussex ,2018,0,229389,110927,118462,48.35759343
DE,Sussex ,2019,0,234225,113279,120946,48.36332586
DC,District of Columbia,2015,0,675400,320302,355098,47.42404501
DC,District of Columbia,2016,0,685815,325465,360350,47.45667563
DC,District of Columbia,2017,0,694906,329599,365307,47.43073164
DC,District of Columbia,2018,0,701547,332904,368643,47.4528435
DC,District of Columbia,2019,0,705749,334711,371038,47.42635129
FL,Alachua ,2015,0,259052,125383,133669,48.40070719
FL,Alachua ,2016,0,263959,127745,136214,48.39577359
FL,Alachua ,2017,0,266309,128758,137551,48.34909823
FL,Alachua ,2018,0,268851,129748,139103,48.26018873
FL,Alachua ,2019,0,269043,129680,139363,48.20047353
FL,Baker ,2015,0,27355,14295,13060,52.25735697
FL,Baker ,2016,0,27884,14641,13243,52.50681394
FL,Baker ,2017,0,28254,14874,13380,52.64387343
FL,Baker ,2018,0,28353,14922,13431,52.62935139
FL,Baker ,2019,0,29210,15365,13845,52.60184868
FL,Bay ,2015,0,181488,90377,91111,49.79778277
FL,Bay ,2016,0,183634,91445,92189,49.79742314
FL,Bay ,2017,0,184736,91977,92759,49.78834661
FL,Bay ,2018,0,186240,92404,93836,49.61554983
FL,Bay ,2019,0,174705,86622,88083,49.58186658
FL,Bradford ,2015,0,26748,14566,12182,54.45640796
FL,Bradford ,2016,0,26740,14536,12204,54.3605086
FL,Bradford ,2017,0,27142,14744,12398,54.32171542
FL,Bradford ,2018,0,27752,15327,12425,55.228452
FL,Bradford ,2019,0,28201,15692,12509,55.6434169
FL,Brevard ,2015,0,565746,276546,289200,48.8816536
FL,Brevard ,2016,0,576874,281866,295008,48.86092977
FL,Brevard ,2017,0,587769,287247,300522,48.87072983
FL,Brevard ,2018,0,595203,291187,304016,48.92230046
FL,Brevard ,2019,0,601942,294384,307558,48.90570852
FL,Broward ,2015,0,1885040,917471,967569,48.67116878
FL,Broward ,2016,0,1912583,931399,981184,48.69848786
FL,Broward ,2017,0,1934516,942414,992102,48.71575112
FL,Broward ,2018,0,1946107,947590,998517,48.69156732
FL,Broward ,2019,0,1952778,950870,1001908,48.69319503
FL,Calhoun ,2015,0,14406,7840,6566,54.42176871
FL,Calhoun ,2016,0,14330,7776,6554,54.26378227
FL,Calhoun ,2017,0,14428,7870,6558,54.54671472
FL,Calhoun ,2018,0,14543,7932,6611,54.54170391
FL,Calhoun ,2019,0,14105,7613,6492,53.97376817
FL,Charlotte ,2015,0,172382,83879,88503,48.65879268
FL,Charlotte ,2016,0,177671,86657,91014,48.7738573
FL,Charlotte ,2017,0,181522,88453,93069,48.72852877
FL,Charlotte ,2018,0,184849,90134,94715,48.7608805
FL,Charlotte ,2019,0,188910,92036,96874,48.71949606
FL,Citrus ,2015,0,140287,67880,72407,48.38652192
FL,Citrus ,2016,0,142804,68930,73874,48.26895605
FL,Citrus ,2017,0,145415,70393,75022,48.40834852
FL,Citrus ,2018,0,147682,71590,76092,48.47577904
FL,Citrus ,2019,0,149657,72571,77086,48.49155068
FL,Clay ,2015,0,202392,99735,102657,49.27813352
FL,Clay ,2016,0,207246,102020,105226,49.22652307
FL,Clay ,2017,0,212228,104587,107641,49.28049079
FL,Clay ,2018,0,215908,106537,109371,49.34370195
FL,Clay ,2019,0,219252,108161,111091,49.33181909
FL,Collier ,2015,0,356041,175596,180445,49.3190391
FL,Collier ,2016,0,365445,179960,185485,49.2440723
FL,Collier ,2017,0,372678,183561,189117,49.25458439
FL,Collier ,2018,0,378201,186291,191910,49.25714104
FL,Collier ,2019,0,384902,189649,195253,49.27202249
FL,Columbia ,2015,0,68222,35390,32832,51.87476181
FL,Columbia ,2016,0,69265,35896,33369,51.82415361
FL,Columbia ,2017,0,69999,36175,33824,51.6793097
FL,Columbia ,2018,0,70668,36462,34206,51.5961963
FL,Columbia ,2019,0,71686,37103,34583,51.75766537
FL,DeSoto ,2015,0,35648,20274,15374,56.87275583
FL,DeSoto ,2016,0,36255,20622,15633,56.88043029
FL,DeSoto ,2017,0,37241,21160,16081,56.81909723
FL,DeSoto ,2018,0,37368,21098,16270,56.46007279
FL,DeSoto ,2019,0,38001,21395,16606,56.30114997
FL,Dixie ,2015,0,16353,8968,7385,54.8400905
FL,Dixie ,2016,0,16465,9074,7391,55.11084118
FL,Dixie ,2017,0,16615,9138,7477,54.99849534
FL,Dixie ,2018,0,16685,9198,7487,55.1273599
FL,Dixie ,2019,0,16826,9278,7548,55.14085344
FL,Duval ,2015,0,910578,441851,468727,48.52423406
FL,Duval ,2016,0,926010,449505,476505,48.54213237
FL,Duval ,2017,0,937933,454866,483067,48.49664102
FL,Duval ,2018,0,948652,459755,488897,48.46403107
FL,Duval ,2019,0,957755,464225,493530,48.47012023
FL,Escambia ,2015,0,309311,153822,155489,49.73053011
FL,Escambia ,2016,0,311473,154356,157117,49.55678341
FL,Escambia ,2017,0,313249,155087,158162,49.50917641
FL,Escambia ,2018,0,315104,155911,159193,49.47921956
FL,Escambia ,2019,0,318316,157221,161095,49.39148519
FL,Flagler ,2015,0,104436,50277,54159,48.14144548
FL,Flagler ,2016,0,107406,51690,55716,48.12580303
FL,Flagler ,2017,0,109999,52891,57108,48.08316439
FL,Flagler ,2018,0,112085,53980,58105,48.15987866
FL,Flagler ,2019,0,115081,55374,59707,48.11741295
FL,Franklin ,2015,0,11707,6735,4972,57.5296831
FL,Franklin ,2016,0,11823,6766,5057,57.22743804
FL,Franklin ,2017,0,11724,6659,5065,56.79802115
FL,Franklin ,2018,0,11676,6508,5168,55.73826653
FL,Franklin ,2019,0,12125,6902,5223,56.92371134
FL,Gadsden ,2015,0,46060,21857,24203,47.45332175
FL,Gadsden ,2016,0,46086,21935,24151,47.59579916
FL,Gadsden ,2017,0,45993,21903,24090,47.62246429
FL,Gadsden ,2018,0,45927,21806,24121,47.47969604
FL,Gadsden ,2019,0,45660,21675,23985,47.47043364
FL,Gilchrist ,2015,0,17378,9038,8340,52.00828634
FL,Gilchrist ,2016,0,17622,9149,8473,51.91805697
FL,Gilchrist ,2017,0,17900,9254,8646,51.69832402
FL,Gilchrist ,2018,0,18284,9451,8833,51.69000219
FL,Gilchrist ,2019,0,18582,9588,8994,51.59832096
FL,Glades ,2015,0,13099,7400,5699,56.49286205
FL,Glades ,2016,0,13406,7516,5890,56.06444875
FL,Glades ,2017,0,13580,7572,6008,55.75846834
FL,Glades ,2018,0,13686,7679,6007,56.10843197
FL,Glades ,2019,0,13811,7700,6111,55.75266092
FL,Gulf ,2015,0,15929,9510,6419,59.70242953
FL,Gulf ,2016,0,16062,9526,6536,59.30768273
FL,Gulf ,2017,0,16105,9447,6658,58.65880161
FL,Gulf ,2018,0,16146,9460,6686,58.59036294
FL,Gulf ,2019,0,13639,6890,6749,50.51690007
FL,Hamilton ,2015,0,14272,8229,6043,57.65835202
FL,Hamilton ,2016,0,14303,8281,6022,57.8969447
FL,Hamilton ,2017,0,14364,8358,6006,58.1871345
FL,Hamilton ,2018,0,14262,8259,6003,57.90912915
FL,Hamilton ,2019,0,14428,8347,6081,57.85278625
FL,Hardee ,2015,0,27177,14444,12733,53.1478824
FL,Hardee ,2016,0,27219,14485,12734,53.21650318
FL,Hardee ,2017,0,27154,14366,12788,52.90564926
FL,Hardee ,2018,0,27168,14355,12813,52.83789753
FL,Hardee ,2019,0,26937,14232,12705,52.83439136
FL,Hendry ,2015,0,39248,20609,18639,52.50968202
FL,Hendry ,2016,0,40037,21085,18952,52.663786
FL,Hendry ,2017,0,41018,21619,19399,52.70612902
FL,Hendry ,2018,0,41336,21852,19484,52.86433133
FL,Hendry ,2019,0,42022,22255,19767,52.9603541
FL,Hernando ,2015,0,177900,85234,92666,47.91118606
FL,Hernando ,2016,0,182459,87575,94884,47.99708428
FL,Hernando ,2017,0,186704,89778,96926,48.08573999
FL,Hernando ,2018,0,190582,91856,98726,48.19762622
FL,Hernando ,2019,0,193920,93470,100450,48.20028878
FL,Highlands ,2015,0,100137,48752,51385,48.68530114
FL,Highlands ,2016,0,102041,49856,52185,48.85879205
FL,Highlands ,2017,0,103852,50740,53112,48.85799022
FL,Highlands ,2018,0,104933,51218,53715,48.81019317
FL,Highlands ,2019,0,106221,51882,54339,48.84344904
FL,Hillsborough ,2015,0,1364073,665697,698376,48.80215355
FL,Hillsborough ,2016,0,1396693,681997,714696,48.82941348
FL,Hillsborough ,2017,0,1426736,697571,729165,48.89278745
FL,Hillsborough ,2018,0,1451919,710366,741553,48.92600758
FL,Hillsborough ,2019,0,1471968,720329,751639,48.93645786
FL,Holmes ,2015,0,19273,10247,9026,53.16764385
FL,Holmes ,2016,0,19398,10316,9082,53.18074028
FL,Holmes ,2017,0,19427,10341,9086,53.23004067
FL,Holmes ,2018,0,19443,10327,9116,53.11423134
FL,Holmes ,2019,0,19617,10425,9192,53.14268237
FL,Indian River ,2015,0,147434,70735,76699,47.97740006
FL,Indian River ,2016,0,151159,72514,78645,47.97200299
FL,Indian River ,2017,0,154241,74067,80174,48.02030588
FL,Indian River ,2018,0,157187,75498,81689,48.03068956
FL,Indian River ,2019,0,159923,76759,83164,47.99747378
FL,Jackson ,2015,0,48609,26859,21750,55.25519965
FL,Jackson ,2016,0,48299,26671,21628,55.22060498
FL,Jackson ,2017,0,48289,26607,21682,55.09950506
FL,Jackson ,2018,0,48112,26505,21607,55.09020619
FL,Jackson ,2019,0,46414,25020,21394,53.90614901
FL,Jefferson ,2015,0,14115,7425,6690,52.60361318
FL,Jefferson ,2016,0,13960,7296,6664,52.26361032
FL,Jefferson ,2017,0,14165,7408,6757,52.2979174
FL,Jefferson ,2018,0,14321,7500,6821,52.37064451
FL,Jefferson ,2019,0,14246,7485,6761,52.54106416
FL,Lafayette ,2015,0,8724,5140,3584,58.91792756
FL,Lafayette ,2016,0,8747,5150,3597,58.87732937
FL,Lafayette ,2017,0,8602,4931,3671,57.32387817
FL,Lafayette ,2018,0,8691,4952,3739,56.97848349
FL,Lafayette ,2019,0,8422,4720,3702,56.04369508
FL,Lake ,2015,0,325154,157443,167711,48.42105587
FL,Lake ,2016,0,334913,162009,172904,48.37345818
FL,Lake ,2017,0,345432,167074,178358,48.36668288
FL,Lake ,2018,0,356720,172687,184033,48.40967706
FL,Lake ,2019,0,367118,177787,189331,48.42775347
FL,Lee ,2015,0,699644,342608,357036,48.96890419
FL,Lee ,2016,0,722649,353929,368720,48.97661244
FL,Lee ,2017,0,740000,362589,377411,48.99851351
FL,Lee ,2018,0,754470,369594,384876,48.98723607
FL,Lee ,2019,0,770577,377301,393276,48.96343909
FL,Leon ,2015,0,285904,135954,149950,47.55232526
FL,Leon ,2016,0,286744,136331,150413,47.54449962
FL,Leon ,2017,0,290965,138155,152810,47.48165587
FL,Leon ,2018,0,291657,138207,153450,47.38682768
FL,Leon ,2019,0,293582,138806,154776,47.2801466
FL,Levy ,2015,0,39601,19447,20154,49.10734577
FL,Levy ,2016,0,39837,19553,20284,49.08251123
FL,Levy ,2017,0,40276,19711,20565,48.93981527
FL,Levy ,2018,0,40798,19961,20837,48.92641796
FL,Levy ,2019,0,41503,20296,21207,48.90248898
FL,Liberty ,2015,0,8409,5178,3231,61.57688191
FL,Liberty ,2016,0,8300,5131,3169,61.81927711
FL,Liberty ,2017,0,8236,5045,3191,61.25546382
FL,Liberty ,2018,0,8427,5213,3214,61.86068589
FL,Liberty ,2019,0,8354,5169,3185,61.87455111
FL,Madison ,2015,0,18478,9761,8717,52.82498106
FL,Madison ,2016,0,18316,9685,8631,52.87726578
FL,Madison ,2017,0,18474,9847,8627,53.30193786
FL,Madison ,2018,0,18540,9842,8698,53.08522114
FL,Madison ,2019,0,18493,9821,8672,53.10658087
FL,Manatee ,2015,0,362548,175301,187247,48.35249401
FL,Manatee ,2016,0,375373,181370,194003,48.31727375
FL,Manatee ,2017,0,385506,186419,199087,48.35696461
FL,Manatee ,2018,0,394387,190618,203769,48.33272902
FL,Manatee ,2019,0,403253,194807,208446,48.30887805
FL,Marion ,2015,0,342182,164262,177920,48.00427842
FL,Marion ,2016,0,347469,166953,180516,48.0483151
FL,Marion ,2017,0,353339,169645,183694,48.01196585
FL,Marion ,2018,0,359062,172251,186811,47.972495
FL,Marion ,2019,0,365579,175184,190395,47.91960151
FL,Martin ,2015,0,155559,76975,78584,49.48283288
FL,Martin ,2016,0,158325,78253,80072,49.42554871
FL,Martin ,2017,0,159701,78883,80818,49.39418037
FL,Martin ,2018,0,160742,79358,81384,49.36979756
FL,Martin ,2019,0,161000,79574,81426,49.42484472
FL,Miami-Dade ,2015,0,2659839,1292164,1367675,48.58053439
FL,Miami-Dade ,2016,0,2692213,1308460,1383753,48.60165225
FL,Miami-Dade ,2017,0,2713295,1318403,1394892,48.59047763
FL,Miami-Dade ,2018,0,2714854,1319237,1395617,48.59329452
FL,Miami-Dade ,2019,0,2716940,1320180,1396760,48.59069394
FL,Monroe ,2015,0,76648,40123,36525,52.34709321
FL,Monroe ,2016,0,76872,40115,36757,52.18415028
FL,Monroe ,2017,0,76483,39866,36617,52.12400141
FL,Monroe ,2018,0,74757,38958,35799,52.11284562
FL,Monroe ,2019,0,74228,38454,35774,51.80524869
FL,Nassau ,2015,0,77951,38354,39597,49.20270426
FL,Nassau ,2016,0,80055,39398,40657,49.2136656
FL,Nassau ,2017,0,82925,40773,42152,49.16852578
FL,Nassau ,2018,0,85936,42227,43709,49.1377304
FL,Nassau ,2019,0,88625,43523,45102,49.10916784
FL,Okaloosa ,2015,0,197748,100402,97346,50.77270061
FL,Okaloosa ,2016,0,200071,101516,98555,50.7399873
FL,Okaloosa ,2017,0,203478,103224,100254,50.72980863
FL,Okaloosa ,2018,0,206934,104932,102002,50.70795519
FL,Okaloosa ,2019,0,210738,106779,103959,50.66907724
FL,Okeechobee ,2015,0,39854,21276,18578,53.38485472
FL,Okeechobee ,2016,0,40769,21844,18925,53.57992592
FL,Okeechobee ,2017,0,41275,22148,19127,53.65960024
FL,Okeechobee ,2018,0,41654,22326,19328,53.598694
FL,Okeechobee ,2019,0,42168,22637,19531,53.6828875
FL,Orange ,2015,0,1291301,633647,657654,49.07043362
FL,Orange ,2016,0,1326516,650722,675794,49.05496805
FL,Orange ,2017,0,1355921,664891,691030,49.03611641
FL,Orange ,2018,0,1381540,677354,704186,49.02890977
FL,Orange ,2019,0,1393452,683793,709659,49.0718733
FL,Osceola ,2015,0,323736,159340,164396,49.21911681
FL,Osceola ,2016,0,338209,166636,171573,49.27012587
FL,Osceola ,2017,0,353623,174281,179342,49.28440741
FL,Osceola ,2018,0,368456,181850,186606,49.35460408
FL,Osceola ,2019,0,375751,185592,190159,49.39228372
FL,Palm Beach ,2015,0,1424256,690223,734033,48.46200402
FL,Palm Beach ,2016,0,1450890,703040,747850,48.45577542
FL,Palm Beach ,2017,0,1470344,712747,757597,48.4748467
FL,Palm Beach ,2018,0,1482876,718909,763967,48.4807226
FL,Palm Beach ,2019,0,1496770,725445,771325,48.4673664
FL,Pasco ,2015,0,494895,240798,254097,48.65638166
FL,Pasco ,2016,0,509937,248277,261660,48.68777908
FL,Pasco ,2017,0,525141,255363,269778,48.62751147
FL,Pasco ,2018,0,539090,261989,277101,48.59837875
FL,Pasco ,2019,0,553947,269315,284632,48.61746701
FL,Pinellas ,2015,0,947060,454624,492436,48.00371677
FL,Pinellas ,2016,0,959874,460894,498980,48.01609378
FL,Pinellas ,2017,0,968341,464959,503382,48.0160398
FL,Pinellas ,2018,0,973058,467102,505956,48.00351058
FL,Pinellas ,2019,0,974996,468101,506895,48.01055594
FL,Polk ,2015,0,648523,317805,330718,49.00443007
FL,Polk ,2016,0,665823,326165,339658,48.98674272
FL,Polk ,2017,0,685368,335901,349467,49.01031271
FL,Polk ,2018,0,706597,346240,360357,49.00105718
FL,Polk ,2019,0,724777,355420,369357,49.03853185
FL,Putnam ,2015,0,71939,35524,36415,49.38072534
FL,Putnam ,2016,0,72373,35763,36610,49.41483702
FL,Putnam ,2017,0,73384,36313,37071,49.48353865
FL,Putnam ,2018,0,74043,36682,37361,49.54148265
FL,Putnam ,2019,0,74521,36909,37612,49.52832088
FL,St. Johns ,2015,0,226362,110436,115926,48.78734063
FL,St. Johns ,2016,0,234828,114551,120277,48.78080978
FL,St. Johns ,2017,0,243693,118732,124961,48.72195754
FL,St. Johns ,2018,0,253814,123710,130104,48.74041621
FL,St. Johns ,2019,0,264672,128943,135729,48.71803591
FL,St. Lucie ,2015,0,297282,145198,152084,48.84184041
FL,St. Lucie ,2016,0,305566,149291,156275,48.8572027
FL,St. Lucie ,2017,0,313163,152888,160275,48.82058225
FL,St. Lucie ,2018,0,320425,156394,164031,48.80830147
FL,St. Lucie ,2019,0,328297,160134,168163,48.77717433
FL,Santa Rosa ,2015,0,166226,85233,80993,51.27537208
FL,Santa Rosa ,2016,0,169894,87024,82870,51.22252699
FL,Santa Rosa ,2017,0,174049,88793,85256,51.01609317
FL,Santa Rosa ,2018,0,179295,91394,87901,50.97409298
FL,Santa Rosa ,2019,0,184313,93940,90373,50.96764743
FL,Sarasota ,2015,0,404761,193374,211387,47.77485973
FL,Sarasota ,2016,0,412968,197075,215893,47.72161523
FL,Sarasota ,2017,0,419680,199988,219692,47.65249714
FL,Sarasota ,2018,0,426329,203097,223232,47.63856083
FL,Sarasota ,2019,0,433742,206575,227167,47.62623864
FL,Seminole ,2015,0,448318,216617,231701,48.31771198
FL,Seminole ,2016,0,455945,220326,235619,48.32293369
FL,Seminole ,2017,0,462801,223736,239065,48.34388863
FL,Seminole ,2018,0,468122,226191,241931,48.31881433
FL,Seminole ,2019,0,471826,228175,243651,48.35998864
FL,Sumter ,2015,0,117076,59043,58033,50.43134374
FL,Sumter ,2016,0,122009,61109,60900,50.08564942
FL,Sumter ,2017,0,124995,62419,62576,49.93719749
FL,Sumter ,2018,0,128719,64183,64536,49.86287961
FL,Sumter ,2019,0,132420,65847,66573,49.72587222
FL,Suwannee ,2015,0,43677,22911,20766,52.45552579
FL,Suwannee ,2016,0,43834,22890,20944,52.2197381
FL,Suwannee ,2017,0,44124,22950,21174,52.0125102
FL,Suwannee ,2018,0,44179,22750,21429,51.49505421
FL,Suwannee ,2019,0,44417,22851,21566,51.44651823
FL,Taylor ,2015,0,22355,12543,9812,56.10825319
FL,Taylor ,2016,0,22099,12268,9831,55.51382415
FL,Taylor ,2017,0,21781,11919,9862,54.72200542
FL,Taylor ,2018,0,21545,11710,9835,54.35135762
FL,Taylor ,2019,0,21569,11713,9856,54.30478928
FL,Union ,2015,0,15265,9929,5336,65.0442188
FL,Union ,2016,0,15238,9952,5286,65.31040819
FL,Union ,2017,0,15448,10109,5339,65.43889177
FL,Union ,2018,0,15328,10019,5309,65.36403967
FL,Union ,2019,0,15237,9843,5394,64.59933058
FL,Volusia ,2015,0,516730,251988,264742,48.76589321
FL,Volusia ,2016,0,528453,257653,270800,48.75608616
FL,Volusia ,2017,0,537868,262165,275703,48.74151279
FL,Volusia ,2018,0,546101,266310,279791,48.76570451
FL,Volusia ,2019,0,553284,269803,283481,48.76392594
FL,Wakulla ,2015,0,31523,17346,14177,55.0264886
FL,Wakulla ,2016,0,31882,17427,14455,54.66093721
FL,Wakulla ,2017,0,32050,17315,14735,54.024961
FL,Wakulla ,2018,0,32413,17306,15107,53.39215747
FL,Wakulla ,2019,0,33739,18239,15500,54.05910074
FL,Walton ,2015,0,63066,31999,31067,50.73890845
FL,Walton ,2016,0,65421,33145,32276,50.66415983
FL,Walton ,2017,0,68021,34509,33512,50.73286191
FL,Walton ,2018,0,70732,35805,34927,50.6206526
FL,Walton ,2019,0,74071,37388,36683,50.47589475
FL,Washington ,2015,0,24552,13426,11126,54.68393614
FL,Washington ,2016,0,24454,13267,11187,54.25288296
FL,Washington ,2017,0,24546,13264,11282,54.03731769
FL,Washington ,2018,0,24793,13309,11484,53.68047433
FL,Washington ,2019,0,25473,13794,11679,54.15145448
GA,Appling ,2015,0,18423,9193,9230,49.89958204
GA,Appling ,2016,0,18428,9214,9214,50
GA,Appling ,2017,0,18438,9209,9229,49.94576418
GA,Appling ,2018,0,18526,9243,9283,49.89204361
GA,Appling ,2019,0,18386,9157,9229,49.80419885
GA,Atkinson ,2015,0,8340,4207,4133,50.44364508
GA,Atkinson ,2016,0,8244,4146,4098,50.29112082
GA,Atkinson ,2017,0,8182,4127,4055,50.43999022
GA,Atkinson ,2018,0,8262,4164,4098,50.39941903
GA,Atkinson ,2019,0,8165,4146,4019,50.77770974
GA,Bacon ,2015,0,11231,5533,5698,49.26542605
GA,Bacon ,2016,0,11275,5530,5745,49.04656319
GA,Bacon ,2017,0,11205,5487,5718,48.96921017
GA,Bacon ,2018,0,11132,5442,5690,48.88609414
GA,Bacon ,2019,0,11164,5455,5709,48.86241491
GA,Baker ,2015,0,3194,1546,1648,48.40325611
GA,Baker ,2016,0,3183,1562,1621,49.07320138
GA,Baker ,2017,0,3159,1548,1611,49.002849
GA,Baker ,2018,0,3086,1519,1567,49.22229423
GA,Baker ,2019,0,3038,1494,1544,49.17709019
GA,Baldwin ,2015,0,45549,23079,22470,50.66851083
GA,Baldwin ,2016,0,45259,22954,22305,50.71698447
GA,Baldwin ,2017,0,44963,22774,22189,50.65053488
GA,Baldwin ,2018,0,44893,22760,22133,50.69832713
GA,Baldwin ,2019,0,44890,22737,22153,50.65047895
GA,Banks ,2015,0,18381,9329,9052,50.75349546
GA,Banks ,2016,0,18325,9303,9022,50.76671214
GA,Banks ,2017,0,18628,9451,9177,50.73545201
GA,Banks ,2018,0,18972,9634,9338,50.78009699
GA,Banks ,2019,0,19234,9775,9459,50.82146199
GA,Barrow ,2015,0,74979,36894,38085,49.20577762
GA,Barrow ,2016,0,77000,37701,39299,48.96233766
GA,Barrow ,2017,0,78899,38692,40207,49.03991179
GA,Barrow ,2018,0,80834,39591,41243,48.97815276
GA,Barrow ,2019,0,83240,40830,42410,49.05093705
GA,Bartow ,2015,0,102043,50285,51758,49.27824545
GA,Bartow ,2016,0,103338,50888,52450,49.24422768
GA,Bartow ,2017,0,105098,51759,53339,49.24832062
GA,Bartow ,2018,0,106378,52472,53906,49.32598846
GA,Bartow ,2019,0,107738,53164,54574,49.34563478
GA,Ben Hill ,2015,0,17357,8253,9104,47.54853949
GA,Ben Hill ,2016,0,17251,8180,9071,47.41754101
GA,Ben Hill ,2017,0,17037,8082,8955,47.43792921
GA,Ben Hill ,2018,0,16822,7952,8870,47.27143027
GA,Ben Hill ,2019,0,16700,7886,8814,47.22155689
GA,Berrien ,2015,0,18991,9379,9612,49.38655152
GA,Berrien ,2016,0,18996,9386,9610,49.41040219
GA,Berrien ,2017,0,19108,9448,9660,49.44525853
GA,Berrien ,2018,0,19266,9452,9814,49.06052113
GA,Berrien ,2019,0,19397,9568,9829,49.32721555
GA,Bibb ,2015,0,153945,72466,81479,47.07265582
GA,Bibb ,2016,0,153152,72086,81066,47.06827204
GA,Bibb ,2017,0,152840,71665,81175,46.88890343
GA,Bibb ,2018,0,152903,71677,81226,46.8774321
GA,Bibb ,2019,0,153159,71659,81500,46.78732559
GA,Bleckley ,2015,0,12714,6123,6591,48.1595092
GA,Bleckley ,2016,0,12864,6165,6699,47.9244403
GA,Bleckley ,2017,0,12764,6110,6654,47.86900658
GA,Bleckley ,2018,0,12821,6123,6698,47.75758521
GA,Bleckley ,2019,0,12873,6145,6728,47.73557057
GA,Brantley ,2015,0,18437,9127,9310,49.50371535
GA,Brantley ,2016,0,18415,9147,9268,49.67146348
GA,Brantley ,2017,0,18832,9356,9476,49.68139337
GA,Brantley ,2018,0,18985,9401,9584,49.51804056
GA,Brantley ,2019,0,19109,9495,9614,49.68862839
GA,Brooks ,2015,0,15670,7700,7970,49.13848117
GA,Brooks ,2016,0,15725,7732,7993,49.17011129
GA,Brooks ,2017,0,15617,7644,7973,48.94666069
GA,Brooks ,2018,0,15479,7549,7930,48.76930034
GA,Brooks ,2019,0,15457,7517,7940,48.63168791
GA,Bryan ,2015,0,34792,17293,17499,49.70395493
GA,Bryan ,2016,0,35839,17707,18132,49.40707051
GA,Bryan ,2017,0,36999,18320,18679,49.51485175
GA,Bryan ,2018,0,38059,18775,19284,49.3313014
GA,Bryan ,2019,0,39627,19511,20116,49.23663159
GA,Bulloch ,2015,0,73116,35953,37163,49.17254773
GA,Bulloch ,2016,0,74642,36699,37943,49.166689
GA,Bulloch ,2017,0,75991,37311,38680,49.09923544
GA,Bulloch ,2018,0,77242,37885,39357,49.04715051
GA,Bulloch ,2019,0,79608,39042,40566,49.04280977
GA,Burke ,2015,0,22632,10825,11807,47.83050548
GA,Burke ,2016,0,22601,10820,11781,47.87398788
GA,Burke ,2017,0,22545,10768,11777,47.76225327
GA,Burke ,2018,0,22439,10688,11751,47.63135612
GA,Burke ,2019,0,22383,10648,11735,47.5718179
GA,Butts ,2015,0,23520,12520,11000,53.23129252
GA,Butts ,2016,0,23736,12622,11114,53.17660937
GA,Butts ,2017,0,24067,12759,11308,53.01450118
GA,Butts ,2018,0,24192,12786,11406,52.85218254
GA,Butts ,2019,0,24936,13182,11754,52.86333013
GA,Calhoun ,2015,0,6534,3918,2616,59.96326905
GA,Calhoun ,2016,0,6359,3812,2547,59.94653247
GA,Calhoun ,2017,0,6389,3858,2531,60.38503678
GA,Calhoun ,2018,0,6353,3835,2518,60.3651818
GA,Calhoun ,2019,0,6189,3747,2442,60.54289869
GA,Camden ,2015,0,52439,27246,25193,51.95751254
GA,Camden ,2016,0,52394,26954,25440,51.44482193
GA,Camden ,2017,0,53005,27213,25792,51.34043958
GA,Camden ,2018,0,53651,27528,26123,51.30938846
GA,Camden ,2019,0,54666,28098,26568,51.39940731
GA,Candler ,2015,0,10873,5325,5548,48.97452405
GA,Candler ,2016,0,10849,5278,5571,48.64964513
GA,Candler ,2017,0,10706,5248,5458,49.01924155
GA,Candler ,2018,0,10827,5304,5523,48.98863951
GA,Candler ,2019,0,10803,5277,5526,48.84754235
GA,Carroll ,2015,0,114461,55937,58524,48.86992076
GA,Carroll ,2016,0,116077,56668,59409,48.81931821
GA,Carroll ,2017,0,117390,57240,60150,48.76054178
GA,Carroll ,2018,0,117997,57656,60341,48.86225921
GA,Carroll ,2019,0,119992,58441,61551,48.70408027
GA,Catoosa ,2015,0,65778,31913,33865,48.51622123
GA,Catoosa ,2016,0,66265,32174,34091,48.55353505
GA,Catoosa ,2017,0,66495,32237,34258,48.48033687
GA,Catoosa ,2018,0,67380,32657,34723,48.46690413
GA,Catoosa ,2019,0,67580,32786,34794,48.51435336
GA,Charlton ,2015,0,13239,7956,5283,60.09517335
GA,Charlton ,2016,0,12842,7530,5312,58.63572652
GA,Charlton ,2017,0,12810,7424,5386,57.95472287
GA,Charlton ,2018,0,12919,7439,5480,57.58185618
GA,Charlton ,2019,0,13392,7822,5570,58.40800478
GA,Chatham ,2015,0,285959,137994,147965,48.25656825
GA,Chatham ,2016,0,288615,139045,149570,48.1766367
GA,Chatham ,2017,0,289309,139317,149992,48.15508678
GA,Chatham ,2018,0,289166,138987,150179,48.0647794
GA,Chatham ,2019,0,289430,139068,150362,48.04892375
GA,Chattahoochee ,2015,0,11042,7468,3574,67.63267524
GA,Chattahoochee ,2016,0,10047,6717,3330,66.85577784
GA,Chattahoochee ,2017,0,10205,6677,3528,65.42871142
GA,Chattahoochee ,2018,0,10600,6800,3800,64.1509434
GA,Chattahoochee ,2019,0,10907,6982,3925,64.013936
GA,Chattooga ,2015,0,24905,12747,12158,51.18249348
GA,Chattooga ,2016,0,24836,12685,12151,51.07505234
GA,Chattooga ,2017,0,24746,12692,12054,51.28909723
GA,Chattooga ,2018,0,24782,12686,12096,51.19038011
GA,Chattooga ,2019,0,24789,12632,12157,50.95808625
GA,Cherokee ,2015,0,235329,115678,119651,49.15586264
GA,Cherokee ,2016,0,241795,119101,122694,49.25701524
GA,Cherokee ,2017,0,247763,121915,125848,49.20629795
GA,Cherokee ,2018,0,253914,124950,128964,49.2095749
GA,Cherokee ,2019,0,258773,127384,131389,49.22615574
GA,Clarke ,2015,0,123561,58888,64673,47.659051
GA,Clarke ,2016,0,124905,59550,65355,47.67623394
GA,Clarke ,2017,0,126815,60403,66412,47.63080077
GA,Clarke ,2018,0,127268,60411,66857,47.46754879
GA,Clarke ,2019,0,128331,60822,67509,47.39462795
GA,Clay ,2015,0,3077,1451,1626,47.15632109
GA,Clay ,2016,0,3005,1416,1589,47.12146423
GA,Clay ,2017,0,2955,1379,1576,46.66666667
GA,Clay ,2018,0,2884,1362,1522,47.2260749
GA,Clay ,2019,0,2834,1325,1509,46.75370501
GA,Clayton ,2015,0,272720,128529,144191,47.12855676
GA,Clayton ,2016,0,279333,131272,148061,46.99480548
GA,Clayton ,2017,0,284184,133091,151093,46.83268587
GA,Clayton ,2018,0,289197,135281,153916,46.77814777
GA,Clayton ,2019,0,292256,136504,155752,46.70699661
GA,Clinch ,2015,0,6826,3340,3486,48.93055962
GA,Clinch ,2016,0,6742,3300,3442,48.94690003
GA,Clinch ,2017,0,6643,3251,3392,48.9387325
GA,Clinch ,2018,0,6603,3205,3398,48.53854309
GA,Clinch ,2019,0,6618,3199,3419,48.33786642
GA,Cobb ,2015,0,739052,357224,381828,48.33543512
GA,Cobb ,2016,0,748178,361618,386560,48.33315067
GA,Cobb ,2017,0,752649,364006,388643,48.36331411
GA,Cobb ,2018,0,756070,366386,389684,48.45926964
GA,Cobb ,2019,0,760141,368461,391680,48.47271756
GA,Coffee ,2015,0,42987,21976,21011,51.12243236
GA,Coffee ,2016,0,42908,21981,20927,51.22820919
GA,Coffee ,2017,0,42880,21950,20930,51.18936567
GA,Coffee ,2018,0,43055,22114,20941,51.36221113
GA,Coffee ,2019,0,43273,22227,21046,51.36459224
GA,Colquitt ,2015,0,45466,22535,22931,49.56450974
GA,Colquitt ,2016,0,45429,22535,22894,49.60487794
GA,Colquitt ,2017,0,45480,22519,22961,49.51407212
GA,Colquitt ,2018,0,45455,22551,22904,49.61170388
GA,Colquitt ,2019,0,45600,22520,23080,49.38596491
GA,Columbia ,2015,0,143837,70228,73609,48.82471131
GA,Columbia ,2016,0,147370,71989,75381,48.84915519
GA,Columbia ,2017,0,151529,74026,77503,48.85269486
GA,Columbia ,2018,0,154077,75294,78783,48.86777391
GA,Columbia ,2019,0,156714,76518,80196,48.82652475
GA,Cook ,2015,0,17070,8153,8917,47.76215583
GA,Cook ,2016,0,17162,8239,8923,48.00722527
GA,Cook ,2017,0,17213,8246,8967,47.9056527
GA,Cook ,2018,0,17171,8253,8918,48.0635956
GA,Cook ,2019,0,17270,8289,8981,47.99652577
GA,Coweta ,2015,0,138145,67299,70846,48.71620399
GA,Coweta ,2016,0,140497,68437,72060,48.71064863
GA,Coweta ,2017,0,143153,69805,73348,48.76251284
GA,Coweta ,2018,0,145998,71061,74937,48.67258456
GA,Coweta ,2019,0,148509,72309,76200,48.68997839
GA,Crawford ,2015,0,12354,6220,6134,50.3480654
GA,Crawford ,2016,0,12268,6168,6100,50.27714379
GA,Crawford ,2017,0,12263,6163,6100,50.25687026
GA,Crawford ,2018,0,12334,6241,6093,50.59996757
GA,Crawford ,2019,0,12404,6267,6137,50.52402451
GA,Crisp ,2015,0,22959,10900,12059,47.47593536
GA,Crisp ,2016,0,22905,10820,12085,47.23859419
GA,Crisp ,2017,0,22710,10715,11995,47.18185821
GA,Crisp ,2018,0,22617,10678,11939,47.21227395
GA,Crisp ,2019,0,22372,10609,11763,47.42088325
GA,Dade ,2015,0,16162,7895,8267,48.84915233
GA,Dade ,2016,0,16224,7952,8272,49.01380671
GA,Dade ,2017,0,16254,7934,8320,48.81259998
GA,Dade ,2018,0,16227,7946,8281,48.96776977
GA,Dade ,2019,0,16116,7918,8198,49.13129809
GA,Dawson ,2015,0,23369,11636,11733,49.7924601
GA,Dawson ,2016,0,23668,11797,11871,49.84367078
GA,Dawson ,2017,0,24406,12137,12269,49.72957469
GA,Dawson ,2018,0,25127,12422,12705,49.43686075
GA,Dawson ,2019,0,26108,12891,13217,49.37567029
GA,Decatur ,2015,0,27049,13172,13877,48.69680949
GA,Decatur ,2016,0,26679,12934,13745,48.48007796
GA,Decatur ,2017,0,26706,12903,13803,48.3149854
GA,Decatur ,2018,0,26573,12855,13718,48.3761713
GA,Decatur ,2019,0,26404,12806,13598,48.50022724
GA,DeKalb ,2015,0,734434,348085,386349,47.39500078
GA,DeKalb ,2016,0,746802,353157,393645,47.28924133
GA,DeKalb ,2017,0,751176,355118,396058,47.27493956
GA,DeKalb ,2018,0,754906,356627,398279,47.24124593
GA,DeKalb ,2019,0,759297,358445,400852,47.20748271
GA,Dodge ,2015,0,21142,11007,10135,52.06224577
GA,Dodge ,2016,0,20854,10823,10031,51.89891628
GA,Dodge ,2017,0,20749,10772,9977,51.91575498
GA,Dodge ,2018,0,20793,10833,9960,52.09926418
GA,Dodge ,2019,0,20605,10743,9862,52.13783062
GA,Dooly ,2015,0,14034,7544,6490,53.75516603
GA,Dooly ,2016,0,13853,7512,6341,54.22652133
GA,Dooly ,2017,0,13691,7408,6283,54.10853846
GA,Dooly ,2018,0,13709,7463,6246,54.43868991
GA,Dooly ,2019,0,13390,7308,6082,54.57804332
GA,Dougherty ,2015,0,91513,42407,49106,46.33986428
GA,Dougherty ,2016,0,90389,41822,48567,46.2689044
GA,Dougherty ,2017,0,89457,41333,48124,46.20432163
GA,Dougherty ,2018,0,89200,41103,48097,46.07959641
GA,Dougherty ,2019,0,87956,40419,47537,45.95365865
GA,Douglas ,2015,0,140173,66849,73324,47.69035406
GA,Douglas ,2016,0,141664,67533,74131,47.67125028
GA,Douglas ,2017,0,143376,68189,75187,47.55956366
GA,Douglas ,2018,0,145024,68937,76087,47.53489078
GA,Douglas ,2019,0,146343,69405,76938,47.42625202
GA,Early ,2015,0,10462,4890,5572,46.74058497
GA,Early ,2016,0,10306,4808,5498,46.65243547
GA,Early ,2017,0,10317,4812,5505,46.64146554
GA,Early ,2018,0,10286,4796,5490,46.6264826
GA,Early ,2019,0,10190,4753,5437,46.6437684
GA,Echols ,2015,0,4030,2022,2008,50.17369727
GA,Echols ,2016,0,3956,2031,1925,51.33973711
GA,Echols ,2017,0,3914,2010,1904,51.35411344
GA,Echols ,2018,0,4000,2062,1938,51.55
GA,Echols ,2019,0,4006,2075,1931,51.79730404
GA,Effingham ,2015,0,57076,28311,28765,49.60228467
GA,Effingham ,2016,0,58699,29163,29536,49.68227738
GA,Effingham ,2017,0,60086,29818,30268,49.62553673
GA,Effingham ,2018,0,62228,30937,31291,49.71556213
GA,Effingham ,2019,0,64296,31905,32391,49.62206047
GA,Elbert ,2015,0,19302,9258,10044,47.96394156
GA,Elbert ,2016,0,19136,9201,9935,48.08214883
GA,Elbert ,2017,0,19102,9179,9923,48.05255994
GA,Elbert ,2018,0,19095,9133,9962,47.82927468
GA,Elbert ,2019,0,19194,9128,10066,47.55652808
GA,Emanuel ,2015,0,22471,11038,11433,49.1210894
GA,Emanuel ,2016,0,22406,11051,11355,49.32161028
GA,Emanuel ,2017,0,22533,11055,11478,49.06137665
GA,Emanuel ,2018,0,22607,11139,11468,49.27234927
GA,Emanuel ,2019,0,22646,11223,11423,49.55842091
GA,Evans ,2015,0,10690,5169,5521,48.3536015
GA,Evans ,2016,0,10648,5175,5473,48.60067618
GA,Evans ,2017,0,10741,5255,5486,48.92468113
GA,Evans ,2018,0,10702,5209,5493,48.67314521
GA,Evans ,2019,0,10654,5162,5492,48.4512859
GA,Fannin ,2015,0,24442,11871,12571,48.56803862
GA,Fannin ,2016,0,25032,12117,12915,48.40604027
GA,Fannin ,2017,0,25332,12259,13073,48.39333649
GA,Fannin ,2018,0,25981,12597,13384,48.48543166
GA,Fannin ,2019,0,26188,12713,13475,48.54513518
GA,Fayette ,2015,0,110141,53374,56767,48.45970166
GA,Fayette ,2016,0,111218,53955,57263,48.51283066
GA,Fayette ,2017,0,112553,54642,57911,48.54779526
GA,Fayette ,2018,0,113181,54766,58415,48.38798031
GA,Fayette ,2019,0,114421,55435,58986,48.44827436
GA,Floyd ,2015,0,96186,46557,49629,48.40309401
GA,Floyd ,2016,0,96698,46745,49953,48.34122733
GA,Floyd ,2017,0,97500,47174,50326,48.38358974
GA,Floyd ,2018,0,97964,47373,50591,48.35755992
GA,Floyd ,2019,0,98498,47689,50809,48.4162115
GA,Forsyth ,2015,0,211250,105000,106250,49.70414201
GA,Forsyth ,2016,0,220481,109701,110780,49.75530771
GA,Forsyth ,2017,0,228940,113693,115247,49.66060977
GA,Forsyth ,2018,0,236993,117562,119431,49.60568456
GA,Forsyth ,2019,0,244252,121103,123149,49.58117027
GA,Franklin ,2015,0,22267,10879,11388,48.85705304
GA,Franklin ,2016,0,22316,10914,11402,48.90661409
GA,Franklin ,2017,0,22864,11211,11653,49.03341498
GA,Franklin ,2018,0,23034,11269,11765,48.92333073
GA,Franklin ,2019,0,23349,11436,11913,48.97854298
GA,Fulton ,2015,0,1005127,486428,518699,48.39468047
GA,Fulton ,2016,0,1022866,495483,527383,48.44065596
GA,Fulton ,2017,0,1038938,503062,535876,48.42079123
GA,Fulton ,2018,0,1050131,508586,541545,48.4307196
GA,Fulton ,2019,0,1063937,514494,549443,48.35756252
GA,Gilmer ,2015,0,29514,14816,14698,50.19990513
GA,Gilmer ,2016,0,29911,14954,14957,49.99498512
GA,Gilmer ,2017,0,30443,15266,15177,50.14617482
GA,Gilmer ,2018,0,30835,15428,15407,50.03405221
GA,Gilmer ,2019,0,31369,15680,15689,49.98565463
GA,Glascock ,2015,0,3020,1482,1538,49.07284768
GA,Glascock ,2016,0,2978,1457,1521,48.92545332
GA,Glascock ,2017,0,3032,1487,1545,49.04353562
GA,Glascock ,2018,0,2977,1468,1509,49.3113873
GA,Glascock ,2019,0,2971,1470,1501,49.47829014
GA,Glynn ,2015,0,83311,39425,43886,47.32268248
GA,Glynn ,2016,0,84099,39766,44333,47.28474774
GA,Glynn ,2017,0,84675,39887,44788,47.1059935
GA,Glynn ,2018,0,84975,40024,44951,47.10091203
GA,Glynn ,2019,0,85292,40066,45226,46.97509731
GA,Gordon ,2015,0,56324,27885,28439,49.50820254
GA,Gordon ,2016,0,56933,28208,28725,49.54595753
GA,Gordon ,2017,0,57164,28294,28870,49.49618641
GA,Gordon ,2018,0,57628,28457,29171,49.38050947
GA,Gordon ,2019,0,57963,28598,29365,49.33837103
GA,Grady ,2015,0,25089,12110,12979,48.26816533
GA,Grady ,2016,0,24869,11995,12874,48.23273956
GA,Grady ,2017,0,24773,11945,12828,48.21781779
GA,Grady ,2018,0,24774,11932,12842,48.16339711
GA,Grady ,2019,0,24633,11899,12734,48.30511915
GA,Greene ,2015,0,16617,8096,8521,48.72118914
GA,Greene ,2016,0,16869,8241,8628,48.85292548
GA,Greene ,2017,0,17203,8414,8789,48.91007382
GA,Greene ,2018,0,17733,8617,9116,48.59301867
GA,Greene ,2019,0,18324,8952,9372,48.85396202
GA,Gwinnett ,2015,0,888494,434627,453867,48.917269
GA,Gwinnett ,2016,0,904962,442203,462759,48.8642617
GA,Gwinnett ,2017,0,918186,448503,469683,48.84663892
GA,Gwinnett ,2018,0,927337,452739,474598,48.82141012
GA,Gwinnett ,2019,0,936250,456696,479554,48.77927904
GA,Habersham ,2015,0,43792,20712,23080,47.29630983
GA,Habersham ,2016,0,44104,20911,23193,47.41293307
GA,Habersham ,2017,0,44535,21062,23473,47.29314023
GA,Habersham ,2018,0,45373,21452,23921,47.27921892
GA,Habersham ,2019,0,45328,21646,23682,47.75414755
GA,Hall ,2015,0,192245,95782,96463,49.82288226
GA,Hall ,2016,0,196159,97572,98587,49.74128131
GA,Hall ,2017,0,198953,99068,99885,49.79467512
GA,Hall ,2018,0,201538,100230,101308,49.73255664
GA,Hall ,2019,0,204441,101660,102781,49.72583777
GA,Hancock ,2015,0,8578,4671,3907,54.45325251
GA,Hancock ,2016,0,8633,4756,3877,55.09093015
GA,Hancock ,2017,0,8539,4738,3801,55.48659094
GA,Hancock ,2018,0,8368,4615,3753,55.15057361
GA,Hancock ,2019,0,8457,4735,3722,55.98912144
GA,Haralson ,2015,0,28702,13907,14795,48.45306947
GA,Haralson ,2016,0,28830,13987,14843,48.51543531
GA,Haralson ,2017,0,29248,14232,15016,48.65973742
GA,Haralson ,2018,0,29561,14366,15195,48.59781469
GA,Haralson ,2019,0,29792,14471,15321,48.57344253
GA,Harris ,2015,0,33155,16569,16586,49.97436284
GA,Harris ,2016,0,33633,16825,16808,50.0252728
GA,Harris ,2017,0,33943,16994,16949,50.0662876
GA,Harris ,2018,0,34560,17318,17242,50.1099537
GA,Harris ,2019,0,35236,17641,17595,50.06527415
GA,Hart ,2015,0,25410,12499,12911,49.18929555
GA,Hart ,2016,0,25471,12580,12891,49.38950179
GA,Hart ,2017,0,25710,12753,12957,49.60326721
GA,Hart ,2018,0,26071,12921,13150,49.5608147
GA,Hart ,2019,0,26205,12980,13225,49.53253196
GA,Heard ,2015,0,11556,5752,5804,49.77500865
GA,Heard ,2016,0,11579,5756,5823,49.71068313
GA,Heard ,2017,0,11751,5853,5898,49.80852693
GA,Heard ,2018,0,11871,5909,5962,49.77676691
GA,Heard ,2019,0,11923,5963,5960,50.01258073
GA,Henry ,2015,0,216414,103390,113024,47.77417357
GA,Henry ,2016,0,220896,105290,115606,47.66496451
GA,Henry ,2017,0,225182,107329,117853,47.66322353
GA,Henry ,2018,0,229728,109562,120166,47.69205321
GA,Henry ,2019,0,234561,111667,122894,47.60680591
GA,Houston ,2015,0,149323,72729,76594,48.70582563
GA,Houston ,2016,0,151622,73638,77984,48.56683067
GA,Houston ,2017,0,153202,74280,78922,48.48500672
GA,Houston ,2018,0,155523,75339,80184,48.44235258
GA,Houston ,2019,0,157863,76340,81523,48.3583867
GA,Irwin ,2015,0,9135,4645,4490,50.84838533
GA,Irwin ,2016,0,9302,4824,4478,51.85981509
GA,Irwin ,2017,0,9352,4869,4483,52.06372968
GA,Irwin ,2018,0,9396,4886,4510,52.00085143
GA,Irwin ,2019,0,9416,4968,4448,52.76125743
GA,Jackson ,2015,0,63418,31388,32030,49.49383456
GA,Jackson ,2016,0,65061,32167,32894,49.44129356
GA,Jackson ,2017,0,67644,33368,34276,49.32883922
GA,Jackson ,2018,0,70325,34722,35603,49.37362247
GA,Jackson ,2019,0,72977,36074,36903,49.43201283
GA,Jasper ,2015,0,13683,6703,6980,48.98779507
GA,Jasper ,2016,0,13767,6742,7025,48.97217985
GA,Jasper ,2017,0,13882,6807,7075,49.03472122
GA,Jasper ,2018,0,14029,6892,7137,49.12680875
GA,Jasper ,2019,0,14219,6986,7233,49.13144384
GA,Jeff Davis ,2015,0,15013,7389,7624,49.21734497
GA,Jeff Davis ,2016,0,14965,7331,7634,48.98763782
GA,Jeff Davis ,2017,0,15039,7417,7622,49.31843873
GA,Jeff Davis ,2018,0,15048,7463,7585,49.59463052
GA,Jeff Davis ,2019,0,15115,7468,7647,49.40787297
GA,Jefferson ,2015,0,15917,7747,8170,48.67123202
GA,Jefferson ,2016,0,15755,7619,8136,48.35925103
GA,Jefferson ,2017,0,15630,7519,8111,48.10620601
GA,Jefferson ,2018,0,15424,7448,7976,48.28838174
GA,Jefferson ,2019,0,15362,7429,7933,48.3595886
GA,Jenkins ,2015,0,8899,4768,4131,53.57905383
GA,Jenkins ,2016,0,8812,4702,4110,53.35905583
GA,Jenkins ,2017,0,8813,4726,4087,53.62532622
GA,Jenkins ,2018,0,8765,4693,4072,53.54249857
GA,Jenkins ,2019,0,8676,4619,4057,53.23881973
GA,Johnson ,2015,0,9708,5467,4241,56.31437989
GA,Johnson ,2016,0,9660,5441,4219,56.32505176
GA,Johnson ,2017,0,9737,5471,4266,56.1877375
GA,Johnson ,2018,0,9706,5448,4258,56.13022872
GA,Johnson ,2019,0,9643,5448,4195,56.49694079
GA,Jones ,2015,0,28441,13806,14635,48.54259696
GA,Jones ,2016,0,28574,13888,14686,48.60362567
GA,Jones ,2017,0,28466,13812,14654,48.52104265
GA,Jones ,2018,0,28680,13868,14812,48.35425384
GA,Jones ,2019,0,28735,13898,14837,48.36610405
GA,Lamar ,2015,0,18236,8752,9484,47.99298092
GA,Lamar ,2016,0,18484,8858,9626,47.92252759
GA,Lamar ,2017,0,18600,8917,9683,47.94086022
GA,Lamar ,2018,0,18961,9101,9860,47.99852328
GA,Lamar ,2019,0,19077,9119,9958,47.80101693
GA,Lanier ,2015,0,10269,5184,5085,50.4820333
GA,Lanier ,2016,0,10430,5250,5180,50.33557047
GA,Lanier ,2017,0,10425,5233,5192,50.19664269
GA,Lanier ,2018,0,10355,5231,5124,50.51665862
GA,Lanier ,2019,0,10423,5279,5144,50.64760626
GA,Laurens ,2015,0,47486,22511,24975,47.40555111
GA,Laurens ,2016,0,47279,22357,24922,47.28737917
GA,Laurens ,2017,0,47376,22407,24969,47.29609929
GA,Laurens ,2018,0,47336,22378,24958,47.27480142
GA,Laurens ,2019,0,47546,22494,25052,47.3099735
GA,Lee ,2015,0,29173,14663,14510,50.26222877
GA,Lee ,2016,0,29184,14647,14537,50.18845943
GA,Lee ,2017,0,29410,14790,14620,50.28901734
GA,Lee ,2018,0,29751,14965,14786,50.30083022
GA,Lee ,2019,0,29992,15064,14928,50.22672713
GA,Liberty ,2015,0,61611,31469,30142,51.07691808
GA,Liberty ,2016,0,61473,31340,30133,50.98173182
GA,Liberty ,2017,0,61619,31341,30278,50.86255863
GA,Liberty ,2018,0,60606,30461,30145,50.26070026
GA,Liberty ,2019,0,61435,30839,30596,50.19777
GA,Lincoln ,2015,0,7722,3763,3959,48.73089873
GA,Lincoln ,2016,0,7855,3817,4038,48.59325271
GA,Lincoln ,2017,0,7856,3844,4012,48.93075356
GA,Lincoln ,2018,0,7925,3846,4079,48.52996845
GA,Lincoln ,2019,0,7921,3847,4074,48.56710011
GA,Long ,2015,0,17658,8939,8719,50.62294711
GA,Long ,2016,0,18372,9241,9131,50.2993686
GA,Long ,2017,0,18780,9480,9300,50.47923323
GA,Long ,2018,0,19091,9629,9462,50.43737887
GA,Long ,2019,0,19559,9868,9691,50.45247712
GA,Lowndes ,2015,0,113342,55446,57896,48.9192003
GA,Lowndes ,2016,0,114360,55795,58565,48.78891221
GA,Lowndes ,2017,0,115404,56230,59174,48.72448095
GA,Lowndes ,2018,0,116309,56290,60019,48.39694263
GA,Lowndes ,2019,0,117406,56663,60743,48.26243974
GA,Lumpkin ,2015,0,31285,15521,15764,49.61163497
GA,Lumpkin ,2016,0,31415,15570,15845,49.562311
GA,Lumpkin ,2017,0,32801,16313,16488,49.73323984
GA,Lumpkin ,2018,0,32899,16307,16592,49.56685614
GA,Lumpkin ,2019,0,33610,16656,16954,49.55667956
GA,McDuffie ,2015,0,21462,10085,11377,46.99002889
GA,McDuffie ,2016,0,21456,10056,11400,46.86800895
GA,McDuffie ,2017,0,21511,10049,11462,46.71563386
GA,McDuffie ,2018,0,21532,10090,11442,46.86048672
GA,McDuffie ,2019,0,21312,9988,11324,46.86561562
GA,McIntosh ,2015,0,14031,6908,7123,49.23383936
GA,McIntosh ,2016,0,14057,6889,7168,49.00761187
GA,McIntosh ,2017,0,14080,6910,7170,49.07670455
GA,McIntosh ,2018,0,14322,7015,7307,48.9805893
GA,McIntosh ,2019,0,14378,6987,7391,48.59507581
GA,Macon ,2015,0,13688,7446,6242,54.39801286
GA,Macon ,2016,0,13478,7376,6102,54.72622051
GA,Macon ,2017,0,13254,7238,6016,54.60992908
GA,Macon ,2018,0,13160,7225,5935,54.90121581
GA,Macon ,2019,0,12947,7083,5864,54.70765428
GA,Madison ,2015,0,28419,14010,14409,49.29800486
GA,Madison ,2016,0,28856,14272,14584,49.45938453
GA,Madison ,2017,0,29295,14477,14818,49.41798942
GA,Madison ,2018,0,29642,14657,14985,49.44673099
GA,Madison ,2019,0,29880,14772,15108,49.437751
GA,Marion ,2015,0,8558,4251,4307,49.67282075
GA,Marion ,2016,0,8468,4209,4259,49.7047709
GA,Marion ,2017,0,8403,4143,4260,49.30382006
GA,Marion ,2018,0,8373,4116,4257,49.15800788
GA,Marion ,2019,0,8359,4146,4213,49.59923436
GA,Meriwether ,2015,0,21173,10168,11005,48.02342606
GA,Meriwether ,2016,0,21074,10097,10977,47.9121192
GA,Meriwether ,2017,0,21021,10070,10951,47.90447648
GA,Meriwether ,2018,0,21094,10110,10984,47.92832085
GA,Meriwether ,2019,0,21167,10133,11034,47.87168706
GA,Miller ,2015,0,5848,2787,3061,47.65731874
GA,Miller ,2016,0,5874,2794,3080,47.56554307
GA,Miller ,2017,0,5813,2782,3031,47.85824875
GA,Miller ,2018,0,5684,2716,2968,47.78325123
GA,Miller ,2019,0,5718,2735,2983,47.83140958
GA,Mitchell ,2015,0,22449,11671,10778,51.98895274
GA,Mitchell ,2016,0,22455,11677,10778,52.00178134
GA,Mitchell ,2017,0,22317,11582,10735,51.8976565
GA,Mitchell ,2018,0,22135,11485,10650,51.88615315
GA,Mitchell ,2019,0,21863,11308,10555,51.72208755
GA,Monroe ,2015,0,26708,13345,13363,49.96630223
GA,Monroe ,2016,0,26905,13334,13571,49.55956142
GA,Monroe ,2017,0,27163,13476,13687,49.61160402
GA,Monroe ,2018,0,27503,13708,13795,49.84183544
GA,Monroe ,2019,0,27578,13722,13856,49.75705272
GA,Montgomery ,2015,0,8942,4629,4313,51.76694252
GA,Montgomery ,2016,0,8985,4633,4352,51.56371731
GA,Montgomery ,2017,0,9024,4646,4378,51.48492908
GA,Montgomery ,2018,0,9168,4717,4451,51.45069808
GA,Montgomery ,2019,0,9172,4653,4519,50.73048408
GA,Morgan ,2015,0,17948,8649,9299,48.18921328
GA,Morgan ,2016,0,18107,8683,9424,47.95383001
GA,Morgan ,2017,0,18373,8821,9552,48.01066783
GA,Morgan ,2018,0,18831,9054,9777,48.08029313
GA,Morgan ,2019,0,19276,9261,10015,48.04420004
GA,Murray ,2015,0,39430,19459,19971,49.35074816
GA,Murray ,2016,0,39347,19346,20001,49.16766208
GA,Murray ,2017,0,39803,19534,20269,49.07670276
GA,Murray ,2018,0,39943,19658,20285,49.21513156
GA,Murray ,2019,0,40096,19756,20340,49.27174781
GA,Muscogee ,2015,0,198702,97363,101339,48.9995068
GA,Muscogee ,2016,0,196219,95794,100425,48.81994098
GA,Muscogee ,2017,0,193836,94420,99416,48.7112817
GA,Muscogee ,2018,0,194169,94405,99764,48.62001658
GA,Muscogee ,2019,0,195769,95139,100630,48.59758184
GA,Newton ,2015,0,104884,49820,55064,47.50009534
GA,Newton ,2016,0,106499,50430,56069,47.3525573
GA,Newton ,2017,0,107846,51011,56835,47.29985349
GA,Newton ,2018,0,109421,51669,57752,47.22036903
GA,Newton ,2019,0,111744,52650,59094,47.11662371
GA,Oconee ,2015,0,35853,17570,18283,49.00566201
GA,Oconee ,2016,0,36929,18132,18797,49.0996236
GA,Oconee ,2017,0,38122,18700,19422,49.05304024
GA,Oconee ,2018,0,39478,19411,20067,49.16915751
GA,Oconee ,2019,0,40280,19765,20515,49.06901688
GA,Oglethorpe ,2015,0,14732,7234,7498,49.10399131
GA,Oglethorpe ,2016,0,14712,7229,7483,49.13675911
GA,Oglethorpe ,2017,0,14874,7330,7544,49.28062391
GA,Oglethorpe ,2018,0,15080,7453,7627,49.42307692
GA,Oglethorpe ,2019,0,15259,7587,7672,49.72147585
GA,Paulding ,2015,0,151649,74027,77622,48.8146971
GA,Paulding ,2016,0,155246,75826,79420,48.84248225
GA,Paulding ,2017,0,159509,77805,81704,48.77781191
GA,Paulding ,2018,0,164053,79905,84148,48.70682036
GA,Paulding ,2019,0,168667,82201,86466,48.73567444
GA,Peach ,2015,0,26970,12997,13973,48.19058213
GA,Peach ,2016,0,26885,12917,13968,48.04537846
GA,Peach ,2017,0,26961,12980,13981,48.14361485
GA,Peach ,2018,0,27363,13200,14163,48.24032453
GA,Peach ,2019,0,27546,13264,14282,48.1521818
GA,Pickens ,2015,0,30136,14811,15325,49.14719936
GA,Pickens ,2016,0,30652,15064,15588,49.14524338
GA,Pickens ,2017,0,31541,15454,16087,48.99654418
GA,Pickens ,2018,0,32014,15671,16343,48.95045917
GA,Pickens ,2019,0,32591,15946,16645,48.92761805
GA,Pierce ,2015,0,19094,9444,9650,49.46056353
GA,Pierce ,2016,0,19104,9476,9628,49.60217755
GA,Pierce ,2017,0,19197,9513,9684,49.55461791
GA,Pierce ,2018,0,19388,9613,9775,49.5822158
GA,Pierce ,2019,0,19465,9638,9827,49.51451323
GA,Pike ,2015,0,17925,8836,9089,49.29428173
GA,Pike ,2016,0,17897,8779,9118,49.0529139
GA,Pike ,2017,0,18204,8942,9262,49.12107229
GA,Pike ,2018,0,18647,9161,9486,49.12854615
GA,Pike ,2019,0,18962,9256,9706,48.81341631
GA,Polk ,2015,0,41207,20178,21029,48.96740845
GA,Polk ,2016,0,41555,20513,21042,49.36349416
GA,Polk ,2017,0,41818,20621,21197,49.31130135
GA,Polk ,2018,0,42346,20872,21474,49.28918906
GA,Polk ,2019,0,42613,20840,21773,48.90526365
GA,Pulaski ,2015,0,11395,4893,6502,42.93988591
GA,Pulaski ,2016,0,11288,4879,6409,43.22289157
GA,Pulaski ,2017,0,11181,4799,6382,42.92102674
GA,Pulaski ,2018,0,11080,4778,6302,43.12274368
GA,Pulaski ,2019,0,11137,4788,6349,42.99182904
GA,Putnam ,2015,0,21307,10371,10936,48.67414465
GA,Putnam ,2016,0,21515,10488,11027,48.74738554
GA,Putnam ,2017,0,21692,10588,11104,48.81062143
GA,Putnam ,2018,0,21820,10667,11153,48.8863428
GA,Putnam ,2019,0,22119,10754,11365,48.61883449
GA,Quitman ,2015,0,2275,1118,1157,49.14285714
GA,Quitman ,2016,0,2320,1123,1197,48.40517241
GA,Quitman ,2017,0,2333,1120,1213,48.00685812
GA,Quitman ,2018,0,2260,1094,1166,48.40707965
GA,Quitman ,2019,0,2299,1097,1202,47.71639843
GA,Rabun ,2015,0,16223,7956,8267,49.04148431
GA,Rabun ,2016,0,16465,8092,8373,49.14667476
GA,Rabun ,2017,0,16545,8117,8428,49.06013901
GA,Rabun ,2018,0,16857,8281,8576,49.12499258
GA,Rabun ,2019,0,17137,8366,8771,48.81834627
GA,Randolph ,2015,0,7150,3281,3869,45.88811189
GA,Randolph ,2016,0,7155,3258,3897,45.53459119
GA,Randolph ,2017,0,6969,3188,3781,45.74544411
GA,Randolph ,2018,0,6812,3134,3678,46.00704639
GA,Randolph ,2019,0,6778,3141,3637,46.34110357
GA,Richmond ,2015,0,201451,97832,103619,48.56367057
GA,Richmond ,2016,0,201949,98126,103823,48.58949537
GA,Richmond ,2017,0,201673,97908,103765,48.54789684
GA,Richmond ,2018,0,201667,97646,104021,48.4194241
GA,Richmond ,2019,0,202518,98225,104293,48.50186156
GA,Rockdale ,2015,0,88354,41699,46655,47.19537316
GA,Rockdale ,2016,0,88987,42013,46974,47.21251419
GA,Rockdale ,2017,0,89843,42355,47488,47.14335007
GA,Rockdale ,2018,0,90505,42553,47952,47.01729186
GA,Rockdale ,2019,0,90896,42758,48138,47.04057384
GA,Schley ,2015,0,5209,2473,2736,47.47552313
GA,Schley ,2016,0,5173,2462,2711,47.59327276
GA,Schley ,2017,0,5235,2485,2750,47.46895893
GA,Schley ,2018,0,5230,2478,2752,47.38049713
GA,Schley ,2019,0,5257,2510,2747,47.74586266
GA,Screven ,2015,0,14059,6894,7165,49.03620457
GA,Screven ,2016,0,14003,6907,7096,49.32514461
GA,Screven ,2017,0,13956,6918,7038,49.57007739
GA,Screven ,2018,0,13960,6925,7035,49.60601719
GA,Screven ,2019,0,13966,6940,7026,49.69210941
GA,Seminole ,2015,0,8565,4088,4477,47.72913018
GA,Seminole ,2016,0,8427,4015,4412,47.64447609
GA,Seminole ,2017,0,8253,3919,4334,47.48576275
GA,Seminole ,2018,0,8270,3944,4326,47.6904474
GA,Seminole ,2019,0,8090,3884,4206,48.00988875
GA,Spalding ,2015,0,63818,30702,33116,48.10868407
GA,Spalding ,2016,0,64546,31117,33429,48.20902922
GA,Spalding ,2017,0,65358,31437,33921,48.09969705
GA,Spalding ,2018,0,66107,31738,34369,48.01004432
GA,Spalding ,2019,0,66703,32041,34662,48.03532075
GA,Stephens ,2015,0,25446,12181,13265,47.86999921
GA,Stephens ,2016,0,25637,12285,13352,47.91902329
GA,Stephens ,2017,0,25736,12375,13361,48.0843954
GA,Stephens ,2018,0,26007,12484,13523,48.00246088
GA,Stephens ,2019,0,25925,12507,13418,48.24300868
GA,Stewart ,2015,0,5973,3791,2182,63.46894358
GA,Stewart ,2016,0,6122,3977,2145,64.96243058
GA,Stewart ,2017,0,6314,4154,2160,65.79030725
GA,Stewart ,2018,0,6435,4338,2097,67.41258741
GA,Stewart ,2019,0,6621,4520,2101,68.26763329
GA,Sumter ,2015,0,30696,14528,16168,47.32864217
GA,Sumter ,2016,0,30403,14365,16038,47.24862678
GA,Sumter ,2017,0,29901,14091,15810,47.1255142
GA,Sumter ,2018,0,29796,13969,15827,46.88213183
GA,Sumter ,2019,0,29524,13827,15697,46.83308495
GA,Talbot ,2015,0,6498,3061,3437,47.10680209
GA,Talbot ,2016,0,6366,3005,3361,47.2038957
GA,Talbot ,2017,0,6256,2973,3283,47.52237852
GA,Talbot ,2018,0,6290,3008,3282,47.82193959
GA,Talbot ,2019,0,6195,2945,3250,47.53833737
GA,Taliaferro ,2015,0,1642,815,827,49.63459196
GA,Taliaferro ,2016,0,1611,803,808,49.84481688
GA,Taliaferro ,2017,0,1613,803,810,49.78301302
GA,Taliaferro ,2018,0,1612,798,814,49.50372208
GA,Taliaferro ,2019,0,1537,749,788,48.73129473
GA,Tattnall ,2015,0,25387,14607,10780,57.53732225
GA,Tattnall ,2016,0,25342,14571,10771,57.49743509
GA,Tattnall ,2017,0,25409,14621,10788,57.54260301
GA,Tattnall ,2018,0,25485,14739,10746,57.83402001
GA,Tattnall ,2019,0,25286,14498,10788,57.3360753
GA,Taylor ,2015,0,8243,3921,4322,47.56763314
GA,Taylor ,2016,0,8189,3921,4268,47.88130419
GA,Taylor ,2017,0,8110,3887,4223,47.92848335
GA,Taylor ,2018,0,8020,3822,4198,47.65586035
GA,Taylor ,2019,0,8020,3820,4200,47.63092269
GA,Telfair ,2015,0,16451,9721,6730,59.09063279
GA,Telfair ,2016,0,15962,9306,6656,58.30096479
GA,Telfair ,2017,0,15929,9351,6578,58.70425011
GA,Telfair ,2018,0,15974,9379,6595,58.71416051
GA,Telfair ,2019,0,15860,9307,6553,58.68221942
GA,Terrell ,2015,0,9013,4337,4676,48.11938311
GA,Terrell ,2016,0,8861,4227,4634,47.70341948
GA,Terrell ,2017,0,8695,4167,4528,47.92409431
GA,Terrell ,2018,0,8587,4120,4467,47.9795039
GA,Terrell ,2019,0,8531,4058,4473,47.56769429
GA,Thomas ,2015,0,44796,21230,23566,47.39262434
GA,Thomas ,2016,0,44950,21299,23651,47.38375973
GA,Thomas ,2017,0,44619,21140,23479,47.37891929
GA,Thomas ,2018,0,44334,20960,23374,47.27748455
GA,Thomas ,2019,0,44451,21012,23439,47.27002767
GA,Tift ,2015,0,40536,19589,20947,48.32494573
GA,Tift ,2016,0,40554,19644,20910,48.43911821
GA,Tift ,2017,0,40431,19586,20845,48.44302639
GA,Tift ,2018,0,40542,19638,20904,48.43865621
GA,Tift ,2019,0,40644,19683,20961,48.42781222
GA,Toombs ,2015,0,27150,12825,14325,47.23756906
GA,Toombs ,2016,0,27121,12810,14311,47.23277165
GA,Toombs ,2017,0,26859,12711,14148,47.32491902
GA,Toombs ,2018,0,26902,12768,14134,47.4611553
GA,Toombs ,2019,0,26830,12699,14131,47.33134551
GA,Towns ,2015,0,11212,5331,5881,47.54727078
GA,Towns ,2016,0,11419,5425,5994,47.5085384
GA,Towns ,2017,0,11553,5513,6040,47.71920713
GA,Towns ,2018,0,11866,5683,6183,47.89314006
GA,Towns ,2019,0,12037,5726,6311,47.56999252
GA,Treutlen ,2015,0,6803,3421,3382,50.28663825
GA,Treutlen ,2016,0,6710,3382,3328,50.4023845
GA,Treutlen ,2017,0,6746,3402,3344,50.42988438
GA,Treutlen ,2018,0,6813,3396,3417,49.84588287
GA,Treutlen ,2019,0,6901,3429,3472,49.68845095
GA,Troup ,2015,0,69595,33542,36053,48.19599109
GA,Troup ,2016,0,69939,33704,36235,48.19056606
GA,Troup ,2017,0,70062,33782,36280,48.21729325
GA,Troup ,2018,0,70078,33769,36309,48.18773367
GA,Troup ,2019,0,69922,33415,36507,47.78896485
GA,Turner ,2015,0,7982,3889,4093,48.72212478
GA,Turner ,2016,0,7944,3878,4066,48.81671702
GA,Turner ,2017,0,7895,3837,4058,48.60037999
GA,Turner ,2018,0,7908,3844,4064,48.60900354
GA,Turner ,2019,0,7985,3853,4132,48.25297433
GA,Twiggs ,2015,0,8347,4063,4284,48.67617108
GA,Twiggs ,2016,0,8249,4045,4204,49.03624682
GA,Twiggs ,2017,0,8253,4056,4197,49.14576518
GA,Twiggs ,2018,0,8174,4017,4157,49.14362613
GA,Twiggs ,2019,0,8120,3971,4149,48.90394089
GA,Union ,2015,0,22007,10616,11391,48.23919662
GA,Union ,2016,0,22640,10929,11711,48.2729682
GA,Union ,2017,0,23376,11322,12054,48.43429158
GA,Union ,2018,0,23905,11598,12307,48.51704664
GA,Union ,2019,0,24511,11868,12643,48.41907715
GA,Upson ,2015,0,26231,12486,13745,47.60016774
GA,Upson ,2016,0,26245,12495,13750,47.60906839
GA,Upson ,2017,0,26201,12440,13761,47.47910385
GA,Upson ,2018,0,26185,12426,13759,47.45464961
GA,Upson ,2019,0,26320,12477,13843,47.4050152
GA,Walker ,2015,0,68537,33896,34641,49.45649795
GA,Walker ,2016,0,68455,33693,34762,49.21919509
GA,Walker ,2017,0,68999,34044,34955,49.33984551
GA,Walker ,2018,0,69443,34174,35269,49.2115836
GA,Walker ,2019,0,69761,34309,35452,49.18077436
GA,Walton ,2015,0,88333,43002,45331,48.68169314
GA,Walton ,2016,0,89786,43724,46062,48.69801528
GA,Walton ,2017,0,91296,44431,46865,48.66697336
GA,Walton ,2018,0,93202,45394,47808,48.70496341
GA,Walton ,2019,0,94593,46187,48406,48.82708023
GA,Ware ,2015,0,35327,17536,17791,49.63908625
GA,Ware ,2016,0,35648,17705,17943,49.66618043
GA,Ware ,2017,0,35668,17742,17926,49.74206572
GA,Ware ,2018,0,35587,17807,17780,50.0379352
GA,Ware ,2019,0,35734,17816,17918,49.85727878
GA,Warren ,2015,0,5374,2529,2845,47.05991812
GA,Warren ,2016,0,5345,2533,2812,47.39008419
GA,Warren ,2017,0,5265,2479,2786,47.08452042
GA,Warren ,2018,0,5247,2474,2773,47.15075281
GA,Warren ,2019,0,5254,2485,2769,47.2972973
GA,Washington ,2015,0,20736,10603,10133,51.13329475
GA,Washington ,2016,0,20347,10253,10094,50.39072099
GA,Washington ,2017,0,20311,10237,10074,50.4012604
GA,Washington ,2018,0,20410,10396,10014,50.93581578
GA,Washington ,2019,0,20374,10412,9962,51.10434868
GA,Wayne ,2015,0,29430,14805,14625,50.3058104
GA,Wayne ,2016,0,29974,15417,14557,51.43457663
GA,Wayne ,2017,0,29797,15191,14606,50.98164245
GA,Wayne ,2018,0,29810,15271,14539,51.22777591
GA,Wayne ,2019,0,29927,15336,14591,51.24469543
GA,Webster ,2015,0,2631,1321,1310,50.20904599
GA,Webster ,2016,0,2616,1312,1304,50.1529052
GA,Webster ,2017,0,2589,1306,1283,50.44418694
GA,Webster ,2018,0,2606,1286,1320,49.34765925
GA,Webster ,2019,0,2607,1295,1312,49.67395474
GA,Wheeler ,2015,0,7911,5132,2779,64.87169764
GA,Wheeler ,2016,0,8015,5199,2816,64.86587648
GA,Wheeler ,2017,0,7960,5157,2803,64.78643216
GA,Wheeler ,2018,0,7898,5107,2791,64.66193973
GA,Wheeler ,2019,0,7855,5058,2797,64.39210694
GA,White ,2015,0,28387,13875,14512,48.87800754
GA,White ,2016,0,28828,14123,14705,48.99056473
GA,White ,2017,0,29445,14400,15045,48.90473765
GA,White ,2018,0,29988,14612,15376,48.72615713
GA,White ,2019,0,30798,14996,15802,48.69147347
GA,Whitfield ,2015,0,103669,51587,52082,49.76125939
GA,Whitfield ,2016,0,104406,51943,52463,49.75097217
GA,Whitfield ,2017,0,104234,51900,52334,49.79181457
GA,Whitfield ,2018,0,104249,51936,52313,49.81918292
GA,Whitfield ,2019,0,104628,52055,52573,49.75245632
GA,Wilcox ,2015,0,9024,5353,3671,59.3195922
GA,Wilcox ,2016,0,8841,5264,3577,59.54077593
GA,Wilcox ,2017,0,8791,5262,3529,59.8566716
GA,Wilcox ,2018,0,8827,5277,3550,59.78248556
GA,Wilcox ,2019,0,8635,5167,3468,59.83786914
GA,Wilkes ,2015,0,9911,4727,5184,47.69448088
GA,Wilkes ,2016,0,9809,4667,5142,47.57875421
GA,Wilkes ,2017,0,9860,4677,5183,47.43407708
GA,Wilkes ,2018,0,9864,4714,5150,47.78994323
GA,Wilkes ,2019,0,9777,4669,5108,47.75493505
GA,Wilkinson ,2015,0,9080,4344,4736,47.84140969
GA,Wilkinson ,2016,0,9020,4330,4690,48.00443459
GA,Wilkinson ,2017,0,8954,4292,4662,47.9338843
GA,Wilkinson ,2018,0,9043,4309,4734,47.65011611
GA,Wilkinson ,2019,0,8954,4302,4652,48.04556623
GA,Worth ,2015,0,20688,9939,10749,48.04234339
GA,Worth ,2016,0,20703,9984,10719,48.22489494
GA,Worth ,2017,0,20528,9912,10616,48.2852689
GA,Worth ,2018,0,20302,9757,10545,48.0593045
GA,Worth ,2019,0,20247,9707,10540,47.94290512
HI,Hawaii ,2015,0,195975,97445,98530,49.72317898
HI,Hawaii ,2016,0,198316,98548,99768,49.69241009
HI,Hawaii ,2017,0,199981,99211,100770,49.61021297
HI,Hawaii ,2018,0,201509,99785,101724,49.51888005
HI,Hawaii ,2019,0,201513,99648,101865,49.44991142
HI,Honolulu ,2015,0,991064,500046,491018,50.45547008
HI,Honolulu ,2016,0,992268,500731,491537,50.4632821
HI,Honolulu ,2017,0,986353,496807,489546,50.36807309
HI,Honolulu ,2018,0,979858,492825,487033,50.29555303
HI,Honolulu ,2019,0,974563,489568,484995,50.23461798
HI,Kalawao ,2015,0,88,41,47,46.59090909
HI,Kalawao ,2016,0,88,41,47,46.59090909
HI,Kalawao ,2017,0,86,41,45,47.6744186
HI,Kalawao ,2018,0,86,41,45,47.6744186
HI,Kalawao ,2019,0,86,41,45,47.6744186
HI,Kauai ,2015,0,71021,35349,35672,49.77260247
HI,Kauai ,2016,0,71537,35529,36008,49.66520821
HI,Kauai ,2017,0,71827,35577,36250,49.53151322
HI,Kauai ,2018,0,72168,35673,36495,49.43049551
HI,Kauai ,2019,0,72293,35697,36596,49.37822472
HI,Maui ,2015,0,163904,81818,82086,49.91824483
HI,Maui ,2016,0,165350,82467,82883,49.87420623
HI,Maui ,2017,0,166146,82729,83417,49.79295319
HI,Maui ,2018,0,166972,82967,84005,49.68916944
HI,Maui ,2019,0,167417,83086,84331,49.62817396
ID,Ada ,2015,0,432862,216722,216140,50.06722697
ID,Ada ,2016,0,444486,222437,222049,50.04364592
ID,Ada ,2017,0,456548,228516,228032,50.05300647
ID,Ada ,2018,0,468764,234701,234063,50.0680513
ID,Ada ,2019,0,481587,241132,240455,50.07028844
ID,Adams ,2015,0,3891,2007,1884,51.58057055
ID,Adams ,2016,0,3941,2037,1904,51.68738899
ID,Adams ,2017,0,4127,2125,2002,51.49018658
ID,Adams ,2018,0,4234,2201,2033,51.98393954
ID,Adams ,2019,0,4294,2207,2087,51.39729856
ID,Bannock ,2015,0,84184,41946,42238,49.82657037
ID,Bannock ,2016,0,84676,42136,42540,49.76144362
ID,Bannock ,2017,0,85482,42531,42951,49.75433425
ID,Bannock ,2018,0,86674,43034,43640,49.6504142
ID,Bannock ,2019,0,87808,43650,44158,49.71073251
ID,Bear Lake ,2015,0,5879,2906,2973,49.4301752
ID,Bear Lake ,2016,0,5927,2944,2983,49.67099713
ID,Bear Lake ,2017,0,6023,2986,3037,49.57662295
ID,Bear Lake ,2018,0,6044,3009,3035,49.78491066
ID,Bear Lake ,2019,0,6125,3069,3056,50.10612245
ID,Benewah ,2015,0,8996,4573,4423,50.83370387
ID,Benewah ,2016,0,9021,4565,4456,50.60414588
ID,Benewah ,2017,0,9157,4668,4489,50.97739434
ID,Benewah ,2018,0,9218,4722,4496,51.22586244
ID,Benewah ,2019,0,9298,4775,4523,51.35513014
ID,Bingham ,2015,0,45057,22591,22466,50.13871319
ID,Bingham ,2016,0,45315,22674,22641,50.03641178
ID,Bingham ,2017,0,45884,22908,22976,49.9259001
ID,Bingham ,2018,0,46129,23017,23112,49.8970279
ID,Bingham ,2019,0,46811,23314,23497,49.80453312
ID,Blaine ,2015,0,21636,10979,10657,50.74413015
ID,Blaine ,2016,0,22062,11145,10917,50.51672559
ID,Blaine ,2017,0,22373,11285,11088,50.44026282
ID,Blaine ,2018,0,22771,11445,11326,50.26129726
ID,Blaine ,2019,0,23021,11566,11455,50.24108423
ID,Boise ,2015,0,6963,3587,3376,51.51515152
ID,Boise ,2016,0,7095,3691,3404,52.02255109
ID,Boise ,2017,0,7347,3807,3540,51.81706819
ID,Boise ,2018,0,7655,3979,3676,51.97909863
ID,Boise ,2019,0,7831,4076,3755,52.04954667
ID,Bonner ,2015,0,41600,20779,20821,49.94951923
ID,Bonner ,2016,0,42357,21098,21259,49.80994877
ID,Bonner ,2017,0,43654,21756,21898,49.8373574
ID,Bonner ,2018,0,44705,22260,22445,49.79308802
ID,Bonner ,2019,0,45739,22846,22893,49.94862153
ID,Bonneville ,2015,0,109849,54620,55229,49.7228013
ID,Bonneville ,2016,0,112118,55827,56291,49.79307515
ID,Bonneville ,2017,0,114488,57061,57427,49.84015792
ID,Bonneville ,2018,0,116444,58165,58279,49.95104943
ID,Bonneville ,2019,0,119062,59452,59610,49.93364802
ID,Boundary ,2015,0,11299,5700,5599,50.44694221
ID,Boundary ,2016,0,11701,5874,5827,50.20083754
ID,Boundary ,2017,0,11965,5997,5968,50.12118679
ID,Boundary ,2018,0,12016,6040,5976,50.26631158
ID,Boundary ,2019,0,12245,6146,6099,50.19191507
ID,Butte ,2015,0,2566,1302,1264,50.74045207
ID,Butte ,2016,0,2572,1314,1258,51.08864697
ID,Butte ,2017,0,2585,1321,1264,51.10251451
ID,Butte ,2018,0,2587,1303,1284,50.36722072
ID,Butte ,2019,0,2597,1324,1273,50.98190219
ID,Camas ,2015,0,1070,548,522,51.21495327
ID,Camas ,2016,0,1082,562,520,51.94085028
ID,Camas ,2017,0,1096,557,539,50.82116788
ID,Camas ,2018,0,1121,571,550,50.93666369
ID,Camas ,2019,0,1106,565,541,51.08499096
ID,Canyon ,2015,0,206842,102290,104552,49.45320583
ID,Canyon ,2016,0,211381,104666,106715,49.51533014
ID,Canyon ,2017,0,216858,107423,109435,49.53610197
ID,Canyon ,2018,0,223236,110665,112571,49.57309753
ID,Canyon ,2019,0,229849,114075,115774,49.63040953
ID,Caribou ,2015,0,6733,3416,3317,50.73518491
ID,Caribou ,2016,0,6867,3489,3378,50.80821319
ID,Caribou ,2017,0,6973,3557,3416,51.01104259
ID,Caribou ,2018,0,7037,3601,3436,51.17237459
ID,Caribou ,2019,0,7155,3651,3504,51.02725367
ID,Cassia ,2015,0,23499,12022,11477,51.15962381
ID,Cassia ,2016,0,23479,11985,11494,51.04561523
ID,Cassia ,2017,0,23650,12087,11563,51.10782241
ID,Cassia ,2018,0,23791,12113,11678,50.91421126
ID,Cassia ,2019,0,24030,12219,11811,50.84893883
ID,Clark ,2015,0,886,473,413,53.38600451
ID,Clark ,2016,0,870,462,408,53.10344828
ID,Clark ,2017,0,879,453,426,51.53583618
ID,Clark ,2018,0,851,435,416,51.11633373
ID,Clark ,2019,0,845,432,413,51.12426036
ID,Clearwater ,2015,0,8554,4709,3845,55.05026888
ID,Clearwater ,2016,0,8651,4793,3858,55.40399954
ID,Clearwater ,2017,0,8646,4771,3875,55.18158686
ID,Clearwater ,2018,0,8758,4824,3934,55.08106874
ID,Clearwater ,2019,0,8756,4836,3920,55.23069895
ID,Custer ,2015,0,4059,2080,1979,51.24414881
ID,Custer ,2016,0,4084,2095,1989,51.29774731
ID,Custer ,2017,0,4135,2126,2009,51.41475212
ID,Custer ,2018,0,4250,2189,2061,51.50588235
ID,Custer ,2019,0,4315,2205,2110,51.10081112
ID,Elmore ,2015,0,25826,13506,12320,52.29613568
ID,Elmore ,2016,0,26137,13666,12471,52.2860313
ID,Elmore ,2017,0,26881,14041,12840,52.23391987
ID,Elmore ,2018,0,27362,14352,13010,52.45230612
ID,Elmore ,2019,0,27511,14415,13096,52.39722293
ID,Franklin ,2015,0,12955,6602,6353,50.96101891
ID,Franklin ,2016,0,13320,6803,6517,51.07357357
ID,Franklin ,2017,0,13467,6885,6582,51.12497215
ID,Franklin ,2018,0,13704,7009,6695,51.1456509
ID,Franklin ,2019,0,13876,7121,6755,51.31882387
ID,Fremont ,2015,0,12812,6655,6157,51.94349048
ID,Fremont ,2016,0,12914,6717,6197,52.01331888
ID,Fremont ,2017,0,13122,6834,6288,52.08047554
ID,Fremont ,2018,0,13155,6877,6278,52.27670087
ID,Fremont ,2019,0,13099,6858,6241,52.35514161
ID,Gem ,2015,0,16685,8313,8372,49.82319449
ID,Gem ,2016,0,16959,8458,8501,49.87322366
ID,Gem ,2017,0,17311,8647,8664,49.95089827
ID,Gem ,2018,0,17587,8814,8773,50.11656337
ID,Gem ,2019,0,18112,9106,9006,50.27606007
ID,Gooding ,2015,0,15188,7751,7437,51.03371082
ID,Gooding ,2016,0,15135,7744,7391,51.16617113
ID,Gooding ,2017,0,15121,7726,7395,51.09450433
ID,Gooding ,2018,0,15116,7679,7437,50.80047632
ID,Gooding ,2019,0,15179,7728,7451,50.91244483
ID,Idaho ,2015,0,16301,8533,7768,52.34648181
ID,Idaho ,2016,0,16236,8516,7720,52.4513427
ID,Idaho ,2017,0,16373,8598,7775,52.51328407
ID,Idaho ,2018,0,16476,8632,7844,52.39135713
ID,Idaho ,2019,0,16667,8726,7941,52.3549529
ID,Jefferson ,2015,0,27127,13723,13404,50.58797508
ID,Jefferson ,2016,0,27830,14125,13705,50.75458139
ID,Jefferson ,2017,0,28439,14442,13997,50.78237631
ID,Jefferson ,2018,0,29405,14951,14454,50.84509437
ID,Jefferson ,2019,0,29871,15276,14595,51.13990158
ID,Jerome ,2015,0,22971,11686,11285,50.87283967
ID,Jerome ,2016,0,23433,11959,11474,51.03486536
ID,Jerome ,2017,0,23768,12125,11643,51.01396836
ID,Jerome ,2018,0,24066,12324,11742,51.20917477
ID,Jerome ,2019,0,24412,12518,11894,51.27805997
ID,Kootenai ,2015,0,149367,73708,75659,49.34691063
ID,Kootenai ,2016,0,153019,75453,77566,49.30956286
ID,Kootenai ,2017,0,157320,77650,79670,49.35799644
ID,Kootenai ,2018,0,161209,79658,81551,49.41287397
ID,Kootenai ,2019,0,165697,81998,83699,49.4867137
ID,Latah ,2015,0,38796,19868,18928,51.2114651
ID,Latah ,2016,0,39050,20011,19039,51.24455826
ID,Latah ,2017,0,39741,20300,19441,51.08074784
ID,Latah ,2018,0,39829,20268,19561,50.88754425
ID,Latah ,2019,0,40108,20365,19743,50.7754064
ID,Lemhi ,2015,0,7737,3921,3816,50.67855758
ID,Lemhi ,2016,0,7709,3916,3793,50.79776884
ID,Lemhi ,2017,0,7829,3961,3868,50.59394559
ID,Lemhi ,2018,0,7932,4019,3913,50.66817953
ID,Lemhi ,2019,0,8027,4056,3971,50.52946306
ID,Lewis ,2015,0,3791,1887,1904,49.77578475
ID,Lewis ,2016,0,3846,1927,1919,50.10400416
ID,Lewis ,2017,0,3884,1951,1933,50.23171988
ID,Lewis ,2018,0,3832,1948,1884,50.83507307
ID,Lewis ,2019,0,3838,1954,1884,50.9119333
ID,Lincoln ,2015,0,5307,2746,2561,51.74298097
ID,Lincoln ,2016,0,5303,2762,2541,52.08372619
ID,Lincoln ,2017,0,5376,2774,2602,51.59970238
ID,Lincoln ,2018,0,5398,2800,2598,51.87106336
ID,Lincoln ,2019,0,5366,2779,2587,51.78904212
ID,Madison ,2015,0,37989,19109,18880,50.30140304
ID,Madison ,2016,0,38972,19585,19387,50.25402853
ID,Madison ,2017,0,39370,19939,19431,50.64516129
ID,Madison ,2018,0,39261,19912,19349,50.71699651
ID,Madison ,2019,0,39907,20227,19680,50.68534342
ID,Minidoka ,2015,0,20430,10291,10139,50.37200196
ID,Minidoka ,2016,0,20613,10365,10248,50.28380148
ID,Minidoka ,2017,0,20722,10356,10366,49.97587105
ID,Minidoka ,2018,0,20719,10363,10356,50.01689271
ID,Minidoka ,2019,0,21039,10512,10527,49.96435192
ID,Nez Perce ,2015,0,39995,19796,20199,49.49618702
ID,Nez Perce ,2016,0,40136,19863,20273,49.4892366
ID,Nez Perce ,2017,0,40289,19934,20355,49.47752488
ID,Nez Perce ,2018,0,40256,19867,20389,49.35164944
ID,Nez Perce ,2019,0,40408,19933,20475,49.32934072
ID,Oneida ,2015,0,4248,2130,2118,50.14124294
ID,Oneida ,2016,0,4296,2137,2159,49.74394786
ID,Oneida ,2017,0,4389,2202,2187,50.17088175
ID,Oneida ,2018,0,4462,2239,2223,50.1792918
ID,Oneida ,2019,0,4531,2272,2259,50.14345619
ID,Owyhee ,2015,0,11288,5787,5501,51.26683203
ID,Owyhee ,2016,0,11364,5781,5583,50.87117212
ID,Owyhee ,2017,0,11618,5908,5710,50.85212601
ID,Owyhee ,2018,0,11669,5963,5706,51.10120833
ID,Owyhee ,2019,0,11823,6046,5777,51.13761313
ID,Payette ,2015,0,22790,11343,11447,49.77182975
ID,Payette ,2016,0,22888,11454,11434,50.04369102
ID,Payette ,2017,0,23163,11524,11639,49.75175927
ID,Payette ,2018,0,23507,11736,11771,49.92555409
ID,Payette ,2019,0,23951,11981,11970,50.02296355
ID,Power ,2015,0,7687,3911,3776,50.87810589
ID,Power ,2016,0,7681,3895,3786,50.70954303
ID,Power ,2017,0,7606,3858,3748,50.72311333
ID,Power ,2018,0,7700,3903,3797,50.68831169
ID,Power ,2019,0,7681,3865,3816,50.31896888
ID,Shoshone ,2015,0,12440,6261,6179,50.32958199
ID,Shoshone ,2016,0,12416,6253,6163,50.36243557
ID,Shoshone ,2017,0,12519,6320,6199,50.48326544
ID,Shoshone ,2018,0,12790,6438,6352,50.33620016
ID,Shoshone ,2019,0,12882,6474,6408,50.2561714
ID,Teton ,2015,0,10725,5597,5128,52.18648019
ID,Teton ,2016,0,11165,5859,5306,52.47648903
ID,Teton ,2017,0,11445,5993,5452,52.3634775
ID,Teton ,2018,0,11651,6116,5535,52.49334821
ID,Teton ,2019,0,12142,6372,5770,52.47899852
ID,Twin Falls ,2015,0,82245,40560,41685,49.31606785
ID,Twin Falls ,2016,0,83819,41255,42564,49.21915079
ID,Twin Falls ,2017,0,85374,42040,43334,49.24215803
ID,Twin Falls ,2018,0,86029,42449,43580,49.34266352
ID,Twin Falls ,2019,0,86878,42819,44059,49.28635558
ID,Valley ,2015,0,10043,5223,4820,52.0063726
ID,Valley ,2016,0,10422,5406,5016,51.87104203
ID,Valley ,2017,0,10667,5513,5154,51.68275991
ID,Valley ,2018,0,11021,5708,5313,51.79203339
ID,Valley ,2019,0,11392,5912,5480,51.89606742
ID,Washington ,2015,0,9891,4948,4943,50.0252755
ID,Washington ,2016,0,10032,4992,5040,49.76076555
ID,Washington ,2017,0,10051,4986,5065,49.60700428
ID,Washington ,2018,0,10115,5032,5083,49.74789916
ID,Washington ,2019,0,10194,5075,5119,49.78418678
IL,Adams ,2015,0,66835,32755,34080,49.0087529
IL,Adams ,2016,0,66475,32584,33891,49.01692366
IL,Adams ,2017,0,66057,32537,33520,49.25594562
IL,Adams ,2018,0,65623,32328,33295,49.26321564
IL,Adams ,2019,0,65435,32232,33203,49.25804233
IL,Alexander ,2015,0,6762,3223,3539,47.66341319
IL,Alexander ,2016,0,6459,3110,3349,48.1498684
IL,Alexander ,2017,0,6278,3000,3278,47.78591908
IL,Alexander ,2018,0,6041,2910,3131,48.17083264
IL,Alexander ,2019,0,5761,2798,2963,48.56795695
IL,Bond ,2015,0,16686,8739,7947,52.37324703
IL,Bond ,2016,0,16546,8641,7905,52.2241025
IL,Bond ,2017,0,16648,8682,7966,52.15040846
IL,Bond ,2018,0,16637,8652,7985,52.00456813
IL,Bond ,2019,0,16426,8528,7898,51.91769146
IL,Boone ,2015,0,53579,26733,26846,49.89454824
IL,Boone ,2016,0,53570,26739,26831,49.91413104
IL,Boone ,2017,0,53513,26716,26797,49.92431746
IL,Boone ,2018,0,53480,26676,26804,49.88032909
IL,Boone ,2019,0,53544,26768,26776,49.99252951
IL,Brown ,2015,0,6753,4350,2403,64.41581519
IL,Brown ,2016,0,6637,4266,2371,64.27602833
IL,Brown ,2017,0,6609,4261,2348,64.47268876
IL,Brown ,2018,0,6563,4235,2328,64.52841688
IL,Brown ,2019,0,6578,4227,2351,64.25965339
IL,Bureau ,2015,0,33491,16432,17059,49.06392762
IL,Bureau ,2016,0,33396,16388,17008,49.07174512
IL,Bureau ,2017,0,33137,16271,16866,49.10221203
IL,Bureau ,2018,0,32959,16156,16803,49.0184775
IL,Bureau ,2019,0,32628,16004,16624,49.0498958
IL,Calhoun ,2015,0,4860,2442,2418,50.24691358
IL,Calhoun ,2016,0,4869,2438,2431,50.07188334
IL,Calhoun ,2017,0,4851,2431,2420,50.11337868
IL,Calhoun ,2018,0,4829,2415,2414,50.01035411
IL,Calhoun ,2019,0,4739,2383,2356,50.28487023
IL,Carroll ,2015,0,14642,7336,7306,50.10244502
IL,Carroll ,2016,0,14596,7302,7294,50.02740477
IL,Carroll ,2017,0,14475,7218,7257,49.86528497
IL,Carroll ,2018,0,14314,7136,7178,49.85329048
IL,Carroll ,2019,0,14305,7126,7179,49.81475009
IL,Cass ,2015,0,12843,6426,6417,50.03503854
IL,Cass ,2016,0,12672,6389,6283,50.41824495
IL,Cass ,2017,0,12492,6272,6220,50.20813321
IL,Cass ,2018,0,12312,6202,6110,50.37361923
IL,Cass ,2019,0,12147,6086,6061,50.10290607
IL,Champaign ,2015,0,209382,104496,104886,49.90686879
IL,Champaign ,2016,0,210198,105053,105145,49.97811587
IL,Champaign ,2017,0,210425,105002,105423,49.89996436
IL,Champaign ,2018,0,209918,104551,105367,49.80563839
IL,Champaign ,2019,0,209689,104175,105514,49.68071763
IL,Christian ,2015,0,33463,17050,16413,50.95179751
IL,Christian ,2016,0,33230,16916,16314,50.905808
IL,Christian ,2017,0,33007,16784,16223,50.84981974
IL,Christian ,2018,0,32653,16605,16048,50.85290785
IL,Christian ,2019,0,32304,16438,15866,50.88533928
IL,Clark ,2015,0,15868,7794,8074,49.1177212
IL,Clark ,2016,0,15857,7844,8013,49.46711232
IL,Clark ,2017,0,15812,7831,7981,49.5256767
IL,Clark ,2018,0,15600,7737,7863,49.59615385
IL,Clark ,2019,0,15441,7649,7792,49.53694709
IL,Clay ,2015,0,13401,6635,6766,49.51123051
IL,Clay ,2016,0,13314,6592,6722,49.5117921
IL,Clay ,2017,0,13270,6564,6706,49.46495855
IL,Clay ,2018,0,13266,6579,6687,49.59294437
IL,Clay ,2019,0,13184,6531,6653,49.53731796
IL,Clinton ,2015,0,37665,19547,18118,51.89698659
IL,Clinton ,2016,0,37599,19519,18080,51.91361472
IL,Clinton ,2017,0,37645,19565,18080,51.97237349
IL,Clinton ,2018,0,37697,19568,18129,51.90863994
IL,Clinton ,2019,0,37562,19448,18114,51.77573079
IL,Coles ,2015,0,52179,25368,26811,48.61725982
IL,Coles ,2016,0,51783,25090,26693,48.45219474
IL,Coles ,2017,0,51353,24921,26432,48.52881039
IL,Coles ,2018,0,50829,24624,26205,48.44478546
IL,Coles ,2019,0,50621,24589,26032,48.5747022
IL,Cook ,2015,0,5244088,2542930,2701158,48.4913678
IL,Cook ,2016,0,5224272,2534882,2689390,48.52124851
IL,Cook ,2017,0,5200821,2524876,2675945,48.54764277
IL,Cook ,2018,0,5171960,2511125,2660835,48.55267635
IL,Cook ,2019,0,5150233,2500872,2649361,48.55842444
IL,Crawford ,2015,0,19255,9998,9257,51.92417554
IL,Crawford ,2016,0,19133,9962,9171,52.06710918
IL,Crawford ,2017,0,18975,9927,9048,52.31620553
IL,Crawford ,2018,0,18830,9871,8959,52.42166755
IL,Crawford ,2019,0,18667,9796,8871,52.47763433
IL,Cumberland ,2015,0,10860,5439,5421,50.08287293
IL,Cumberland ,2016,0,10868,5445,5423,50.10121457
IL,Cumberland ,2017,0,10880,5449,5431,50.08272059
IL,Cumberland ,2018,0,10804,5378,5426,49.77786005
IL,Cumberland ,2019,0,10766,5358,5408,49.76778748
IL,DeKalb ,2015,0,104195,51735,52460,49.65209463
IL,DeKalb ,2016,0,104080,51592,52488,49.56956188
IL,DeKalb ,2017,0,104309,51721,52588,49.58440787
IL,DeKalb ,2018,0,104349,51743,52606,49.58648382
IL,DeKalb ,2019,0,104897,52068,52829,49.63726322
IL,De Witt ,2015,0,16184,8064,8120,49.82698962
IL,De Witt ,2016,0,16137,8019,8118,49.69325153
IL,De Witt ,2017,0,15906,7908,7998,49.71708789
IL,De Witt ,2018,0,15794,7821,7973,49.51880461
IL,De Witt ,2019,0,15638,7766,7872,49.66108198
IL,Douglas ,2015,0,19835,9812,10023,49.46811192
IL,Douglas ,2016,0,19727,9784,9943,49.59699904
IL,Douglas ,2017,0,19629,9738,9891,49.61027052
IL,Douglas ,2018,0,19458,9627,9831,49.47579402
IL,Douglas ,2019,0,19465,9668,9797,49.66863601
IL,DuPage ,2015,0,933609,458084,475525,49.0659366
IL,DuPage ,2016,0,931256,457258,473998,49.10121384
IL,DuPage ,2017,0,930265,457025,473240,49.12847414
IL,DuPage ,2018,0,927247,455746,471501,49.15044212
IL,DuPage ,2019,0,922921,453686,469235,49.15762021
IL,Edgar ,2015,0,17603,8578,9025,48.73033006
IL,Edgar ,2016,0,17519,8535,8984,48.71853416
IL,Edgar ,2017,0,17390,8491,8899,48.82691202
IL,Edgar ,2018,0,17360,8513,8847,49.03801843
IL,Edgar ,2019,0,17161,8409,8752,49.00064099
IL,Edwards ,2015,0,6511,3210,3301,49.30118261
IL,Edwards ,2016,0,6536,3218,3318,49.23500612
IL,Edwards ,2017,0,6448,3169,3279,49.14702233
IL,Edwards ,2018,0,6387,3149,3238,49.30327227
IL,Edwards ,2019,0,6395,3130,3265,48.94448788
IL,Effingham ,2015,0,34202,17042,17160,49.82749547
IL,Effingham ,2016,0,34170,16995,17175,49.73661106
IL,Effingham ,2017,0,34123,16991,17132,49.79339448
IL,Effingham ,2018,0,34181,17053,17128,49.89028993
IL,Effingham ,2019,0,34008,16975,17033,49.91472595
IL,Fayette ,2015,0,22036,11705,10331,53.1176257
IL,Fayette ,2016,0,21570,11337,10233,52.55910987
IL,Fayette ,2017,0,21514,11323,10191,52.63084503
IL,Fayette ,2018,0,21368,11278,10090,52.77985773
IL,Fayette ,2019,0,21336,11249,10087,52.72309711
IL,Ford ,2015,0,13529,6668,6861,49.28671742
IL,Ford ,2016,0,13352,6557,6795,49.10874775
IL,Ford ,2017,0,13298,6526,6772,49.07504888
IL,Ford ,2018,0,13212,6521,6691,49.35664547
IL,Ford ,2019,0,12961,6404,6557,49.40976776
IL,Franklin ,2015,0,39383,19403,19980,49.26745042
IL,Franklin ,2016,0,39075,19310,19765,49.41778631
IL,Franklin ,2017,0,38995,19226,19769,49.30375689
IL,Franklin ,2018,0,38695,19090,19605,49.33453935
IL,Franklin ,2019,0,38469,18942,19527,49.23964751
IL,Fulton ,2015,0,35713,18594,17119,52.06507434
IL,Fulton ,2016,0,35473,18412,17061,51.90426522
IL,Fulton ,2017,0,35104,18270,16834,52.04535096
IL,Fulton ,2018,0,34830,18125,16705,52.03847258
IL,Fulton ,2019,0,34340,17882,16458,52.07338381
IL,Gallatin ,2015,0,5221,2524,2697,48.34322927
IL,Gallatin ,2016,0,5157,2491,2666,48.3032771
IL,Gallatin ,2017,0,5071,2470,2601,48.70834155
IL,Gallatin ,2018,0,5045,2466,2579,48.88007929
IL,Gallatin ,2019,0,4828,2368,2460,49.04722452
IL,Greene ,2015,0,13345,6719,6626,50.34844511
IL,Greene ,2016,0,13123,6617,6506,50.42292159
IL,Greene ,2017,0,13156,6633,6523,50.4180602
IL,Greene ,2018,0,13065,6583,6482,50.38652889
IL,Greene ,2019,0,12969,6556,6413,50.55131467
IL,Grundy ,2015,0,50363,25099,25264,49.83618927
IL,Grundy ,2016,0,50317,25125,25192,49.9334221
IL,Grundy ,2017,0,50622,25207,25415,49.79455573
IL,Grundy ,2018,0,50973,25410,25563,49.84992055
IL,Grundy ,2019,0,51054,25418,25636,49.78650057
IL,Hamilton ,2015,0,8248,4021,4227,48.75121242
IL,Hamilton ,2016,0,8186,3997,4189,48.82726606
IL,Hamilton ,2017,0,8181,3986,4195,48.72265004
IL,Hamilton ,2018,0,8148,3980,4168,48.84634266
IL,Hamilton ,2019,0,8116,3977,4139,49.00197141
IL,Hancock ,2015,0,18216,9035,9181,49.5992534
IL,Hancock ,2016,0,18205,9048,9157,49.70063169
IL,Hancock ,2017,0,17958,8918,9040,49.66031852
IL,Hancock ,2018,0,17828,8859,8969,49.69149652
IL,Hancock ,2019,0,17708,8758,8950,49.45787215
IL,Hardin ,2015,0,4067,2044,2023,50.25817556
IL,Hardin ,2016,0,3991,2014,1977,50.46354297
IL,Hardin ,2017,0,3922,1969,1953,50.20397756
IL,Hardin ,2018,0,3893,1964,1929,50.44952479
IL,Hardin ,2019,0,3821,1933,1888,50.58885109
IL,Henderson ,2015,0,6997,3432,3565,49.04959268
IL,Henderson ,2016,0,6886,3387,3499,49.18675574
IL,Henderson ,2017,0,6819,3324,3495,48.74615046
IL,Henderson ,2018,0,6697,3279,3418,48.96222189
IL,Henderson ,2019,0,6646,3231,3415,48.6157087
IL,Henry ,2015,0,49638,24744,24894,49.84890608
IL,Henry ,2016,0,49498,24728,24770,49.95757404
IL,Henry ,2017,0,49219,24548,24671,49.87504825
IL,Henry ,2018,0,49069,24450,24619,49.82779352
IL,Henry ,2019,0,48913,24402,24511,49.88857768
IL,Iroquois ,2015,0,28522,13936,14586,48.86052871
IL,Iroquois ,2016,0,28163,13799,14364,48.99691084
IL,Iroquois ,2017,0,27777,13628,14149,49.06217374
IL,Iroquois ,2018,0,27484,13491,13993,49.08674138
IL,Iroquois ,2019,0,27114,13349,13765,49.23286863
IL,Jackson ,2015,0,59214,29716,29498,50.18407809
IL,Jackson ,2016,0,58726,29314,29412,49.91656166
IL,Jackson ,2017,0,57904,28802,29102,49.74095054
IL,Jackson ,2018,0,57289,28467,28822,49.6901674
IL,Jackson ,2019,0,56750,28122,28628,49.55418502
IL,Jasper ,2015,0,9630,4843,4787,50.29075805
IL,Jasper ,2016,0,9583,4797,4786,50.0573933
IL,Jasper ,2017,0,9523,4768,4755,50.0682558
IL,Jasper ,2018,0,9624,4803,4821,49.90648379
IL,Jasper ,2019,0,9610,4815,4795,50.10405827
IL,Jefferson ,2015,0,38272,19728,18544,51.54682274
IL,Jefferson ,2016,0,38214,19694,18520,51.53608625
IL,Jefferson ,2017,0,38045,19621,18424,51.57313707
IL,Jefferson ,2018,0,37708,19387,18321,51.41349316
IL,Jefferson ,2019,0,37684,19399,18285,51.47808088
IL,Jersey ,2015,0,22260,10838,11422,48.68823001
IL,Jersey ,2016,0,21947,10679,11268,48.65813095
IL,Jersey ,2017,0,21912,10674,11238,48.71303395
IL,Jersey ,2018,0,21795,10619,11176,48.72218399
IL,Jersey ,2019,0,21773,10596,11177,48.66577872
IL,Jo Daviess ,2015,0,22066,11029,11037,49.98187256
IL,Jo Daviess ,2016,0,21814,10888,10926,49.91289997
IL,Jo Daviess ,2017,0,21495,10713,10782,49.83949756
IL,Jo Daviess ,2018,0,21331,10675,10656,50.04453612
IL,Jo Daviess ,2019,0,21235,10636,10599,50.08712032
IL,Johnson ,2015,0,12777,7187,5590,56.24951084
IL,Johnson ,2016,0,12454,6812,5642,54.69728601
IL,Johnson ,2017,0,12399,6793,5606,54.78667634
IL,Johnson ,2018,0,12423,6784,5639,54.60838767
IL,Johnson ,2019,0,12417,6764,5653,54.4737054
IL,Kane ,2015,0,528760,262900,265860,49.72009986
IL,Kane ,2016,0,530726,263940,266786,49.73187671
IL,Kane ,2017,0,532272,264698,267574,49.72983738
IL,Kane ,2018,0,532720,265280,267440,49.79726686
IL,Kane ,2019,0,532403,265208,267195,49.81339324
IL,Kankakee ,2015,0,111750,54906,56844,49.13288591
IL,Kankakee ,2016,0,111080,54674,56406,49.22038171
IL,Kankakee ,2017,0,110540,54490,56050,49.29437308
IL,Kankakee ,2018,0,109953,54133,55820,49.23285404
IL,Kankakee ,2019,0,109862,54175,55687,49.31186397
IL,Kendall ,2015,0,122878,60833,62045,49.50682791
IL,Kendall ,2016,0,124535,61772,62763,49.60211989
IL,Kendall ,2017,0,126152,62648,63504,49.66072674
IL,Kendall ,2018,0,127717,63317,64400,49.57601572
IL,Kendall ,2019,0,128990,63908,65082,49.54492596
IL,Knox ,2015,0,51370,25864,25506,50.3484524
IL,Knox ,2016,0,50917,25707,25210,50.48804918
IL,Knox ,2017,0,50577,25514,25063,50.44585484
IL,Knox ,2018,0,49978,25249,24729,50.5202289
IL,Knox ,2019,0,49699,25120,24579,50.54427654
IL,Lake ,2015,0,704611,351886,352725,49.9404636
IL,Lake ,2016,0,704158,351924,352234,49.97798789
IL,Lake ,2017,0,702475,351043,351432,49.97231218
IL,Lake ,2018,0,699587,349558,350029,49.96633728
IL,Lake ,2019,0,696535,348294,348241,50.00380455
IL,LaSalle ,2015,0,111019,55928,55091,50.3769625
IL,LaSalle ,2016,0,110215,55553,54662,50.40420995
IL,LaSalle ,2017,0,109622,55245,54377,50.39590593
IL,LaSalle ,2018,0,109159,55024,54135,50.40720417
IL,LaSalle ,2019,0,108669,54844,53825,50.46885496
IL,Lawrence ,2015,0,16465,9203,7262,55.89432129
IL,Lawrence ,2016,0,16182,9015,7167,55.7100482
IL,Lawrence ,2017,0,16027,8933,7094,55.73719349
IL,Lawrence ,2018,0,15813,8847,6966,55.94763802
IL,Lawrence ,2019,0,15678,8777,6901,55.98290598
IL,Lee ,2015,0,34521,18242,16279,52.84319689
IL,Lee ,2016,0,34494,18267,16227,52.95703601
IL,Lee ,2017,0,34540,18322,16218,53.04574406
IL,Lee ,2018,0,34296,18204,16092,53.07907628
IL,Lee ,2019,0,34096,18111,15985,53.11766776
IL,Livingston ,2015,0,36605,18394,18211,50.24996585
IL,Livingston ,2016,0,36107,18114,17993,50.16755754
IL,Livingston ,2017,0,36124,18127,17997,50.17993578
IL,Livingston ,2018,0,35714,17908,17806,50.14280114
IL,Livingston ,2019,0,35648,17892,17756,50.19075404
IL,Logan ,2015,0,29284,14827,14457,50.6317443
IL,Logan ,2016,0,29166,14784,14382,50.68915861
IL,Logan ,2017,0,29034,14749,14285,50.79906317
IL,Logan ,2018,0,28912,14688,14224,50.80243498
IL,Logan ,2019,0,28618,14547,14071,50.83164442
IL,McDonough ,2015,0,31449,15578,15871,49.53416643
IL,McDonough ,2016,0,30907,15261,15646,49.37716375
IL,McDonough ,2017,0,30373,14937,15436,49.17854674
IL,McDonough ,2018,0,29984,14675,15309,48.94276948
IL,McDonough ,2019,0,29682,14561,15121,49.05666734
IL,McHenry ,2015,0,307572,153177,154395,49.80199758
IL,McHenry ,2016,0,307159,152908,154251,49.78138358
IL,McHenry ,2017,0,307815,153186,154629,49.76560596
IL,McHenry ,2018,0,308251,153401,154850,49.76496427
IL,McHenry ,2019,0,307774,153171,154603,49.76736177
IL,McLean ,2015,0,173141,84183,88958,48.62106607
IL,McLean ,2016,0,173070,84187,88883,48.64332351
IL,McLean ,2017,0,172754,83914,88840,48.57427324
IL,McLean ,2018,0,172410,83784,88626,48.59578911
IL,McLean ,2019,0,171517,83217,88300,48.51822268
IL,Macon ,2015,0,107343,51446,55897,47.92673952
IL,Macon ,2016,0,106383,50998,55385,47.93811041
IL,Macon ,2017,0,105399,50520,54879,47.93214357
IL,Macon ,2018,0,104504,50042,54462,47.88524841
IL,Macon ,2019,0,104009,49800,54209,47.88047188
IL,Macoupin ,2015,0,45876,22641,23235,49.35260267
IL,Macoupin ,2016,0,45691,22540,23151,49.33137817
IL,Macoupin ,2017,0,45505,22462,23043,49.36160861
IL,Macoupin ,2018,0,45318,22407,22911,49.44392956
IL,Macoupin ,2019,0,44926,22190,22736,49.39233406
IL,Madison ,2015,0,265996,129605,136391,48.72441691
IL,Madison ,2016,0,265641,129529,136112,48.7609217
IL,Madison ,2017,0,265251,129232,136019,48.72064573
IL,Madison ,2018,0,264026,128567,135459,48.69482551
IL,Madison ,2019,0,262966,128013,134953,48.68043778
IL,Marion ,2015,0,38359,18705,19654,48.76300216
IL,Marion ,2016,0,38045,18540,19505,48.73176502
IL,Marion ,2017,0,37726,18375,19351,48.70646239
IL,Marion ,2018,0,37381,18272,19109,48.88044729
IL,Marion ,2019,0,37205,18202,19003,48.92353178
IL,Marshall ,2015,0,11925,5928,5997,49.71069182
IL,Marshall ,2016,0,11881,5913,5968,49.768538
IL,Marshall ,2017,0,11668,5777,5891,49.5114844
IL,Marshall ,2018,0,11483,5686,5797,49.51667683
IL,Marshall ,2019,0,11438,5650,5788,49.39674768
IL,Mason ,2015,0,13863,6827,7036,49.24619491
IL,Mason ,2016,0,13675,6732,6943,49.2285192
IL,Mason ,2017,0,13677,6699,6978,48.98003948
IL,Mason ,2018,0,13533,6668,6865,49.27214956
IL,Mason ,2019,0,13359,6591,6768,49.33752526
IL,Massac ,2015,0,14567,6987,7580,47.96457747
IL,Massac ,2016,0,14440,6913,7527,47.87396122
IL,Massac ,2017,0,14291,6882,7409,48.15618221
IL,Massac ,2018,0,14023,6724,7299,47.94979676
IL,Massac ,2019,0,13772,6621,7151,48.07580598
IL,Menard ,2015,0,12356,6021,6335,48.72936225
IL,Menard ,2016,0,12398,6060,6338,48.87885143
IL,Menard ,2017,0,12293,5985,6308,48.6862442
IL,Menard ,2018,0,12289,5986,6303,48.71022866
IL,Menard ,2019,0,12196,5952,6244,48.80288619
IL,Mercer ,2015,0,15746,7820,7926,49.66340658
IL,Mercer ,2016,0,15602,7790,7812,49.92949622
IL,Mercer ,2017,0,15608,7774,7834,49.80779088
IL,Mercer ,2018,0,15551,7749,7802,49.82959295
IL,Mercer ,2019,0,15437,7695,7742,49.84776835
IL,Monroe ,2015,0,33739,16736,17003,49.60431548
IL,Monroe ,2016,0,33913,16783,17130,49.48839678
IL,Monroe ,2017,0,34179,16934,17245,49.54504228
IL,Monroe ,2018,0,34373,17078,17295,49.68434527
IL,Monroe ,2019,0,34637,17247,17390,49.79357335
IL,Montgomery ,2015,0,29192,15293,13899,52.38764045
IL,Montgomery ,2016,0,29061,15227,13834,52.39668284
IL,Montgomery ,2017,0,28781,15103,13678,52.47559154
IL,Montgomery ,2018,0,28691,15031,13660,52.38925098
IL,Montgomery ,2019,0,28414,14893,13521,52.41430281
IL,Morgan ,2015,0,34673,17479,17194,50.41098261
IL,Morgan ,2016,0,34632,17605,17027,50.83448833
IL,Morgan ,2017,0,34245,17335,16910,50.62052854
IL,Morgan ,2018,0,34027,17234,16793,50.64801481
IL,Morgan ,2019,0,33658,17019,16639,50.56450175
IL,Moultrie ,2015,0,14743,7218,7525,48.95882792
IL,Moultrie ,2016,0,14610,7149,7461,48.93223819
IL,Moultrie ,2017,0,14701,7198,7503,48.9626556
IL,Moultrie ,2018,0,14648,7186,7462,49.05789186
IL,Moultrie ,2019,0,14501,7082,7419,48.83801117
IL,Ogle ,2015,0,51559,25592,25967,49.63633895
IL,Ogle ,2016,0,51148,25390,25758,49.64025964
IL,Ogle ,2017,0,50993,25319,25674,49.65191301
IL,Ogle ,2018,0,50781,25179,25602,49.58350564
IL,Ogle ,2019,0,50643,25113,25530,49.58829453
IL,Peoria ,2015,0,186481,90548,95933,48.55615317
IL,Peoria ,2016,0,185043,89800,95243,48.52926077
IL,Peoria ,2017,0,182525,88486,94039,48.47883852
IL,Peoria ,2018,0,180620,87545,93075,48.46916178
IL,Peoria ,2019,0,179179,86927,92252,48.51405578
IL,Perry ,2015,0,21521,11790,9731,54.78369964
IL,Perry ,2016,0,21391,11712,9679,54.7519985
IL,Perry ,2017,0,21281,11686,9595,54.91283304
IL,Perry ,2018,0,21144,11632,9512,55.01324253
IL,Perry ,2019,0,20916,11551,9365,55.22566456
IL,Piatt ,2015,0,16350,8102,8248,49.55351682
IL,Piatt ,2016,0,16524,8159,8365,49.37666425
IL,Piatt ,2017,0,16422,8114,8308,49.40932895
IL,Piatt ,2018,0,16366,8104,8262,49.51729195
IL,Piatt ,2019,0,16344,8111,8233,49.62677435
IL,Pike ,2015,0,15795,7920,7875,50.14245014
IL,Pike ,2016,0,15742,7876,7866,50.03176216
IL,Pike ,2017,0,15668,7818,7850,49.89788103
IL,Pike ,2018,0,15595,7811,7784,50.08656621
IL,Pike ,2019,0,15561,7781,7780,50.00321316
IL,Pope ,2015,0,4291,2260,2031,52.66837567
IL,Pope ,2016,0,4182,2188,1994,52.31946437
IL,Pope ,2017,0,4183,2189,1994,52.33086302
IL,Pope ,2018,0,4184,2163,2021,51.69694073
IL,Pope ,2019,0,4177,2147,2030,51.40052669
IL,Pulaski ,2015,0,5657,2735,2922,48.34718048
IL,Pulaski ,2016,0,5604,2713,2891,48.41184868
IL,Pulaski ,2017,0,5520,2678,2842,48.51449275
IL,Pulaski ,2018,0,5434,2639,2795,48.5645933
IL,Pulaski ,2019,0,5335,2582,2753,48.39737582
IL,Putnam ,2015,0,5727,2934,2793,51.231011
IL,Putnam ,2016,0,5710,2921,2789,51.1558669
IL,Putnam ,2017,0,5694,2923,2771,51.33473832
IL,Putnam ,2018,0,5736,2923,2813,50.95885635
IL,Putnam ,2019,0,5739,2933,2806,51.10646454
IL,Randolph ,2015,0,32806,18151,14655,55.3282936
IL,Randolph ,2016,0,32414,17865,14549,55.11507373
IL,Randolph ,2017,0,32297,17816,14481,55.16301824
IL,Randolph ,2018,0,32177,17714,14463,55.05174504
IL,Randolph ,2019,0,31782,17519,14263,55.12239632
IL,Richland ,2015,0,15957,7875,8082,49.35138184
IL,Richland ,2016,0,15829,7830,7999,49.46616969
IL,Richland ,2017,0,15837,7838,7999,49.49169666
IL,Richland ,2018,0,15695,7776,7919,49.5444409
IL,Richland ,2019,0,15513,7656,7857,49.35215626
IL,Rock Island ,2015,0,146094,72054,74040,49.32030063
IL,Rock Island ,2016,0,144943,71555,73388,49.36768247
IL,Rock Island ,2017,0,143828,71021,72807,49.3791195
IL,Rock Island ,2018,0,142621,70328,72293,49.31111127
IL,Rock Island ,2019,0,141879,69912,71967,49.27579134
IL,St. Clair ,2015,0,264858,127954,136904,48.31041539
IL,St. Clair ,2016,0,263187,127073,136114,48.28239997
IL,St. Clair ,2017,0,262600,126799,135801,48.28598629
IL,St. Clair ,2018,0,261360,126082,135278,48.24074074
IL,St. Clair ,2019,0,259686,125101,134585,48.17394854
IL,Saline ,2015,0,24495,12083,12412,49.32843437
IL,Saline ,2016,0,24230,11951,12279,49.32315312
IL,Saline ,2017,0,23963,11831,12132,49.37194842
IL,Saline ,2018,0,23789,11732,12057,49.31691118
IL,Saline ,2019,0,23491,11551,11940,49.17202333
IL,Sangamon ,2015,0,198898,95597,103301,48.06332894
IL,Sangamon ,2016,0,198026,95091,102935,48.01945199
IL,Sangamon ,2017,0,197072,94642,102430,48.02407242
IL,Sangamon ,2018,0,195639,93954,101685,48.02416696
IL,Sangamon ,2019,0,194672,93458,101214,48.00793129
IL,Schuyler ,2015,0,7151,3763,3388,52.62201091
IL,Schuyler ,2016,0,7030,3677,3353,52.30440967
IL,Schuyler ,2017,0,6948,3642,3306,52.417962
IL,Schuyler ,2018,0,6870,3599,3271,52.38719068
IL,Schuyler ,2019,0,6768,3547,3221,52.40839243
IL,Scott ,2015,0,5110,2498,2612,48.88454012
IL,Scott ,2016,0,5052,2469,2583,48.87173397
IL,Scott ,2017,0,4983,2456,2527,49.28757776
IL,Scott ,2018,0,4927,2422,2505,49.15770246
IL,Scott ,2019,0,4951,2434,2517,49.1617855
IL,Shelby ,2015,0,21819,10794,11025,49.47064485
IL,Shelby ,2016,0,21733,10799,10934,49.68941241
IL,Shelby ,2017,0,21774,10823,10951,49.70607146
IL,Shelby ,2018,0,21726,10820,10906,49.80208046
IL,Shelby ,2019,0,21634,10772,10862,49.79199408
IL,Stark ,2015,0,5505,2698,2807,49.00999092
IL,Stark ,2016,0,5512,2707,2805,49.11103048
IL,Stark ,2017,0,5457,2684,2773,49.18453363
IL,Stark ,2018,0,5418,2686,2732,49.57548911
IL,Stark ,2019,0,5342,2652,2690,49.64432797
IL,Stephenson ,2015,0,45668,22112,23556,48.41902426
IL,Stephenson ,2016,0,45503,22068,23435,48.49790124
IL,Stephenson ,2017,0,44997,21828,23169,48.50990066
IL,Stephenson ,2018,0,44797,21775,23022,48.60816573
IL,Stephenson ,2019,0,44498,21638,22860,48.62690458
IL,Tazewell ,2015,0,134302,66083,68219,49.20477729
IL,Tazewell ,2016,0,133932,65956,67976,49.24588597
IL,Tazewell ,2017,0,133489,65657,67832,49.18532613
IL,Tazewell ,2018,0,132450,65123,67327,49.16798792
IL,Tazewell ,2019,0,131803,64848,66955,49.20070105
IL,Union ,2015,0,17284,8608,8676,49.80328628
IL,Union ,2016,0,17105,8500,8605,49.6930722
IL,Union ,2017,0,16968,8458,8510,49.84677039
IL,Union ,2018,0,16832,8427,8405,50.06535171
IL,Union ,2019,0,16653,8345,8308,50.11109109
IL,Vermilion ,2015,0,79170,39310,39860,49.6526462
IL,Vermilion ,2016,0,78494,38974,39520,49.65220272
IL,Vermilion ,2017,0,77689,38600,39089,49.68528363
IL,Vermilion ,2018,0,76702,38181,38521,49.77836302
IL,Vermilion ,2019,0,75758,37722,38036,49.79276116
IL,Wabash ,2015,0,11624,5793,5831,49.83654508
IL,Wabash ,2016,0,11542,5782,5760,50.09530411
IL,Wabash ,2017,0,11523,5780,5743,50.16054847
IL,Wabash ,2018,0,11523,5802,5721,50.35147097
IL,Wabash ,2019,0,11520,5806,5714,50.39930556
IL,Warren ,2015,0,17455,8618,8837,49.37267259
IL,Warren ,2016,0,17294,8541,8753,49.38707066
IL,Warren ,2017,0,17144,8473,8671,49.4225385
IL,Warren ,2018,0,16992,8380,8612,49.3173258
IL,Warren ,2019,0,16844,8314,8530,49.35882213
IL,Washington ,2015,0,14262,7156,7106,50.17529098
IL,Washington ,2016,0,14179,7093,7086,50.02468439
IL,Washington ,2017,0,13963,6981,6982,49.99641911
IL,Washington ,2018,0,13999,6987,7012,49.91070791
IL,Washington ,2019,0,13887,6949,6938,50.03960539
IL,Wayne ,2015,0,16517,8153,8364,49.36126415
IL,Wayne ,2016,0,16542,8179,8363,49.44383992
IL,Wayne ,2017,0,16412,8089,8323,49.28710699
IL,Wayne ,2018,0,16326,8036,8290,49.22209972
IL,Wayne ,2019,0,16215,8004,8211,49.36170213
IL,White ,2015,0,14204,6930,7274,48.7890735
IL,White ,2016,0,14079,6904,7175,49.03757369
IL,White ,2017,0,13903,6824,7079,49.08293174
IL,White ,2018,0,13618,6695,6923,49.16287267
IL,White ,2019,0,13537,6639,6898,49.04336264
IL,Whiteside ,2015,0,56919,28133,28786,49.42637784
IL,Whiteside ,2016,0,56476,27927,28549,49.44932361
IL,Whiteside ,2017,0,55955,27695,28260,49.49513002
IL,Whiteside ,2018,0,55553,27515,28038,49.52927835
IL,Whiteside ,2019,0,55175,27302,27873,49.48255551
IL,Will ,2015,0,685877,340466,345411,49.63951262
IL,Will ,2016,0,688328,341492,346836,49.61181297
IL,Will ,2017,0,690479,342540,347939,49.60903952
IL,Will ,2018,0,691149,342962,348187,49.62200625
IL,Will ,2019,0,690743,342744,347999,49.6196125
IL,Williamson ,2015,0,67428,33510,33918,49.69745506
IL,Williamson ,2016,0,67454,33566,33888,49.76131882
IL,Williamson ,2017,0,67049,33358,33691,49.75167415
IL,Williamson ,2018,0,66982,33286,33696,49.69394763
IL,Williamson ,2019,0,66597,33155,33442,49.78452483
IL,Winnebago ,2015,0,287148,140264,146884,48.84728433
IL,Winnebago ,2016,0,286065,139740,146325,48.84903781
IL,Winnebago ,2017,0,284681,139060,145621,48.84765755
IL,Winnebago ,2018,0,283630,138499,145131,48.83087121
IL,Winnebago ,2019,0,282572,137829,144743,48.77659499
IL,Woodford ,2015,0,38930,19338,19592,49.67377344
IL,Woodford ,2016,0,38913,19369,19544,49.77513941
IL,Woodford ,2017,0,38670,19287,19383,49.87587277
IL,Woodford ,2018,0,38527,19238,19289,49.93381265
IL,Woodford ,2019,0,38459,19225,19234,49.98829923
IN,Adams ,2015,0,34945,17375,17570,49.72099013
IN,Adams ,2016,0,35178,17514,17664,49.78679857
IN,Adams ,2017,0,35385,17659,17726,49.90532712
IN,Adams ,2018,0,35595,17786,17809,49.96769209
IN,Adams ,2019,0,35777,17875,17902,49.96226626
IN,Allen ,2015,0,367362,179303,188059,48.80825997
IN,Allen ,2016,0,369412,180608,188804,48.8906695
IN,Allen ,2017,0,371723,181708,190015,48.88263573
IN,Allen ,2018,0,375079,183358,191721,48.88516819
IN,Allen ,2019,0,379299,185582,193717,48.92762702
IN,Bartholomew ,2015,0,81458,40838,40620,50.13381129
IN,Bartholomew ,2016,0,82231,41271,40960,50.18910143
IN,Bartholomew ,2017,0,82213,41267,40946,50.1952246
IN,Bartholomew ,2018,0,82722,41587,41135,50.27320423
IN,Bartholomew ,2019,0,83779,42179,41600,50.34555199
IN,Benton ,2015,0,8693,4367,4326,50.23582193
IN,Benton ,2016,0,8658,4333,4325,50.04620005
IN,Benton ,2017,0,8631,4321,4310,50.06372379
IN,Benton ,2018,0,8653,4316,4337,49.8786548
IN,Benton ,2019,0,8748,4363,4385,49.87425697
IN,Blackford ,2015,0,12242,6043,6199,49.36284921
IN,Blackford ,2016,0,12115,5990,6125,49.44283946
IN,Blackford ,2017,0,12028,5923,6105,49.24343199
IN,Blackford ,2018,0,11924,5869,6055,49.22006038
IN,Blackford ,2019,0,11758,5759,5999,48.97941827
IN,Boone ,2015,0,63033,31236,31797,49.554995
IN,Boone ,2016,0,64192,31849,32343,49.61521685
IN,Boone ,2017,0,65723,32668,33055,49.70558252
IN,Boone ,2018,0,66930,33284,33646,49.72956821
IN,Boone ,2019,0,67843,33727,34116,49.71330867
IN,Brown ,2015,0,14994,7429,7565,49.54648526
IN,Brown ,2016,0,14996,7412,7584,49.42651374
IN,Brown ,2017,0,15010,7410,7600,49.36708861
IN,Brown ,2018,0,15230,7488,7742,49.1661195
IN,Brown ,2019,0,15092,7454,7638,49.39040551
IN,Carroll ,2015,0,19887,9896,9991,49.7611505
IN,Carroll ,2016,0,19973,9966,10007,49.89736144
IN,Carroll ,2017,0,20067,10059,10008,50.1270743
IN,Carroll ,2018,0,20188,10155,10033,50.3021597
IN,Carroll ,2019,0,20257,10193,10064,50.31840845
IN,Cass ,2015,0,38081,19037,19044,49.99080906
IN,Cass ,2016,0,37905,18976,18929,50.0619971
IN,Cass ,2017,0,37828,18858,18970,49.85196151
IN,Cass ,2018,0,37895,18861,19034,49.7717377
IN,Cass ,2019,0,37689,18830,18859,49.96152724
IN,Clark ,2015,0,114819,56138,58681,48.89260488
IN,Clark ,2016,0,115588,56393,59195,48.78793646
IN,Clark ,2017,0,116545,56811,59734,48.74597795
IN,Clark ,2018,0,117280,57188,60092,48.76193724
IN,Clark ,2019,0,118302,57657,60645,48.7371304
IN,Clay ,2015,0,26395,13020,13375,49.32752415
IN,Clay ,2016,0,26210,12928,13282,49.32468523
IN,Clay ,2017,0,26167,12927,13240,49.40191845
IN,Clay ,2018,0,26175,12941,13234,49.44030564
IN,Clay ,2019,0,26225,13018,13207,49.63965682
IN,Clinton ,2015,0,32373,16022,16351,49.4918605
IN,Clinton ,2016,0,32207,15958,16249,49.54823486
IN,Clinton ,2017,0,32195,16013,16182,49.73753688
IN,Clinton ,2018,0,32192,15991,16201,49.67383201
IN,Clinton ,2019,0,32399,16129,16270,49.78240069
IN,Crawford ,2015,0,10555,5358,5197,50.76267172
IN,Crawford ,2016,0,10583,5366,5217,50.70395918
IN,Crawford ,2017,0,10535,5346,5189,50.74513526
IN,Crawford ,2018,0,10594,5398,5196,50.95336983
IN,Crawford ,2019,0,10577,5387,5190,50.93126595
IN,Daviess ,2015,0,32823,16475,16348,50.1934619
IN,Daviess ,2016,0,33010,16574,16436,50.20902757
IN,Daviess ,2017,0,33136,16703,16433,50.40741188
IN,Daviess ,2018,0,33278,16815,16463,50.52887794
IN,Daviess ,2019,0,33351,16827,16524,50.45425924
IN,Dearborn ,2015,0,49455,24627,24828,49.79678496
IN,Dearborn ,2016,0,49436,24560,24876,49.68039485
IN,Dearborn ,2017,0,49564,24689,24875,49.81236381
IN,Dearborn ,2018,0,49482,24586,24896,49.68675478
IN,Dearborn ,2019,0,49458,24576,24882,49.69064661
IN,Decatur ,2015,0,26339,13076,13263,49.6450131
IN,Decatur ,2016,0,26565,13221,13344,49.76849238
IN,Decatur ,2017,0,26620,13240,13380,49.73703982
IN,Decatur ,2018,0,26725,13288,13437,49.7212348
IN,Decatur ,2019,0,26559,13198,13361,49.69313604
IN,DeKalb ,2015,0,42496,21133,21363,49.7293863
IN,DeKalb ,2016,0,42652,21190,21462,49.68114039
IN,DeKalb ,2017,0,42806,21244,21562,49.62855674
IN,DeKalb ,2018,0,43208,21425,21783,49.58572487
IN,DeKalb ,2019,0,43475,21566,21909,49.60552041
IN,Delaware ,2015,0,115767,55948,59819,48.32810732
IN,Delaware ,2016,0,115657,55828,59829,48.27031654
IN,Delaware ,2017,0,115246,55547,59699,48.19863596
IN,Delaware ,2018,0,114297,55140,59157,48.24273603
IN,Delaware ,2019,0,114135,54996,59139,48.18504403
IN,Dubois ,2015,0,42317,20997,21320,49.61835669
IN,Dubois ,2016,0,42450,21132,21318,49.78091873
IN,Dubois ,2017,0,42538,21194,21344,49.82368706
IN,Dubois ,2018,0,42674,21297,21377,49.90626611
IN,Dubois ,2019,0,42736,21437,21299,50.16145638
IN,Elkhart ,2015,0,202995,100432,102563,49.47511022
IN,Elkhart ,2016,0,203642,100742,102900,49.47014859
IN,Elkhart ,2017,0,204194,100976,103218,49.45101227
IN,Elkhart ,2018,0,205617,101641,103976,49.43219675
IN,Elkhart ,2019,0,206341,101948,104393,49.40753413
IN,Fayette ,2015,0,23388,11567,11821,49.45698649
IN,Fayette ,2016,0,23252,11481,11771,49.37639773
IN,Fayette ,2017,0,23154,11420,11734,49.32193142
IN,Fayette ,2018,0,23076,11348,11728,49.17663373
IN,Fayette ,2019,0,23102,11401,11701,49.35070557
IN,Floyd ,2015,0,76505,37073,39432,48.4582707
IN,Floyd ,2016,0,76734,37207,39527,48.4882842
IN,Floyd ,2017,0,77006,37325,39681,48.47024907
IN,Floyd ,2018,0,77834,37753,40081,48.5045096
IN,Floyd ,2019,0,78522,38122,40400,48.54945111
IN,Fountain ,2015,0,16537,8279,8258,50.06349398
IN,Fountain ,2016,0,16457,8215,8242,49.91796804
IN,Fountain ,2017,0,16419,8201,8218,49.94823071
IN,Fountain ,2018,0,16390,8176,8214,49.88407566
IN,Fountain ,2019,0,16346,8152,8194,49.8715282
IN,Franklin ,2015,0,22940,11497,11443,50.11769834
IN,Franklin ,2016,0,22770,11381,11389,49.98243303
IN,Franklin ,2017,0,22694,11335,11359,49.94712259
IN,Franklin ,2018,0,22706,11317,11389,49.8414516
IN,Franklin ,2019,0,22758,11333,11425,49.79787328
IN,Fulton ,2015,0,20340,10096,10244,49.63618486
IN,Fulton ,2016,0,20118,9996,10122,49.6868476
IN,Fulton ,2017,0,19995,9956,10039,49.79244811
IN,Fulton ,2018,0,20053,10012,10041,49.92769162
IN,Fulton ,2019,0,19974,9966,10008,49.89486332
IN,Gibson ,2015,0,33644,16763,16881,49.82463441
IN,Gibson ,2016,0,33644,16763,16881,49.82463441
IN,Gibson ,2017,0,33721,16864,16857,50.01037929
IN,Gibson ,2018,0,33610,16829,16781,50.07140732
IN,Gibson ,2019,0,33659,16895,16764,50.19459877
IN,Grant ,2015,0,67479,32340,35139,47.92602143
IN,Grant ,2016,0,66669,31958,34711,47.93532226
IN,Grant ,2017,0,66305,31721,34584,47.84103763
IN,Grant ,2018,0,66039,31600,34439,47.85051258
IN,Grant ,2019,0,65769,31473,34296,47.85385212
IN,Greene ,2015,0,32416,16212,16204,50.01233959
IN,Greene ,2016,0,32228,16115,16113,50.00310289
IN,Greene ,2017,0,32172,16116,16056,50.09324879
IN,Greene ,2018,0,32059,16030,16029,50.00155962
IN,Greene ,2019,0,31922,15954,15968,49.97807155
IN,Hamilton ,2015,0,308428,150832,157596,48.9034718
IN,Hamilton ,2016,0,315902,154317,161585,48.84964324
IN,Hamilton ,2017,0,322933,157527,165406,48.78008751
IN,Hamilton ,2018,0,330311,161448,168863,48.87757295
IN,Hamilton ,2019,0,338011,165068,172943,48.83509708
IN,Hancock ,2015,0,72413,35527,36886,49.06163258
IN,Hancock ,2016,0,73765,36284,37481,49.1886396
IN,Hancock ,2017,0,74998,36831,38167,49.10930958
IN,Hancock ,2018,0,76478,37615,38863,49.18407908
IN,Hancock ,2019,0,78168,38506,39662,49.26056698
IN,Harrison ,2015,0,39532,19755,19777,49.97217444
IN,Harrison ,2016,0,39661,19824,19837,49.9836111
IN,Harrison ,2017,0,39777,19917,19860,50.07164945
IN,Harrison ,2018,0,40214,20095,20119,49.97015965
IN,Harrison ,2019,0,40515,20272,20243,50.03578921
IN,Hendricks ,2015,0,157776,78943,78833,50.03485955
IN,Hendricks ,2016,0,160376,80173,80203,49.99064698
IN,Hendricks ,2017,0,163622,81891,81731,50.04889318
IN,Hendricks ,2018,0,166908,83456,83452,50.00119826
IN,Hendricks ,2019,0,170311,85123,85188,49.98091726
IN,Henry ,2015,0,48655,25261,23394,51.91861063
IN,Henry ,2016,0,48345,25155,23190,52.03226807
IN,Henry ,2017,0,48170,25045,23125,51.99294166
IN,Henry ,2018,0,48131,25079,23052,52.1057115
IN,Henry ,2019,0,47972,25033,22939,52.18252314
IN,Howard ,2015,0,82338,39875,42463,48.42842916
IN,Howard ,2016,0,82304,39904,42400,48.4836703
IN,Howard ,2017,0,82210,39827,42383,48.44544459
IN,Howard ,2018,0,82257,39903,42354,48.51015719
IN,Howard ,2019,0,82544,40082,42462,48.55834464
IN,Huntington ,2015,0,36518,17979,18539,49.23325483
IN,Huntington ,2016,0,36294,17905,18389,49.33322312
IN,Huntington ,2017,0,36222,17877,18345,49.35398377
IN,Huntington ,2018,0,36243,17890,18353,49.36125597
IN,Huntington ,2019,0,36520,18063,18457,49.46056955
IN,Jackson ,2015,0,43875,21902,21973,49.91908832
IN,Jackson ,2016,0,43997,21931,22066,49.84658045
IN,Jackson ,2017,0,43955,21910,22045,49.84643385
IN,Jackson ,2018,0,44068,21987,22081,49.89334665
IN,Jackson ,2019,0,44231,22121,22110,50.01243472
IN,Jasper ,2015,0,33478,16644,16834,49.71623156
IN,Jasper ,2016,0,33405,16605,16800,49.70812753
IN,Jasper ,2017,0,33424,16603,16821,49.67388703
IN,Jasper ,2018,0,33365,16605,16760,49.76772067
IN,Jasper ,2019,0,33562,16692,16870,49.73481914
IN,Jay ,2015,0,21137,10458,10679,49.47722004
IN,Jay ,2016,0,21017,10425,10592,49.60270257
IN,Jay ,2017,0,20883,10398,10485,49.7916966
IN,Jay ,2018,0,20727,10341,10386,49.89144594
IN,Jay ,2019,0,20436,10213,10223,49.97553337
IN,Jefferson ,2015,0,32297,15520,16777,48.05399882
IN,Jefferson ,2016,0,32230,15503,16727,48.101148
IN,Jefferson ,2017,0,32013,15456,16557,48.28038609
IN,Jefferson ,2018,0,32157,15448,16709,48.03930715
IN,Jefferson ,2019,0,32308,15509,16799,48.00359044
IN,Jennings ,2015,0,27834,13948,13886,50.11137458
IN,Jennings ,2016,0,27648,13904,13744,50.28935185
IN,Jennings ,2017,0,27652,13895,13757,50.24952987
IN,Jennings ,2018,0,27679,13877,13802,50.13548177
IN,Jennings ,2019,0,27735,13882,13853,50.05228051
IN,Johnson ,2015,0,148962,73404,75558,49.27699682
IN,Johnson ,2016,0,151540,74845,76695,49.38960011
IN,Johnson ,2017,0,153820,75935,77885,49.36614224
IN,Johnson ,2018,0,156093,76979,79114,49.31611283
IN,Johnson ,2019,0,158167,78019,80148,49.32697718
IN,Knox ,2015,0,37760,19128,18632,50.65677966
IN,Knox ,2016,0,37333,18884,18449,50.58259449
IN,Knox ,2017,0,37044,18689,18355,50.45081525
IN,Knox ,2018,0,36596,18466,18130,50.45906656
IN,Knox ,2019,0,36594,18513,18081,50.5902607
IN,Kosciusko ,2015,0,78547,39043,39504,49.70654513
IN,Kosciusko ,2016,0,78732,39122,39610,49.69008789
IN,Kosciusko ,2017,0,79026,39392,39634,49.84688584
IN,Kosciusko ,2018,0,79416,39691,39725,49.97859373
IN,Kosciusko ,2019,0,79456,39727,39729,49.99874144
IN,LaGrange ,2015,0,38616,19485,19131,50.45835923
IN,LaGrange ,2016,0,39113,19743,19370,50.47682356
IN,LaGrange ,2017,0,39248,19868,19380,50.62168773
IN,LaGrange ,2018,0,39375,19984,19391,50.75301587
IN,LaGrange ,2019,0,39614,20110,19504,50.7648811
IN,Lake ,2015,0,487908,235844,252064,48.33780139
IN,Lake ,2016,0,486092,235113,250979,48.36800441
IN,Lake ,2017,0,484601,234341,250260,48.35751474
IN,Lake ,2018,0,484440,234427,250013,48.39133845
IN,Lake ,2019,0,485493,234924,250569,48.38875123
IN,LaPorte ,2015,0,110835,57143,53692,51.55681869
IN,LaPorte ,2016,0,110222,56753,53469,51.48972075
IN,LaPorte ,2017,0,109842,56568,53274,51.49942645
IN,LaPorte ,2018,0,109981,56688,53293,51.54344841
IN,LaPorte ,2019,0,109888,56630,53258,51.53428946
IN,Lawrence ,2015,0,45568,22581,22987,49.55451194
IN,Lawrence ,2016,0,45578,22581,22997,49.54363948
IN,Lawrence ,2017,0,45592,22579,23013,49.52403931
IN,Lawrence ,2018,0,45630,22592,23038,49.51128643
IN,Lawrence ,2019,0,45370,22464,22906,49.51289398
IN,Madison ,2015,0,129388,64645,64743,49.96212941
IN,Madison ,2016,0,129329,64537,64792,49.90141422
IN,Madison ,2017,0,129418,64648,64770,49.95286591
IN,Madison ,2018,0,129573,64771,64802,49.98803763
IN,Madison ,2019,0,129569,64849,64720,50.04978043
IN,Marion ,2015,0,939843,452601,487242,48.15708581
IN,Marion ,2016,0,945685,455679,490006,48.1850722
IN,Marion ,2017,0,950537,457944,492593,48.17739867
IN,Marion ,2018,0,958700,461986,496714,48.18879733
IN,Marion ,2019,0,964582,465006,499576,48.20803208
IN,Marshall ,2015,0,46733,23193,23540,49.628742
IN,Marshall ,2016,0,46586,23144,23442,49.68016142
IN,Marshall ,2017,0,46433,23081,23352,49.70818168
IN,Marshall ,2018,0,46296,23083,23213,49.8595991
IN,Marshall ,2019,0,46258,23021,23237,49.76652687
IN,Martin ,2015,0,10216,5152,5064,50.43069695
IN,Martin ,2016,0,10190,5154,5036,50.57899902
IN,Martin ,2017,0,10181,5153,5028,50.61388862
IN,Martin ,2018,0,10219,5180,5039,50.68989138
IN,Martin ,2019,0,10255,5196,5059,50.66796685
IN,Miami ,2015,0,36004,19307,16697,53.62459727
IN,Miami ,2016,0,36043,19306,16737,53.5637988
IN,Miami ,2017,0,35864,19268,16596,53.72518403
IN,Miami ,2018,0,35646,19182,16464,53.81248948
IN,Miami ,2019,0,35516,19118,16398,53.82926005
IN,Monroe ,2015,0,144247,71892,72355,49.83951139
IN,Monroe ,2016,0,145757,72622,73135,49.82402217
IN,Monroe ,2017,0,146638,72974,73664,49.76472674
IN,Monroe ,2018,0,147230,73166,74064,49.69503498
IN,Monroe ,2019,0,148431,73727,74704,49.67089085
IN,Montgomery ,2015,0,38243,19331,18912,50.54781267
IN,Montgomery ,2016,0,38238,19357,18881,50.62241749
IN,Montgomery ,2017,0,38343,19408,18935,50.61680098
IN,Montgomery ,2018,0,38274,19401,18873,50.68976329
IN,Montgomery ,2019,0,38338,19484,18854,50.8216391
IN,Morgan ,2015,0,69559,34445,35114,49.51911327
IN,Morgan ,2016,0,69633,34410,35223,49.41622507
IN,Morgan ,2017,0,69793,34612,35181,49.592366
IN,Morgan ,2018,0,70137,34835,35302,49.66708014
IN,Morgan ,2019,0,70489,35025,35464,49.6886039
IN,Newton ,2015,0,13971,7106,6865,50.86250089
IN,Newton ,2016,0,13992,7101,6891,50.75042882
IN,Newton ,2017,0,14027,7085,6942,50.50973123
IN,Newton ,2018,0,13986,7075,6911,50.58630059
IN,Newton ,2019,0,13984,7054,6930,50.44336384
IN,Noble ,2015,0,47515,23795,23720,50.07892245
IN,Noble ,2016,0,47398,23807,23591,50.22785772
IN,Noble ,2017,0,47329,23762,23567,50.20600478
IN,Noble ,2018,0,47543,23837,23706,50.13777002
IN,Noble ,2019,0,47744,23938,23806,50.13823727
IN,Ohio ,2015,0,5877,2930,2947,49.85536839
IN,Ohio ,2016,0,5885,2941,2944,49.97451147
IN,Ohio ,2017,0,5854,2922,2932,49.91458832
IN,Ohio ,2018,0,5879,2913,2966,49.54924307
IN,Ohio ,2019,0,5875,2919,2956,49.68510638
IN,Orange ,2015,0,19634,9742,9892,49.61800958
IN,Orange ,2016,0,19473,9677,9796,49.69444872
IN,Orange ,2017,0,19423,9695,9728,49.91504917
IN,Orange ,2018,0,19548,9787,9761,50.06650297
IN,Orange ,2019,0,19646,9813,9833,49.94909905
IN,Owen ,2015,0,20826,10487,10339,50.35532507
IN,Owen ,2016,0,20898,10491,10407,50.20097617
IN,Owen ,2017,0,20791,10448,10343,50.25251311
IN,Owen ,2018,0,20862,10449,10413,50.08628128
IN,Owen ,2019,0,20799,10420,10379,50.09856243
IN,Parke ,2015,0,16970,8000,8970,47.14201532
IN,Parke ,2016,0,16938,8076,8862,47.67977329
IN,Parke ,2017,0,16907,8028,8879,47.48329094
IN,Parke ,2018,0,16978,8029,8949,47.29061138
IN,Parke ,2019,0,16937,7970,8967,47.05673968
IN,Perry ,2015,0,19310,10364,8946,53.67167271
IN,Perry ,2016,0,18978,10037,8941,52.88755401
IN,Perry ,2017,0,18978,10062,8916,53.01928549
IN,Perry ,2018,0,19077,10202,8875,53.47801017
IN,Perry ,2019,0,19169,10316,8853,53.81605718
IN,Pike ,2015,0,12407,6245,6162,50.3344886
IN,Pike ,2016,0,12391,6210,6181,50.11702042
IN,Pike ,2017,0,12315,6172,6143,50.11774259
IN,Pike ,2018,0,12388,6155,6233,49.68517921
IN,Pike ,2019,0,12389,6169,6220,49.79417225
IN,Porter ,2015,0,167334,82541,84793,49.32709431
IN,Porter ,2016,0,167475,82731,84744,49.39901478
IN,Porter ,2017,0,168495,83334,85161,49.45784741
IN,Porter ,2018,0,169488,83815,85673,49.4518786
IN,Porter ,2019,0,170389,84265,86124,49.45448356
IN,Posey ,2015,0,25613,12723,12890,49.67399368
IN,Posey ,2016,0,25639,12779,12860,49.84203752
IN,Posey ,2017,0,25569,12721,12848,49.75165239
IN,Posey ,2018,0,25554,12767,12787,49.96086718
IN,Posey ,2019,0,25427,12709,12718,49.98230228
IN,Pulaski ,2015,0,12804,6520,6284,50.921587
IN,Pulaski ,2016,0,12618,6435,6183,50.99857347
IN,Pulaski ,2017,0,12529,6411,6118,51.16928725
IN,Pulaski ,2018,0,12492,6378,6114,51.05667627
IN,Pulaski ,2019,0,12353,6329,6024,51.23451793
IN,Putnam ,2015,0,37382,19766,17616,52.87571559
IN,Putnam ,2016,0,37113,19498,17615,52.53684693
IN,Putnam ,2017,0,37363,19571,17792,52.38069748
IN,Putnam ,2018,0,37486,19698,17788,52.54761778
IN,Putnam ,2019,0,37576,19686,17890,52.38982329
IN,Randolph ,2015,0,25138,12332,12806,49.05720423
IN,Randolph ,2016,0,25112,12329,12783,49.0960497
IN,Randolph ,2017,0,24907,12209,12698,49.01834826
IN,Randolph ,2018,0,24806,12162,12644,49.02846086
IN,Randolph ,2019,0,24665,12126,12539,49.16278127
IN,Ripley ,2015,0,28372,13982,14390,49.28098125
IN,Ripley ,2016,0,28381,14001,14380,49.33229978
IN,Ripley ,2017,0,28428,14084,14344,49.54270438
IN,Ripley ,2018,0,28450,14115,14335,49.61335677
IN,Ripley ,2019,0,28324,14100,14224,49.78110436
IN,Rush ,2015,0,16708,8159,8549,48.83289442
IN,Rush ,2016,0,16639,8124,8515,48.82504958
IN,Rush ,2017,0,16643,8178,8465,49.13777564
IN,Rush ,2018,0,16635,8200,8435,49.29365795
IN,Rush ,2019,0,16581,8158,8423,49.20089259
IN,St. Joseph ,2015,0,268361,130449,137912,48.60952225
IN,St. Joseph ,2016,0,269862,131177,138685,48.60891863
IN,St. Joseph ,2017,0,270057,131140,138917,48.56011879
IN,St. Joseph ,2018,0,270972,131784,139188,48.63380718
IN,St. Joseph ,2019,0,271826,132376,139450,48.69879997
IN,Scott ,2015,0,23660,11650,12010,49.23922232
IN,Scott ,2016,0,23687,11667,12020,49.25486554
IN,Scott ,2017,0,23793,11715,12078,49.2371706
IN,Scott ,2018,0,23784,11677,12107,49.09603095
IN,Scott ,2019,0,23873,11701,12172,49.01352993
IN,Shelby ,2015,0,44341,21946,22395,49.49369658
IN,Shelby ,2016,0,44229,21925,22304,49.57154808
IN,Shelby ,2017,0,44367,22028,22339,49.64951428
IN,Shelby ,2018,0,44522,22135,22387,49.71699385
IN,Shelby ,2019,0,44729,22225,22504,49.6881218
IN,Spencer ,2015,0,20640,10432,10208,50.54263566
IN,Spencer ,2016,0,20491,10323,10168,50.37821483
IN,Spencer ,2017,0,20440,10311,10129,50.44520548
IN,Spencer ,2018,0,20385,10267,10118,50.3654648
IN,Spencer ,2019,0,20277,10227,10050,50.4364551
IN,Starke ,2015,0,22860,11381,11479,49.78565179
IN,Starke ,2016,0,23019,11510,11509,50.00217212
IN,Starke ,2017,0,22935,11473,11462,50.02398082
IN,Starke ,2018,0,22951,11457,11494,49.91939349
IN,Starke ,2019,0,22995,11476,11519,49.90650141
IN,Steuben ,2015,0,34469,17500,16969,50.77025733
IN,Steuben ,2016,0,34329,17456,16873,50.8491363
IN,Steuben ,2017,0,34384,17430,16954,50.69218241
IN,Steuben ,2018,0,34487,17499,16988,50.74085887
IN,Steuben ,2019,0,34594,17522,17072,50.6504018
IN,Sullivan ,2015,0,20874,11353,9521,54.38823417
IN,Sullivan ,2016,0,20710,11245,9465,54.29744085
IN,Sullivan ,2017,0,20700,11224,9476,54.22222222
IN,Sullivan ,2018,0,20696,11256,9440,54.38732122
IN,Sullivan ,2019,0,20669,11257,9412,54.46320577
IN,Switzerland ,2015,0,10614,5436,5178,51.21537592
IN,Switzerland ,2016,0,10641,5458,5183,51.29217179
IN,Switzerland ,2017,0,10686,5472,5214,51.20718697
IN,Switzerland ,2018,0,10731,5532,5199,51.55157954
IN,Switzerland ,2019,0,10751,5542,5209,51.54869314
IN,Tippecanoe ,2015,0,186723,95447,91276,51.11689508
IN,Tippecanoe ,2016,0,190292,97355,92937,51.16084754
IN,Tippecanoe ,2017,0,191199,97690,93509,51.09336346
IN,Tippecanoe ,2018,0,193817,99057,94760,51.10851989
IN,Tippecanoe ,2019,0,195732,100050,95682,51.11581142
IN,Tipton ,2015,0,15249,7610,7639,49.9049118
IN,Tipton ,2016,0,15163,7560,7603,49.85820748
IN,Tipton ,2017,0,15137,7523,7614,49.69941204
IN,Tipton ,2018,0,15112,7519,7593,49.75516146
IN,Tipton ,2019,0,15148,7545,7603,49.80855558
IN,Union ,2015,0,7185,3545,3640,49.33890049
IN,Union ,2016,0,7139,3542,3597,49.61479199
IN,Union ,2017,0,7159,3566,3593,49.81142618
IN,Union ,2018,0,7029,3496,3533,49.73680467
IN,Union ,2019,0,7054,3485,3569,49.40459314
IN,Vanderburgh ,2015,0,181504,87770,93734,48.357061
IN,Vanderburgh ,2016,0,181427,87798,93629,48.39301758
IN,Vanderburgh ,2017,0,180954,87669,93285,48.44822441
IN,Vanderburgh ,2018,0,181120,87757,93363,48.45240724
IN,Vanderburgh ,2019,0,181451,87952,93499,48.47148817
IN,Vermillion ,2015,0,15593,7777,7816,49.87494389
IN,Vermillion ,2016,0,15593,7772,7821,49.84287821
IN,Vermillion ,2017,0,15503,7723,7780,49.81616461
IN,Vermillion ,2018,0,15510,7724,7786,49.80012895
IN,Vermillion ,2019,0,15498,7735,7763,49.90966576
IN,Vigo ,2015,0,107533,54617,52916,50.79092
IN,Vigo ,2016,0,107790,54564,53226,50.62065127
IN,Vigo ,2017,0,107569,54407,53162,50.57869832
IN,Vigo ,2018,0,107367,54305,53062,50.5788557
IN,Vigo ,2019,0,107038,54102,52936,50.54466638
IN,Wabash ,2015,0,31860,15490,16370,48.61895794
IN,Wabash ,2016,0,31513,15296,16217,48.53869831
IN,Wabash ,2017,0,31380,15217,16163,48.49267049
IN,Wabash ,2018,0,31198,15106,16092,48.4197705
IN,Wabash ,2019,0,30996,15047,15949,48.54497354
IN,Warren ,2015,0,8270,4114,4156,49.74607013
IN,Warren ,2016,0,8165,4064,4101,49.77342315
IN,Warren ,2017,0,8204,4073,4131,49.6465139
IN,Warren ,2018,0,8280,4090,4190,49.39613527
IN,Warren ,2019,0,8265,4102,4163,49.63097399
IN,Warrick ,2015,0,61522,30338,31184,49.31244108
IN,Warrick ,2016,0,62005,30555,31450,49.27828401
IN,Warrick ,2017,0,62401,30710,31691,49.2139549
IN,Warrick ,2018,0,62474,30666,31808,49.08601978
IN,Warrick ,2019,0,62998,30906,32092,49.05870028
IN,Washington ,2015,0,27774,13837,13937,49.81997552
IN,Washington ,2016,0,27728,13807,13921,49.79443162
IN,Washington ,2017,0,27771,13851,13920,49.87576969
IN,Washington ,2018,0,27932,13913,14019,49.81025347
IN,Washington ,2019,0,28036,13987,14049,49.88942788
IN,Wayne ,2015,0,66972,32434,34538,48.42919429
IN,Wayne ,2016,0,66630,32247,34383,48.39711842
IN,Wayne ,2017,0,66179,32064,34115,48.45041478
IN,Wayne ,2018,0,66046,31991,34055,48.43745268
IN,Wayne ,2019,0,65884,31871,34013,48.37441564
IN,Wells ,2015,0,27851,13788,14063,49.50630139
IN,Wells ,2016,0,27865,13768,14097,49.40965369
IN,Wells ,2017,0,27958,13813,14145,49.40625224
IN,Wells ,2018,0,28083,13845,14238,49.30028843
IN,Wells ,2019,0,28296,13967,14329,49.36033362
IN,White ,2015,0,24274,12058,12216,49.6745489
IN,White ,2016,0,24074,12007,12067,49.87538423
IN,White ,2017,0,24163,12031,12132,49.79100277
IN,White ,2018,0,24133,12016,12117,49.79074297
IN,White ,2019,0,24102,12001,12101,49.79254834
IN,Whitley ,2015,0,33444,16686,16758,49.89235737
IN,Whitley ,2016,0,33475,16686,16789,49.84615385
IN,Whitley ,2017,0,33722,16830,16892,49.90807188
IN,Whitley ,2018,0,34047,16958,17089,49.80761888
IN,Whitley ,2019,0,33964,16938,17026,49.87045107
IA,Adair ,2015,0,7145,3531,3614,49.41917425
IA,Adair ,2016,0,7005,3479,3526,49.66452534
IA,Adair ,2017,0,7051,3496,3555,49.58161963
IA,Adair ,2018,0,7074,3510,3564,49.61832061
IA,Adair ,2019,0,7152,3562,3590,49.80425056
IA,Adams ,2015,0,3754,1870,1884,49.81353223
IA,Adams ,2016,0,3692,1849,1843,50.08125677
IA,Adams ,2017,0,3657,1822,1835,49.82225868
IA,Adams ,2018,0,3644,1822,1822,50
IA,Adams ,2019,0,3602,1799,1803,49.94447529
IA,Allamakee ,2015,0,13874,7060,6814,50.88655038
IA,Allamakee ,2016,0,13851,7064,6787,50.9999278
IA,Allamakee ,2017,0,13803,7024,6779,50.88748823
IA,Allamakee ,2018,0,13852,7049,6803,50.88795842
IA,Allamakee ,2019,0,13687,6986,6701,51.04113392
IA,Appanoose ,2015,0,12577,6205,6372,49.33608969
IA,Appanoose ,2016,0,12505,6156,6349,49.22830868
IA,Appanoose ,2017,0,12353,6098,6255,49.36452684
IA,Appanoose ,2018,0,12401,6121,6280,49.35892267
IA,Appanoose ,2019,0,12426,6152,6274,49.50909384
IA,Audubon ,2015,0,5711,2793,2918,48.90562073
IA,Audubon ,2016,0,5626,2753,2873,48.93352293
IA,Audubon ,2017,0,5550,2720,2830,49.00900901
IA,Audubon ,2018,0,5471,2666,2805,48.72966551
IA,Audubon ,2019,0,5496,2674,2822,48.65356623
IA,Benton ,2015,0,25608,12732,12876,49.71883786
IA,Benton ,2016,0,25644,12783,12861,49.84791764
IA,Benton ,2017,0,25656,12815,12841,49.94932959
IA,Benton ,2018,0,25625,12792,12833,49.92
IA,Benton ,2019,0,25645,12812,12833,49.95905635
IA,Black Hawk ,2015,0,133701,65536,68165,49.01683607
IA,Black Hawk ,2016,0,133077,65301,67776,49.07008724
IA,Black Hawk ,2017,0,132238,64942,67296,49.10993814
IA,Black Hawk ,2018,0,131723,64690,67033,49.11063368
IA,Black Hawk ,2019,0,131228,64624,66604,49.24558783
IA,Boone ,2015,0,26443,13339,13104,50.444352
IA,Boone ,2016,0,26416,13312,13104,50.39370079
IA,Boone ,2017,0,26443,13366,13077,50.54645842
IA,Boone ,2018,0,26312,13309,13003,50.58148373
IA,Boone ,2019,0,26234,13289,12945,50.65563772
IA,Bremer ,2015,0,24746,12187,12559,49.24836337
IA,Bremer ,2016,0,24747,12223,12524,49.39184548
IA,Bremer ,2017,0,24823,12299,12524,49.54679128
IA,Bremer ,2018,0,24941,12338,12603,49.46874624
IA,Bremer ,2019,0,25062,12400,12662,49.47729631
IA,Buchanan ,2015,0,21105,10527,10578,49.87917555
IA,Buchanan ,2016,0,21007,10443,10564,49.71200076
IA,Buchanan ,2017,0,21126,10509,10617,49.7443908
IA,Buchanan ,2018,0,21178,10499,10679,49.57503069
IA,Buchanan ,2019,0,21175,10507,10668,49.61983471
IA,Buena Vista ,2015,0,20374,10294,10080,50.52517915
IA,Buena Vista ,2016,0,20325,10245,10080,50.40590406
IA,Buena Vista ,2017,0,20144,10202,9942,50.64535346
IA,Buena Vista ,2018,0,19826,10058,9768,50.73136286
IA,Buena Vista ,2019,0,19620,9896,9724,50.43832824
IA,Butler ,2015,0,14881,7427,7454,49.90928029
IA,Butler ,2016,0,14702,7337,7365,49.90477486
IA,Butler ,2017,0,14592,7277,7315,49.86979167
IA,Butler ,2018,0,14525,7225,7300,49.74182444
IA,Butler ,2019,0,14439,7180,7259,49.72643535
IA,Calhoun ,2015,0,9801,5077,4724,51.80083665
IA,Calhoun ,2016,0,9811,5055,4756,51.52379982
IA,Calhoun ,2017,0,9729,5005,4724,51.44413609
IA,Calhoun ,2018,0,9711,5015,4696,51.64246731
IA,Calhoun ,2019,0,9668,5014,4654,51.86181216
IA,Carroll ,2015,0,20423,10004,10419,48.98398864
IA,Carroll ,2016,0,20388,10022,10366,49.15636649
IA,Carroll ,2017,0,20274,9988,10286,49.26506856
IA,Carroll ,2018,0,20153,9938,10215,49.31275741
IA,Carroll ,2019,0,20165,9979,10186,49.48673444
IA,Cass ,2015,0,13351,6598,6753,49.41951914
IA,Cass ,2016,0,13176,6514,6662,49.4383728
IA,Cass ,2017,0,13144,6474,6670,49.25441266
IA,Cass ,2018,0,12948,6380,6568,49.27401915
IA,Cass ,2019,0,12836,6308,6528,49.14303521
IA,Cedar ,2015,0,18254,9102,9152,49.86304372
IA,Cedar ,2016,0,18348,9156,9192,49.90189666
IA,Cedar ,2017,0,18490,9225,9265,49.89183342
IA,Cedar ,2018,0,18564,9231,9333,49.72527473
IA,Cedar ,2019,0,18627,9272,9355,49.77720513
IA,Cerro Gordo ,2015,0,42983,21041,21942,48.95191122
IA,Cerro Gordo ,2016,0,43096,21049,22047,48.84211992
IA,Cerro Gordo ,2017,0,42999,21030,21969,48.90811414
IA,Cerro Gordo ,2018,0,42642,20850,21792,48.89545519
IA,Cerro Gordo ,2019,0,42450,20784,21666,48.96113074
IA,Cherokee ,2015,0,11483,5769,5714,50.23948446
IA,Cherokee ,2016,0,11394,5713,5681,50.14042478
IA,Cherokee ,2017,0,11307,5672,5635,50.16361546
IA,Cherokee ,2018,0,11295,5661,5634,50.11952191
IA,Cherokee ,2019,0,11235,5622,5613,50.0400534
IA,Chickasaw ,2015,0,12151,6107,6044,50.25923792
IA,Chickasaw ,2016,0,12094,6090,6004,50.35554821
IA,Chickasaw ,2017,0,12002,6061,5941,50.49991668
IA,Chickasaw ,2018,0,11952,6033,5919,50.47690763
IA,Chickasaw ,2019,0,11933,6000,5933,50.2807341
IA,Clarke ,2015,0,9219,4625,4594,50.16813103
IA,Clarke ,2016,0,9288,4673,4615,50.31223084
IA,Clarke ,2017,0,9396,4749,4647,50.54278416
IA,Clarke ,2018,0,9502,4832,4670,50.85245212
IA,Clarke ,2019,0,9395,4791,4604,50.99521022
IA,Clay ,2015,0,16498,8082,8416,48.98775609
IA,Clay ,2016,0,16295,8005,8290,49.12549862
IA,Clay ,2017,0,16141,7932,8209,49.14193668
IA,Clay ,2018,0,16106,7891,8215,48.99416367
IA,Clay ,2019,0,16016,7874,8142,49.16333666
IA,Clayton ,2015,0,17726,8939,8787,50.42874873
IA,Clayton ,2016,0,17661,8898,8763,50.38219806
IA,Clayton ,2017,0,17648,8919,8729,50.53830462
IA,Clayton ,2018,0,17540,8891,8649,50.68985177
IA,Clayton ,2019,0,17549,8897,8652,50.69804547
IA,Clinton ,2015,0,47558,23305,24253,49.00332226
IA,Clinton ,2016,0,47248,23158,24090,49.01371487
IA,Clinton ,2017,0,46874,22951,23923,48.96317788
IA,Clinton ,2018,0,46437,22800,23637,49.09877899
IA,Clinton ,2019,0,46429,22787,23642,49.07923927
IA,Crawford ,2015,0,17082,8765,8317,51.31132186
IA,Crawford ,2016,0,17103,8785,8318,51.36525756
IA,Crawford ,2017,0,17076,8756,8320,51.27664558
IA,Crawford ,2018,0,17089,8730,8359,51.08549359
IA,Crawford ,2019,0,16820,8577,8243,50.99286564
IA,Dallas ,2015,0,80631,39639,40992,49.16099267
IA,Dallas ,2016,0,84248,41468,42780,49.2213465
IA,Dallas ,2017,0,87208,42989,44219,49.29478947
IA,Dallas ,2018,0,89953,44325,45628,49.27573288
IA,Dallas ,2019,0,93453,46056,47397,49.28252705
IA,Davis ,2015,0,8777,4317,4460,49.18537086
IA,Davis ,2016,0,8884,4378,4506,49.27960378
IA,Davis ,2017,0,8969,4436,4533,49.45924852
IA,Davis ,2018,0,8972,4436,4536,49.44271066
IA,Davis ,2019,0,9000,4467,4533,49.63333333
IA,Decatur ,2015,0,8137,4120,4017,50.63291139
IA,Decatur ,2016,0,8053,4071,3982,50.5525891
IA,Decatur ,2017,0,7947,4009,3938,50.44670945
IA,Decatur ,2018,0,7890,3960,3930,50.19011407
IA,Decatur ,2019,0,7870,3961,3909,50.33036849
IA,Delaware ,2015,0,17393,8689,8704,49.9568792
IA,Delaware ,2016,0,17288,8689,8599,50.26029616
IA,Delaware ,2017,0,17143,8630,8513,50.34124716
IA,Delaware ,2018,0,17081,8607,8474,50.38932147
IA,Delaware ,2019,0,17011,8618,8393,50.66133678
IA,Des Moines ,2015,0,39874,19486,20388,48.86893715
IA,Des Moines ,2016,0,39613,19312,20301,48.75167243
IA,Des Moines ,2017,0,39326,19142,20184,48.67517673
IA,Des Moines ,2018,0,39149,19021,20128,48.58617078
IA,Des Moines ,2019,0,38967,18982,19985,48.71301358
IA,Dickinson ,2015,0,17004,8476,8528,49.8470948
IA,Dickinson ,2016,0,17109,8530,8579,49.85680051
IA,Dickinson ,2017,0,17141,8543,8598,49.83956595
IA,Dickinson ,2018,0,17121,8488,8633,49.57654343
IA,Dickinson ,2019,0,17258,8581,8677,49.72186812
IA,Dubuque ,2015,0,96850,47782,49068,49.33608673
IA,Dubuque ,2016,0,96763,47769,48994,49.36701012
IA,Dubuque ,2017,0,97066,47890,49176,49.33756413
IA,Dubuque ,2018,0,96922,47910,49012,49.43150162
IA,Dubuque ,2019,0,97311,48017,49294,49.3438563
IA,Emmet ,2015,0,9702,4913,4789,50.6390435
IA,Emmet ,2016,0,9581,4838,4743,50.49577288
IA,Emmet ,2017,0,9422,4743,4679,50.33963065
IA,Emmet ,2018,0,9277,4680,4597,50.44734289
IA,Emmet ,2019,0,9208,4641,4567,50.4018245
IA,Fayette ,2015,0,20142,10135,10007,50.31774402
IA,Fayette ,2016,0,19858,9998,9860,50.34746702
IA,Fayette ,2017,0,19687,9956,9731,50.57144308
IA,Fayette ,2018,0,19679,9958,9721,50.60216474
IA,Fayette ,2019,0,19650,9896,9754,50.36132316
IA,Floyd ,2015,0,15910,7841,8069,49.28346952
IA,Floyd ,2016,0,15857,7823,8034,49.33467869
IA,Floyd ,2017,0,15767,7763,8004,49.23574554
IA,Floyd ,2018,0,15752,7774,7978,49.35246318
IA,Floyd ,2019,0,15642,7723,7919,49.37348165
IA,Franklin ,2015,0,10319,5174,5145,50.14051749
IA,Franklin ,2016,0,10177,5133,5044,50.43726049
IA,Franklin ,2017,0,10160,5098,5062,50.17716535
IA,Franklin ,2018,0,10085,5067,5018,50.24293505
IA,Franklin ,2019,0,10070,5099,4971,50.63555114
IA,Fremont ,2015,0,6912,3448,3464,49.88425926
IA,Fremont ,2016,0,6947,3466,3481,49.89203973
IA,Fremont ,2017,0,6930,3458,3472,49.8989899
IA,Fremont ,2018,0,6981,3489,3492,49.97851311
IA,Fremont ,2019,0,6960,3501,3459,50.30172414
IA,Greene ,2015,0,8944,4402,4542,49.21735242
IA,Greene ,2016,0,9001,4439,4562,49.31674258
IA,Greene ,2017,0,8954,4414,4540,49.29640384
IA,Greene ,2018,0,8965,4428,4537,49.39208031
IA,Greene ,2019,0,8888,4397,4491,49.47119712
IA,Grundy ,2015,0,12405,6121,6284,49.34300685
IA,Grundy ,2016,0,12286,6060,6226,49.32443432
IA,Grundy ,2017,0,12298,6068,6230,49.34135632
IA,Grundy ,2018,0,12272,6061,6211,49.38885267
IA,Grundy ,2019,0,12232,6060,6172,49.54218443
IA,Guthrie ,2015,0,10649,5308,5341,49.84505587
IA,Guthrie ,2016,0,10642,5295,5347,49.75568502
IA,Guthrie ,2017,0,10645,5293,5352,49.72287459
IA,Guthrie ,2018,0,10720,5352,5368,49.92537313
IA,Guthrie ,2019,0,10689,5340,5349,49.95790065
IA,Hamilton ,2015,0,15218,7540,7678,49.54658956
IA,Hamilton ,2016,0,15075,7487,7588,49.66500829
IA,Hamilton ,2017,0,15032,7482,7550,49.77381586
IA,Hamilton ,2018,0,14886,7416,7470,49.81862152
IA,Hamilton ,2019,0,14773,7322,7451,49.56339268
IA,Hancock ,2015,0,11028,5528,5500,50.12694958
IA,Hancock ,2016,0,10887,5453,5434,50.08726003
IA,Hancock ,2017,0,10756,5386,5370,50.07437709
IA,Hancock ,2018,0,10710,5359,5351,50.03734827
IA,Hancock ,2019,0,10630,5342,5288,50.25399812
IA,Hardin ,2015,0,17253,8632,8621,50.03187851
IA,Hardin ,2016,0,17196,8604,8592,50.03489184
IA,Hardin ,2017,0,17073,8598,8475,50.36021789
IA,Hardin ,2018,0,16937,8505,8432,50.21550452
IA,Hardin ,2019,0,16846,8450,8396,50.16027544
IA,Harrison ,2015,0,14139,7014,7125,49.6074687
IA,Harrison ,2016,0,14046,6984,7062,49.72234088
IA,Harrison ,2017,0,14107,7032,7075,49.84759339
IA,Harrison ,2018,0,14105,7053,7052,50.00354484
IA,Harrison ,2019,0,14049,7071,6978,50.33098441
IA,Henry ,2015,0,19843,10173,9670,51.26744948
IA,Henry ,2016,0,19833,10177,9656,51.31346745
IA,Henry ,2017,0,20044,10366,9678,51.71622431
IA,Henry ,2018,0,20033,10327,9706,51.54994259
IA,Henry ,2019,0,19954,10289,9665,51.56359627
IA,Howard ,2015,0,9313,4653,4660,49.96241813
IA,Howard ,2016,0,9257,4646,4611,50.18904613
IA,Howard ,2017,0,9229,4628,4601,50.14627804
IA,Howard ,2018,0,9172,4591,4581,50.05451374
IA,Howard ,2019,0,9158,4572,4586,49.9235641
IA,Humboldt ,2015,0,9556,4729,4827,49.48723315
IA,Humboldt ,2016,0,9530,4699,4831,49.30745016
IA,Humboldt ,2017,0,9569,4708,4861,49.20054342
IA,Humboldt ,2018,0,9559,4706,4853,49.23109112
IA,Humboldt ,2019,0,9558,4709,4849,49.26762921
IA,Ida ,2015,0,6968,3473,3495,49.84213548
IA,Ida ,2016,0,6961,3479,3482,49.97845137
IA,Ida ,2017,0,6869,3402,3467,49.5268598
IA,Ida ,2018,0,6846,3416,3430,49.89775051
IA,Ida ,2019,0,6860,3412,3448,49.73760933
IA,Iowa ,2015,0,16282,8094,8188,49.71133767
IA,Iowa ,2016,0,16192,8061,8131,49.78384387
IA,Iowa ,2017,0,16133,8077,8056,50.06508399
IA,Iowa ,2018,0,16155,8080,8075,50.01547509
IA,Iowa ,2019,0,16184,8108,8076,50.09886307
IA,Jackson ,2015,0,19366,9673,9693,49.94836311
IA,Jackson ,2016,0,19393,9704,9689,50.03867375
IA,Jackson ,2017,0,19382,9692,9690,50.00515943
IA,Jackson ,2018,0,19427,9710,9717,49.98198384
IA,Jackson ,2019,0,19439,9725,9714,50.02829364
IA,Jasper ,2015,0,36750,18838,17912,51.25986395
IA,Jasper ,2016,0,36736,18771,17965,51.09701655
IA,Jasper ,2017,0,36995,18975,18020,51.29071496
IA,Jasper ,2018,0,37189,19025,18164,51.15760037
IA,Jasper ,2019,0,37185,19010,18175,51.12276456
IA,Jefferson ,2015,0,17906,9825,8081,54.86987602
IA,Jefferson ,2016,0,18063,9905,8158,54.83585229
IA,Jefferson ,2017,0,18219,9994,8225,54.85482189
IA,Jefferson ,2018,0,18256,9979,8277,54.66148116
IA,Jefferson ,2019,0,18295,10025,8270,54.79639246
IA,Johnson ,2015,0,144943,72054,72889,49.71195573
IA,Johnson ,2016,0,146928,72920,74008,49.62975063
IA,Johnson ,2017,0,149325,74199,75126,49.68960321
IA,Johnson ,2018,0,150549,74841,75708,49.71205388
IA,Johnson ,2019,0,151140,74890,76250,49.55008601
IA,Jones ,2015,0,20433,10612,9821,51.93559438
IA,Jones ,2016,0,20392,10554,9838,51.75559043
IA,Jones ,2017,0,20618,10705,9913,51.92065186
IA,Jones ,2018,0,20673,10727,9946,51.88893726
IA,Jones ,2019,0,20681,10732,9949,51.89304192
IA,Keokuk ,2015,0,10171,5138,5033,50.51617343
IA,Keokuk ,2016,0,10170,5182,4988,50.95378564
IA,Keokuk ,2017,0,10141,5153,4988,50.81352924
IA,Keokuk ,2018,0,10213,5194,5019,50.8567512
IA,Keokuk ,2019,0,10246,5170,5076,50.4587156
IA,Kossuth ,2015,0,15158,7591,7567,50.07916612
IA,Kossuth ,2016,0,15104,7593,7511,50.27145127
IA,Kossuth ,2017,0,14939,7499,7440,50.19746971
IA,Kossuth ,2018,0,14878,7492,7386,50.35623068
IA,Kossuth ,2019,0,14813,7467,7346,50.40842503
IA,Lee ,2015,0,34894,17548,17346,50.28944804
IA,Lee ,2016,0,34458,17373,17085,50.41790005
IA,Lee ,2017,0,34216,17238,16978,50.37993921
IA,Lee ,2018,0,33909,17067,16842,50.33177033
IA,Lee ,2019,0,33657,16949,16708,50.35802359
IA,Linn ,2015,0,220271,108619,111652,49.31152989
IA,Linn ,2016,0,222188,109573,112615,49.31544458
IA,Linn ,2017,0,224379,110542,113837,49.26575125
IA,Linn ,2018,0,225763,111138,114625,49.22772996
IA,Linn ,2019,0,226706,111755,114951,49.29512232
IA,Louisa ,2015,0,11285,5772,5513,51.14754098
IA,Louisa ,2016,0,11221,5713,5508,50.91346582
IA,Louisa ,2017,0,11195,5712,5483,51.02277803
IA,Louisa ,2018,0,11153,5694,5459,51.0535282
IA,Louisa ,2019,0,11035,5628,5407,51.00135931
IA,Lucas ,2015,0,8610,4357,4253,50.6039489
IA,Lucas ,2016,0,8555,4323,4232,50.53185272
IA,Lucas ,2017,0,8533,4339,4194,50.84964256
IA,Lucas ,2018,0,8617,4393,4224,50.98061971
IA,Lucas ,2019,0,8600,4402,4198,51.18604651
IA,Lyon ,2015,0,11747,5963,5784,50.76189665
IA,Lyon ,2016,0,11780,5973,5807,50.70458404
IA,Lyon ,2017,0,11785,5993,5792,50.85277896
IA,Lyon ,2018,0,11815,5999,5816,50.77443927
IA,Lyon ,2019,0,11755,5970,5785,50.78689919
IA,Madison ,2015,0,15720,7831,7889,49.81552163
IA,Madison ,2016,0,15796,7900,7896,50.01266143
IA,Madison ,2017,0,16000,7996,8004,49.975
IA,Madison ,2018,0,16206,8100,8106,49.98148834
IA,Madison ,2019,0,16338,8202,8136,50.20198311
IA,Mahaska ,2015,0,22312,11252,11060,50.43026174
IA,Mahaska ,2016,0,22186,11232,10954,50.62652123
IA,Mahaska ,2017,0,22211,11247,10964,50.63707172
IA,Mahaska ,2018,0,22018,11150,10868,50.64038514
IA,Mahaska ,2019,0,22095,11221,10874,50.78524553
IA,Marion ,2015,0,33109,16493,16616,49.8142499
IA,Marion ,2016,0,33146,16526,16620,49.8582031
IA,Marion ,2017,0,33091,16475,16616,49.78695113
IA,Marion ,2018,0,33259,16631,16628,50.00451006
IA,Marion ,2019,0,33253,16605,16648,49.93534418
IA,Marshall ,2015,0,40352,20361,19991,50.4584655
IA,Marshall ,2016,0,40135,20241,19894,50.43229102
IA,Marshall ,2017,0,40078,20270,19808,50.57637607
IA,Marshall ,2018,0,39888,20161,19727,50.54402327
IA,Marshall ,2019,0,39369,19896,19473,50.53722472
IA,Mills ,2015,0,14882,7470,7412,50.19486628
IA,Mills ,2016,0,15053,7559,7494,50.21590381
IA,Mills ,2017,0,15060,7583,7477,50.35192563
IA,Mills ,2018,0,15068,7579,7489,50.29864614
IA,Mills ,2019,0,15109,7598,7511,50.28790787
IA,Mitchell ,2015,0,10676,5277,5399,49.42862495
IA,Mitchell ,2016,0,10644,5255,5389,49.37053739
IA,Mitchell ,2017,0,10563,5211,5352,49.33257597
IA,Mitchell ,2018,0,10571,5253,5318,49.6925551
IA,Mitchell ,2019,0,10586,5264,5322,49.72605328
IA,Monona ,2015,0,8866,4367,4499,49.25558313
IA,Monona ,2016,0,8786,4317,4469,49.13498748
IA,Monona ,2017,0,8724,4277,4447,49.0256763
IA,Monona ,2018,0,8659,4221,4438,48.74696847
IA,Monona ,2019,0,8615,4174,4441,48.45037725
IA,Monroe ,2015,0,7924,3950,3974,49.84856133
IA,Monroe ,2016,0,7836,3916,3920,49.97447677
IA,Monroe ,2017,0,7798,3874,3924,49.67940498
IA,Monroe ,2018,0,7768,3848,3920,49.53656025
IA,Monroe ,2019,0,7707,3828,3879,49.66913196
IA,Montgomery ,2015,0,10149,4944,5205,48.71415903
IA,Montgomery ,2016,0,10124,4945,5179,48.8443303
IA,Montgomery ,2017,0,10112,4924,5188,48.69462025
IA,Montgomery ,2018,0,9961,4851,5110,48.69992973
IA,Montgomery ,2019,0,9917,4812,5105,48.52273873
IA,Muscatine ,2015,0,43068,21474,21594,49.86068543
IA,Muscatine ,2016,0,42968,21458,21510,49.93948985
IA,Muscatine ,2017,0,42872,21382,21490,49.87404366
IA,Muscatine ,2018,0,42874,21405,21469,49.92536269
IA,Muscatine ,2019,0,42664,21355,21309,50.05390962
IA,O'Brien ,2015,0,13926,6976,6950,50.09335057
IA,O'Brien ,2016,0,13926,6986,6940,50.1651587
IA,O'Brien ,2017,0,13774,6897,6877,50.07260055
IA,O'Brien ,2018,0,13798,6913,6885,50.10146398
IA,O'Brien ,2019,0,13753,6898,6855,50.15632953
IA,Osceola ,2015,0,6160,3139,3021,50.95779221
IA,Osceola ,2016,0,6095,3119,2976,51.1730927
IA,Osceola ,2017,0,6021,3075,2946,51.07125062
IA,Osceola ,2018,0,6028,3062,2966,50.79628401
IA,Osceola ,2019,0,5958,3025,2933,50.77207116
IA,Page ,2015,0,15462,8139,7323,52.6387272
IA,Page ,2016,0,15329,8107,7222,52.88668537
IA,Page ,2017,0,15213,8045,7168,52.88240321
IA,Page ,2018,0,15229,8070,7159,52.99100401
IA,Page ,2019,0,15107,8017,7090,53.06811412
IA,Palo Alto ,2015,0,9140,4517,4623,49.42013129
IA,Palo Alto ,2016,0,9034,4485,4549,49.6457826
IA,Palo Alto ,2017,0,9052,4484,4568,49.53601414
IA,Palo Alto ,2018,0,8903,4428,4475,49.73604403
IA,Palo Alto ,2019,0,8886,4423,4463,49.77492685
IA,Plymouth ,2015,0,24899,12348,12551,49.59235311
IA,Plymouth ,2016,0,25180,12457,12723,49.47180302
IA,Plymouth ,2017,0,25060,12443,12617,49.6528332
IA,Plymouth ,2018,0,25024,12473,12551,49.84414962
IA,Plymouth ,2019,0,25177,12548,12629,49.8391389
IA,Pocahontas ,2015,0,6967,3451,3516,49.53351514
IA,Pocahontas ,2016,0,6854,3394,3460,49.51852933
IA,Pocahontas ,2017,0,6833,3398,3435,49.72925509
IA,Pocahontas ,2018,0,6714,3330,3384,49.59785523
IA,Pocahontas ,2019,0,6619,3290,3329,49.70539356
IA,Polk ,2015,0,467304,229878,237426,49.19238868
IA,Polk ,2016,0,474277,233635,240642,49.26129667
IA,Polk ,2017,0,480487,236764,243723,49.27583889
IA,Polk ,2018,0,485833,239537,246296,49.3043906
IA,Polk ,2019,0,490161,241736,248425,49.31767317
IA,Pottawattamie ,2015,0,93563,46043,47520,49.21069226
IA,Pottawattamie ,2016,0,93518,45978,47540,49.16486666
IA,Pottawattamie ,2017,0,93416,45896,47520,49.13076989
IA,Pottawattamie ,2018,0,93264,45867,47397,49.17974781
IA,Pottawattamie ,2019,0,93206,45945,47261,49.29403686
IA,Poweshiek ,2015,0,18358,8927,9431,48.62730145
IA,Poweshiek ,2016,0,18279,8882,9397,48.59127961
IA,Poweshiek ,2017,0,18334,8872,9462,48.3909676
IA,Poweshiek ,2018,0,18467,8961,9506,48.52439487
IA,Poweshiek ,2019,0,18504,8992,9512,48.5948984
IA,Ringgold ,2015,0,4977,2456,2521,49.34699618
IA,Ringgold ,2016,0,4985,2462,2523,49.38816449
IA,Ringgold ,2017,0,5024,2470,2554,49.16401274
IA,Ringgold ,2018,0,4940,2442,2498,49.43319838
IA,Ringgold ,2019,0,4894,2427,2467,49.59133633
IA,Sac ,2015,0,9966,4901,5065,49.17720249
IA,Sac ,2016,0,9816,4817,4999,49.07294214
IA,Sac ,2017,0,9803,4845,4958,49.42364582
IA,Sac ,2018,0,9705,4788,4917,49.33539413
IA,Sac ,2019,0,9721,4802,4919,49.39821006
IA,Scott ,2015,0,171903,84310,87593,49.04510102
IA,Scott ,2016,0,172135,84390,87745,49.02547419
IA,Scott ,2017,0,172448,84579,87869,49.04608926
IA,Scott ,2018,0,172803,84777,88026,49.05991215
IA,Scott ,2019,0,172943,84922,88021,49.10404006
IA,Shelby ,2015,0,11789,5794,5995,49.14751039
IA,Shelby ,2016,0,11655,5743,5912,49.27498927
IA,Shelby ,2017,0,11574,5712,5862,49.35199585
IA,Shelby ,2018,0,11559,5716,5843,49.45064452
IA,Shelby ,2019,0,11454,5678,5776,49.57220185
IA,Sioux ,2015,0,34754,17447,17307,50.20141566
IA,Sioux ,2016,0,34944,17549,17395,50.22035256
IA,Sioux ,2017,0,34781,17481,17300,50.26019953
IA,Sioux ,2018,0,34802,17488,17314,50.24998563
IA,Sioux ,2019,0,34855,17522,17333,50.27112322
IA,Story ,2015,0,96636,50502,46134,52.26002732
IA,Story ,2016,0,96893,50631,46262,52.25454883
IA,Story ,2017,0,97278,50946,46332,52.37155369
IA,Story ,2018,0,96781,50572,46209,52.25405813
IA,Story ,2019,0,97117,50732,46385,52.23802218
IA,Tama ,2015,0,17217,8497,8720,49.35238427
IA,Tama ,2016,0,17192,8540,8652,49.6742671
IA,Tama ,2017,0,17029,8481,8548,49.80327676
IA,Tama ,2018,0,16869,8441,8428,50.03853222
IA,Tama ,2019,0,16854,8449,8405,50.13053281
IA,Taylor ,2015,0,6246,3164,3082,50.65642011
IA,Taylor ,2016,0,6213,3135,3078,50.4587156
IA,Taylor ,2017,0,6095,3091,3004,50.71369975
IA,Taylor ,2018,0,6160,3125,3035,50.73051948
IA,Taylor ,2019,0,6121,3122,2999,51.00473779
IA,Union ,2015,0,12430,6078,6352,48.89782784
IA,Union ,2016,0,12360,6053,6307,48.97249191
IA,Union ,2017,0,12459,6090,6369,48.88032747
IA,Union ,2018,0,12298,5995,6303,48.74776386
IA,Union ,2019,0,12241,5970,6271,48.77052528
IA,Van Buren ,2015,0,7296,3706,3590,50.79495614
IA,Van Buren ,2016,0,7241,3678,3563,50.79408921
IA,Van Buren ,2017,0,7155,3664,3491,51.20894479
IA,Van Buren ,2018,0,7013,3611,3402,51.49008983
IA,Van Buren ,2019,0,7044,3628,3416,51.5048268
IA,Wapello ,2015,0,35456,17549,17907,49.49514892
IA,Wapello ,2016,0,35265,17481,17784,49.57039558
IA,Wapello ,2017,0,35022,17406,17616,49.70018845
IA,Wapello ,2018,0,34991,17429,17562,49.80995113
IA,Wapello ,2019,0,34969,17442,17527,49.87846378
IA,Warren ,2015,0,48468,23810,24658,49.12519601
IA,Warren ,2016,0,49356,24302,25054,49.23818786
IA,Warren ,2017,0,50078,24644,25434,49.21123048
IA,Warren ,2018,0,51014,25148,25866,49.29627161
IA,Warren ,2019,0,51466,25384,26082,49.32188241
IA,Washington ,2015,0,22145,10944,11201,49.41973357
IA,Washington ,2016,0,22126,10991,11135,49.67459098
IA,Washington ,2017,0,22204,10996,11208,49.52260854
IA,Washington ,2018,0,22058,10902,11156,49.42424517
IA,Washington ,2019,0,21965,10820,11145,49.26018666
IA,Wayne ,2015,0,6359,3102,3257,48.78125491
IA,Wayne ,2016,0,6447,3142,3305,48.73584613
IA,Wayne ,2017,0,6492,3173,3319,48.87553913
IA,Wayne ,2018,0,6405,3149,3256,49.16471507
IA,Wayne ,2019,0,6441,3201,3240,49.69725198
IA,Webster ,2015,0,37066,19088,17978,51.49732909
IA,Webster ,2016,0,36781,18937,17844,51.48582148
IA,Webster ,2017,0,36637,18918,17719,51.63632393
IA,Webster ,2018,0,36339,18800,17539,51.7350505
IA,Webster ,2019,0,35904,18566,17338,51.71011586
IA,Winnebago ,2015,0,10603,5213,5390,49.16533057
IA,Winnebago ,2016,0,10602,5227,5375,49.30201849
IA,Winnebago ,2017,0,10573,5196,5377,49.14404616
IA,Winnebago ,2018,0,10539,5206,5333,49.39747604
IA,Winnebago ,2019,0,10354,5109,5245,49.34324899
IA,Winneshiek ,2015,0,20745,10286,10459,49.58303206
IA,Winneshiek ,2016,0,20427,10154,10273,49.70871885
IA,Winneshiek ,2017,0,20129,9989,10140,49.62491927
IA,Winneshiek ,2018,0,20017,9961,10056,49.7627017
IA,Winneshiek ,2019,0,19991,9956,10035,49.80241108
IA,Woodbury ,2015,0,102492,50744,51748,49.51020567
IA,Woodbury ,2016,0,102686,50842,51844,49.51210486
IA,Woodbury ,2017,0,102132,50505,51627,49.45071084
IA,Woodbury ,2018,0,102515,50850,51665,49.6024972
IA,Woodbury ,2019,0,103107,51335,51772,49.78808422
IA,Worth ,2015,0,7503,3771,3732,50.25989604
IA,Worth ,2016,0,7471,3762,3709,50.35470486
IA,Worth ,2017,0,7455,3745,3710,50.23474178
IA,Worth ,2018,0,7413,3750,3663,50.58680696
IA,Worth ,2019,0,7381,3744,3637,50.72483403
IA,Wright ,2015,0,12841,6436,6405,50.12070711
IA,Wright ,2016,0,12839,6425,6414,50.04283823
IA,Wright ,2017,0,12765,6408,6357,50.19976498
IA,Wright ,2018,0,12690,6374,6316,50.2285264
IA,Wright ,2019,0,12562,6314,6248,50.26269702
KS,Allen ,2015,0,12683,6195,6488,48.84491051
KS,Allen ,2016,0,12670,6196,6474,48.90292028
KS,Allen ,2017,0,12555,6138,6417,48.88888889
KS,Allen ,2018,0,12501,6151,6350,49.20406367
KS,Allen ,2019,0,12369,6089,6280,49.22790848
KS,Anderson ,2015,0,7816,3883,3933,49.6801433
KS,Anderson ,2016,0,7812,3898,3914,49.89759345
KS,Anderson ,2017,0,7833,3913,3920,49.95531725
KS,Anderson ,2018,0,7848,3909,3939,49.8088685
KS,Anderson ,2019,0,7858,3905,3953,49.69457877
KS,Atchison ,2015,0,16418,8027,8391,48.89146059
KS,Atchison ,2016,0,16376,7982,8394,48.74206155
KS,Atchison ,2017,0,16298,7915,8383,48.56424101
KS,Atchison ,2018,0,16173,7844,8329,48.5005874
KS,Atchison ,2019,0,16073,7808,8265,48.57836123
KS,Barber ,2015,0,4824,2474,2350,51.28524046
KS,Barber ,2016,0,4673,2403,2270,51.42306869
KS,Barber ,2017,0,4570,2344,2226,51.29102845
KS,Barber ,2018,0,4465,2301,2164,51.53415454
KS,Barber ,2019,0,4427,2271,2156,51.29884798
KS,Barton ,2015,0,27159,13371,13788,49.23229869
KS,Barton ,2016,0,26878,13285,13593,49.4270407
KS,Barton ,2017,0,26394,13042,13352,49.41274532
KS,Barton ,2018,0,26057,12903,13154,49.51836359
KS,Barton ,2019,0,25779,12772,13007,49.54420265
KS,Bourbon ,2015,0,14733,7302,7431,49.56220729
KS,Bourbon ,2016,0,14624,7283,7341,49.80169584
KS,Bourbon ,2017,0,14609,7261,7348,49.70223835
KS,Bourbon ,2018,0,14542,7199,7343,49.50488241
KS,Bourbon ,2019,0,14534,7162,7372,49.27755608
KS,Brown ,2015,0,9708,4760,4948,49.03172641
KS,Brown ,2016,0,9641,4731,4910,49.07167306
KS,Brown ,2017,0,9609,4734,4875,49.26631283
KS,Brown ,2018,0,9610,4731,4879,49.22996878
KS,Brown ,2019,0,9564,4721,4843,49.36219155
KS,Butler ,2015,0,66249,33318,32931,50.29207988
KS,Butler ,2016,0,66652,33552,33100,50.3390746
KS,Butler ,2017,0,66845,33591,33254,50.2520757
KS,Butler ,2018,0,66833,33621,33212,50.30598656
KS,Butler ,2019,0,66911,33634,33277,50.26677228
KS,Chase ,2015,0,2656,1362,1294,51.28012048
KS,Chase ,2016,0,2632,1339,1293,50.87386018
KS,Chase ,2017,0,2651,1354,1297,51.07506601
KS,Chase ,2018,0,2600,1319,1281,50.73076923
KS,Chase ,2019,0,2648,1361,1287,51.39728097
KS,Chautauqua ,2015,0,3387,1736,1651,51.25479776
KS,Chautauqua ,2016,0,3360,1714,1646,51.01190476
KS,Chautauqua ,2017,0,3315,1707,1608,51.49321267
KS,Chautauqua ,2018,0,3304,1689,1615,51.11985472
KS,Chautauqua ,2019,0,3250,1655,1595,50.92307692
KS,Cherokee ,2015,0,20535,10182,10353,49.58363769
KS,Cherokee ,2016,0,20256,10090,10166,49.81240126
KS,Cherokee ,2017,0,20129,9969,10160,49.52556014
KS,Cherokee ,2018,0,20035,9879,10156,49.30870976
KS,Cherokee ,2019,0,19939,9840,10099,49.35051908
KS,Cheyenne ,2015,0,2674,1335,1339,49.92520568
KS,Cheyenne ,2016,0,2667,1334,1333,50.01874766
KS,Cheyenne ,2017,0,2684,1356,1328,50.52160954
KS,Cheyenne ,2018,0,2645,1338,1307,50.58601134
KS,Cheyenne ,2019,0,2657,1338,1319,50.3575461
KS,Clark ,2015,0,2081,1029,1052,49.44738107
KS,Clark ,2016,0,2065,1030,1035,49.87893462
KS,Clark ,2017,0,1995,985,1010,49.37343358
KS,Clark ,2018,0,1994,990,1004,49.64894684
KS,Clark ,2019,0,1994,984,1010,49.34804413
KS,Clay ,2015,0,8293,4115,4178,49.62016158
KS,Clay ,2016,0,8105,4011,4094,49.48797039
KS,Clay ,2017,0,8006,3992,4014,49.86260305
KS,Clay ,2018,0,8003,4006,3997,50.05622891
KS,Clay ,2019,0,8002,3970,4032,49.61259685
KS,Cloud ,2015,0,9188,4563,4625,49.6626034
KS,Cloud ,2016,0,9070,4504,4566,49.65821389
KS,Cloud ,2017,0,8912,4439,4473,49.80924596
KS,Cloud ,2018,0,8734,4344,4390,49.73666132
KS,Cloud ,2019,0,8786,4359,4427,49.61302071
KS,Coffey ,2015,0,8291,4078,4213,49.18586419
KS,Coffey ,2016,0,8339,4111,4228,49.29847704
KS,Coffey ,2017,0,8228,4064,4164,49.39231891
KS,Coffey ,2018,0,8232,4072,4160,49.46550049
KS,Coffey ,2019,0,8179,4042,4137,49.41924441
KS,Comanche ,2015,0,1827,888,939,48.60426929
KS,Comanche ,2016,0,1838,880,958,47.8781284
KS,Comanche ,2017,0,1759,847,912,48.1523593
KS,Comanche ,2018,0,1736,838,898,48.2718894
KS,Comanche ,2019,0,1700,828,872,48.70588235
KS,Cowley ,2015,0,35752,17865,17887,49.96923249
KS,Cowley ,2016,0,35650,17874,17776,50.13744741
KS,Cowley ,2017,0,35297,17690,17607,50.11757373
KS,Cowley ,2018,0,35149,17675,17474,50.28592563
KS,Cowley ,2019,0,34908,17553,17355,50.28360261
KS,Crawford ,2015,0,39139,19599,19540,50.07537239
KS,Crawford ,2016,0,39046,19534,19512,50.0281719
KS,Crawford ,2017,0,38925,19450,19475,49.96788696
KS,Crawford ,2018,0,38911,19486,19425,50.078384
KS,Crawford ,2019,0,38818,19373,19445,49.90725952
KS,Decatur ,2015,0,2923,1469,1454,50.2565857
KS,Decatur ,2016,0,2828,1421,1407,50.24752475
KS,Decatur ,2017,0,2863,1447,1416,50.54139015
KS,Decatur ,2018,0,2860,1443,1417,50.45454545
KS,Decatur ,2019,0,2827,1418,1409,50.15917934
KS,Dickinson ,2015,0,19206,9600,9606,49.98437988
KS,Dickinson ,2016,0,18956,9509,9447,50.16353661
KS,Dickinson ,2017,0,18829,9448,9381,50.17791704
KS,Dickinson ,2018,0,18682,9406,9276,50.34792849
KS,Dickinson ,2019,0,18466,9252,9214,50.1028918
KS,Doniphan ,2015,0,7788,3915,3873,50.26964561
KS,Doniphan ,2016,0,7718,3854,3864,49.93521638
KS,Doniphan ,2017,0,7657,3862,3795,50.43750816
KS,Doniphan ,2018,0,7658,3843,3815,50.18281536
KS,Doniphan ,2019,0,7600,3835,3765,50.46052632
KS,Douglas ,2015,0,118141,58904,59237,49.85906671
KS,Douglas ,2016,0,119662,59654,60008,49.85208337
KS,Douglas ,2017,0,120281,59925,60356,49.82083621
KS,Douglas ,2018,0,121109,60319,60790,49.80554707
KS,Douglas ,2019,0,122259,60854,61405,49.77465872
KS,Edwards ,2015,0,2955,1512,1443,51.16751269
KS,Edwards ,2016,0,2899,1483,1416,51.15557089
KS,Edwards ,2017,0,2873,1456,1417,50.67873303
KS,Edwards ,2018,0,2820,1439,1381,51.02836879
KS,Edwards ,2019,0,2798,1436,1362,51.32237312
KS,Elk ,2015,0,2574,1269,1305,49.3006993
KS,Elk ,2016,0,2511,1247,1264,49.66148945
KS,Elk ,2017,0,2514,1240,1274,49.32378679
KS,Elk ,2018,0,2484,1253,1231,50.44283414
KS,Elk ,2019,0,2530,1271,1259,50.23715415
KS,Ellis ,2015,0,28999,14654,14345,50.53277699
KS,Ellis ,2016,0,28942,14549,14393,50.26950453
KS,Ellis ,2017,0,28735,14425,14310,50.2001044
KS,Ellis ,2018,0,28646,14396,14250,50.25483488
KS,Ellis ,2019,0,28553,14378,14175,50.35547928
KS,Ellsworth ,2015,0,6302,3569,2733,56.63281498
KS,Ellsworth ,2016,0,6302,3566,2736,56.58521104
KS,Ellsworth ,2017,0,6284,3537,2747,56.28580522
KS,Ellsworth ,2018,0,6163,3479,2684,56.44978095
KS,Ellsworth ,2019,0,6102,3460,2642,56.70272042
KS,Finney ,2015,0,37148,18899,18249,50.87487886
KS,Finney ,2016,0,36885,18832,18053,51.05598482
KS,Finney ,2017,0,36720,18878,17842,51.41067538
KS,Finney ,2018,0,36528,18812,17716,51.50021901
KS,Finney ,2019,0,36467,18810,17657,51.58088134
KS,Ford ,2015,0,34629,17888,16741,51.65612637
KS,Ford ,2016,0,34552,17868,16684,51.71335957
KS,Ford ,2017,0,34218,17752,16466,51.87912794
KS,Ford ,2018,0,33877,17586,16291,51.91132627
KS,Ford ,2019,0,33619,17458,16161,51.92896874
KS,Franklin ,2015,0,25469,12639,12830,49.62503436
KS,Franklin ,2016,0,25523,12728,12795,49.86874584
KS,Franklin ,2017,0,25631,12755,12876,49.76395771
KS,Franklin ,2018,0,25625,12771,12854,49.83804878
KS,Franklin ,2019,0,25544,12742,12802,49.88255559
KS,Geary ,2015,0,36681,19672,17009,53.62994466
KS,Geary ,2016,0,35223,18751,16472,53.23510206
KS,Geary ,2017,0,33774,17836,15938,52.80985373
KS,Geary ,2018,0,32777,17293,15484,52.75955701
KS,Geary ,2019,0,31670,16580,15090,52.35238396
KS,Gove ,2015,0,2698,1369,1329,50.74128984
KS,Gove ,2016,0,2622,1339,1283,51.06788711
KS,Gove ,2017,0,2622,1334,1288,50.87719298
KS,Gove ,2018,0,2611,1312,1299,50.24894676
KS,Gove ,2019,0,2636,1318,1318,50
KS,Graham ,2015,0,2591,1274,1317,49.17020455
KS,Graham ,2016,0,2562,1258,1304,49.10226386
KS,Graham ,2017,0,2485,1207,1278,48.57142857
KS,Graham ,2018,0,2475,1216,1259,49.13131313
KS,Graham ,2019,0,2482,1217,1265,49.03303787
KS,Grant ,2015,0,7724,3906,3818,50.56965303
KS,Grant ,2016,0,7675,3880,3795,50.55374593
KS,Grant ,2017,0,7490,3777,3713,50.42723632
KS,Grant ,2018,0,7294,3655,3639,50.10967919
KS,Grant ,2019,0,7150,3595,3555,50.27972028
KS,Gray ,2015,0,6082,3071,3011,50.4932588
KS,Gray ,2016,0,6031,3039,2992,50.38965346
KS,Gray ,2017,0,6018,3028,2990,50.31571951
KS,Gray ,2018,0,6076,3061,3015,50.37853851
KS,Gray ,2019,0,5988,3030,2958,50.6012024
KS,Greeley ,2015,0,1302,627,675,48.15668203
KS,Greeley ,2016,0,1277,608,669,47.61158966
KS,Greeley ,2017,0,1226,577,649,47.06362153
KS,Greeley ,2018,0,1229,585,644,47.59967453
KS,Greeley ,2019,0,1232,602,630,48.86363636
KS,Greenwood ,2015,0,6233,3119,3114,50.0401091
KS,Greenwood ,2016,0,6112,3069,3043,50.21269634
KS,Greenwood ,2017,0,6067,3032,3035,49.97527608
KS,Greenwood ,2018,0,6011,2997,3014,49.85859258
KS,Greenwood ,2019,0,5982,2981,3001,49.83283183
KS,Hamilton ,2015,0,2568,1319,1249,51.36292835
KS,Hamilton ,2016,0,2634,1353,1281,51.3667426
KS,Hamilton ,2017,0,2616,1345,1271,51.41437309
KS,Hamilton ,2018,0,2600,1347,1253,51.80769231
KS,Hamilton ,2019,0,2539,1325,1214,52.18589996
KS,Harper ,2015,0,5781,2896,2885,50.09513925
KS,Harper ,2016,0,5667,2827,2840,49.88530086
KS,Harper ,2017,0,5580,2798,2782,50.14336918
KS,Harper ,2018,0,5508,2757,2751,50.05446623
KS,Harper ,2019,0,5436,2718,2718,50
KS,Harvey ,2015,0,34802,17118,17684,49.18682834
KS,Harvey ,2016,0,34726,17117,17609,49.29159707
KS,Harvey ,2017,0,34373,16937,17436,49.27413959
KS,Harvey ,2018,0,34183,16879,17304,49.37834596
KS,Harvey ,2019,0,34429,16961,17468,49.26370211
KS,Haskell ,2015,0,4089,2018,2071,49.35191978
KS,Haskell ,2016,0,4026,2003,2023,49.75161451
KS,Haskell ,2017,0,4019,2032,1987,50.55984076
KS,Haskell ,2018,0,3990,2000,1990,50.12531328
KS,Haskell ,2019,0,3968,1997,1971,50.32762097
KS,Hodgeman ,2015,0,1869,918,951,49.11717496
KS,Hodgeman ,2016,0,1851,918,933,49.59481361
KS,Hodgeman ,2017,0,1863,933,930,50.0805153
KS,Hodgeman ,2018,0,1822,917,905,50.32930845
KS,Hodgeman ,2019,0,1794,918,876,51.17056856
KS,Jackson ,2015,0,13285,6659,6626,50.12420023
KS,Jackson ,2016,0,13270,6604,6666,49.76639035
KS,Jackson ,2017,0,13332,6651,6681,49.88748875
KS,Jackson ,2018,0,13270,6636,6634,50.0075358
KS,Jackson ,2019,0,13171,6610,6561,50.18601473
KS,Jefferson ,2015,0,18794,9552,9242,50.8247313
KS,Jefferson ,2016,0,18824,9559,9265,50.78091798
KS,Jefferson ,2017,0,18932,9621,9311,50.81871963
KS,Jefferson ,2018,0,18856,9591,9265,50.86444633
KS,Jefferson ,2019,0,19043,9678,9365,50.82182429
KS,Jewell ,2015,0,2963,1512,1451,51.02936213
KS,Jewell ,2016,0,2880,1471,1409,51.07638889
KS,Jewell ,2017,0,2857,1466,1391,51.31256563
KS,Jewell ,2018,0,2845,1450,1395,50.96660808
KS,Jewell ,2019,0,2879,1475,1404,51.23306704
KS,Johnson ,2015,0,579684,284016,295668,48.99496967
KS,Johnson ,2016,0,586015,287232,298783,49.01444502
KS,Johnson ,2017,0,591305,290075,301230,49.05674736
KS,Johnson ,2018,0,598127,293527,304600,49.07436046
KS,Johnson ,2019,0,602401,295652,306749,49.07893579
KS,Kearny ,2015,0,3929,1975,1954,50.26724357
KS,Kearny ,2016,0,3890,1939,1951,49.84575835
KS,Kearny ,2017,0,3935,1972,1963,50.11435832
KS,Kearny ,2018,0,3941,1958,1983,49.68282162
KS,Kearny ,2019,0,3838,1904,1934,49.60917144
KS,Kingman ,2015,0,7636,3809,3827,49.88213724
KS,Kingman ,2016,0,7417,3699,3718,49.87191587
KS,Kingman ,2017,0,7275,3643,3632,50.07560137
KS,Kingman ,2018,0,7220,3609,3611,49.98614958
KS,Kingman ,2019,0,7152,3566,3586,49.86017897
KS,Kiowa ,2015,0,2570,1263,1307,49.14396887
KS,Kiowa ,2016,0,2507,1237,1270,49.34184284
KS,Kiowa ,2017,0,2486,1211,1275,48.71279163
KS,Kiowa ,2018,0,2489,1224,1265,49.17637605
KS,Kiowa ,2019,0,2475,1222,1253,49.37373737
KS,Labette ,2015,0,20628,10230,10398,49.5927865
KS,Labette ,2016,0,20313,10055,10258,49.50031999
KS,Labette ,2017,0,20129,9984,10145,49.60007949
KS,Labette ,2018,0,19906,9915,9991,49.80910278
KS,Labette ,2019,0,19618,9801,9817,49.95922112
KS,Lane ,2015,0,1630,809,821,49.63190184
KS,Lane ,2016,0,1593,799,794,50.1569366
KS,Lane ,2017,0,1548,779,769,50.32299742
KS,Lane ,2018,0,1546,784,762,50.71151358
KS,Lane ,2019,0,1535,773,762,50.35830619
KS,Leavenworth ,2015,0,79119,42275,36844,53.43217179
KS,Leavenworth ,2016,0,80244,42826,37418,53.36972235
KS,Leavenworth ,2017,0,81109,43321,37788,53.4108422
KS,Leavenworth ,2018,0,81497,43426,38071,53.28539701
KS,Leavenworth ,2019,0,81758,43582,38176,53.30609849
KS,Lincoln ,2015,0,3142,1562,1580,49.71355824
KS,Lincoln ,2016,0,3077,1535,1542,49.88625284
KS,Lincoln ,2017,0,3043,1532,1511,50.34505422
KS,Lincoln ,2018,0,2998,1491,1507,49.73315544
KS,Lincoln ,2019,0,2962,1484,1478,50.10128292
KS,Linn ,2015,0,9580,4828,4752,50.39665971
KS,Linn ,2016,0,9606,4814,4792,50.11451176
KS,Linn ,2017,0,9697,4893,4804,50.45890482
KS,Linn ,2018,0,9771,4941,4830,50.56800737
KS,Linn ,2019,0,9703,4924,4779,50.74719159
KS,Logan ,2015,0,2787,1423,1364,51.05848583
KS,Logan ,2016,0,2818,1415,1403,50.21291696
KS,Logan ,2017,0,2814,1410,1404,50.10660981
KS,Logan ,2018,0,2812,1405,1407,49.96443812
KS,Logan ,2019,0,2794,1394,1400,49.89262706
KS,Lyon ,2015,0,33133,16156,16977,48.76105393
KS,Lyon ,2016,0,33369,16275,17094,48.77281309
KS,Lyon ,2017,0,33257,16202,17055,48.71756322
KS,Lyon ,2018,0,33300,16176,17124,48.57657658
KS,Lyon ,2019,0,33195,16120,17075,48.56153035
KS,McPherson ,2015,0,28648,14114,14534,49.26696454
KS,McPherson ,2016,0,28429,13988,14441,49.20327834
KS,McPherson ,2017,0,28687,14120,14567,49.22090145
KS,McPherson ,2018,0,28528,14002,14526,49.08160404
KS,McPherson ,2019,0,28542,14031,14511,49.15913391
KS,Marion ,2015,0,12053,6026,6027,49.99585166
KS,Marion ,2016,0,12017,5981,6036,49.77115753
KS,Marion ,2017,0,11945,5904,6041,49.4265383
KS,Marion ,2018,0,11923,5931,5992,49.7441919
KS,Marion ,2019,0,11884,5903,5981,49.67182767
KS,Marshall ,2015,0,9845,4927,4918,50.04570848
KS,Marshall ,2016,0,9789,4866,4923,49.70885688
KS,Marshall ,2017,0,9687,4848,4839,50.04645401
KS,Marshall ,2018,0,9715,4850,4865,49.92279979
KS,Marshall ,2019,0,9707,4828,4879,49.73730298
KS,Meade ,2015,0,4301,2167,2134,50.38363171
KS,Meade ,2016,0,4236,2133,2103,50.35410765
KS,Meade ,2017,0,4230,2127,2103,50.28368794
KS,Meade ,2018,0,4098,2085,2013,50.87847731
KS,Meade ,2019,0,4033,2054,1979,50.92982891
KS,Miami ,2015,0,32758,16262,16496,49.64283534
KS,Miami ,2016,0,32923,16315,16608,49.55502232
KS,Miami ,2017,0,33429,16621,16808,49.72030273
KS,Miami ,2018,0,33737,16777,16960,49.72878442
KS,Miami ,2019,0,34237,17064,17173,49.84081549
KS,Mitchell ,2015,0,6294,3224,3070,51.22338735
KS,Mitchell ,2016,0,6207,3160,3047,50.91026261
KS,Mitchell ,2017,0,6137,3101,3036,50.52957471
KS,Mitchell ,2018,0,6110,3081,3029,50.42553191
KS,Mitchell ,2019,0,5979,3015,2964,50.42649272
KS,Montgomery ,2015,0,33436,16527,16909,49.42875942
KS,Montgomery ,2016,0,32859,16296,16563,49.59371862
KS,Montgomery ,2017,0,32390,16076,16314,49.63260266
KS,Montgomery ,2018,0,32091,15931,16160,49.64320214
KS,Montgomery ,2019,0,31829,15813,16016,49.68110842
KS,Morris ,2015,0,5628,2791,2837,49.59132907
KS,Morris ,2016,0,5558,2783,2775,50.07196833
KS,Morris ,2017,0,5467,2735,2732,50.02743735
KS,Morris ,2018,0,5557,2781,2776,50.0449883
KS,Morris ,2019,0,5620,2816,2804,50.10676157
KS,Morton ,2015,0,2953,1469,1484,49.746021
KS,Morton ,2016,0,2790,1382,1408,49.53405018
KS,Morton ,2017,0,2747,1360,1387,49.50855479
KS,Morton ,2018,0,2693,1333,1360,49.49870033
KS,Morton ,2019,0,2587,1297,1290,50.13529184
KS,Nemaha ,2015,0,10094,5121,4973,50.73310878
KS,Nemaha ,2016,0,10089,5126,4963,50.80781049
KS,Nemaha ,2017,0,10060,5099,4961,50.68588469
KS,Nemaha ,2018,0,10125,5124,5001,50.60740741
KS,Nemaha ,2019,0,10231,5174,5057,50.57179161
KS,Neosho ,2015,0,16287,8072,8215,49.56099957
KS,Neosho ,2016,0,16127,8024,8103,49.75506914
KS,Neosho ,2017,0,16094,8023,8071,49.8508761
KS,Neosho ,2018,0,16025,7965,8060,49.70358814
KS,Neosho ,2019,0,16007,7957,8050,49.70950209
KS,Ness ,2015,0,3020,1487,1533,49.2384106
KS,Ness ,2016,0,2957,1450,1507,49.03618532
KS,Ness ,2017,0,2856,1409,1447,49.33473389
KS,Ness ,2018,0,2796,1376,1420,49.21316166
KS,Ness ,2019,0,2750,1340,1410,48.72727273
KS,Norton ,2015,0,5536,3137,2399,56.66546243
KS,Norton ,2016,0,5491,3087,2404,56.21926789
KS,Norton ,2017,0,5421,3031,2390,55.91219332
KS,Norton ,2018,0,5419,3030,2389,55.91437535
KS,Norton ,2019,0,5361,2988,2373,55.73587017
KS,Osage ,2015,0,15865,7944,7921,50.07248661
KS,Osage ,2016,0,15811,7937,7874,50.19922839
KS,Osage ,2017,0,15842,7953,7889,50.2019947
KS,Osage ,2018,0,15938,7999,7939,50.18822939
KS,Osage ,2019,0,15949,7991,7958,50.10345476
KS,Osborne ,2015,0,3641,1823,1818,50.06866246
KS,Osborne ,2016,0,3588,1801,1787,50.19509476
KS,Osborne ,2017,0,3539,1794,1745,50.69228596
KS,Osborne ,2018,0,3459,1761,1698,50.91066782
KS,Osborne ,2019,0,3421,1738,1683,50.80385852
KS,Ottawa ,2015,0,5934,3061,2873,51.58409168
KS,Ottawa ,2016,0,5905,3034,2871,51.38018628
KS,Ottawa ,2017,0,5817,3004,2813,51.64173973
KS,Ottawa ,2018,0,5752,2981,2771,51.82545202
KS,Ottawa ,2019,0,5704,2962,2742,51.92847125
KS,Pawnee ,2015,0,6769,3750,3019,55.3996159
KS,Pawnee ,2016,0,6719,3736,2983,55.60351243
KS,Pawnee ,2017,0,6665,3712,2953,55.69392348
KS,Pawnee ,2018,0,6573,3681,2892,56.00182565
KS,Pawnee ,2019,0,6414,3603,2811,56.17399439
KS,Phillips ,2015,0,5420,2692,2728,49.66789668
KS,Phillips ,2016,0,5402,2710,2692,50.16660496
KS,Phillips ,2017,0,5370,2696,2674,50.20484171
KS,Phillips ,2018,0,5276,2621,2655,49.6777862
KS,Phillips ,2019,0,5234,2603,2631,49.73251815
KS,Pottawatomie ,2015,0,23123,11521,11602,49.82484972
KS,Pottawatomie ,2016,0,23605,11727,11878,49.68015251
KS,Pottawatomie ,2017,0,23916,11872,12044,49.64040809
KS,Pottawatomie ,2018,0,24209,12037,12172,49.72117807
KS,Pottawatomie ,2019,0,24383,12119,12264,49.70266169
KS,Pratt ,2015,0,9697,4805,4892,49.55140765
KS,Pratt ,2016,0,9557,4713,4844,49.31463848
KS,Pratt ,2017,0,9500,4698,4802,49.45263158
KS,Pratt ,2018,0,9340,4626,4714,49.52890792
KS,Pratt ,2019,0,9164,4552,4612,49.67263204
KS,Rawlins ,2015,0,2506,1280,1226,51.07741421
KS,Rawlins ,2016,0,2500,1268,1232,50.72
KS,Rawlins ,2017,0,2473,1247,1226,50.42458552
KS,Rawlins ,2018,0,2502,1259,1243,50.3197442
KS,Rawlins ,2019,0,2530,1280,1250,50.59288538
KS,Reno ,2015,0,63596,31969,31627,50.26888484
KS,Reno ,2016,0,63184,31782,31402,50.30070904
KS,Reno ,2017,0,62714,31482,31232,50.19931754
KS,Reno ,2018,0,62331,31276,31055,50.17727936
KS,Reno ,2019,0,61998,31154,30844,50.25000806
KS,Republic ,2015,0,4688,2293,2395,48.91211604
KS,Republic ,2016,0,4659,2285,2374,49.04485941
KS,Republic ,2017,0,4654,2287,2367,49.14052428
KS,Republic ,2018,0,4652,2299,2353,49.41960447
KS,Republic ,2019,0,4636,2308,2328,49.78429681
KS,Rice ,2015,0,9925,5023,4902,50.60957179
KS,Rice ,2016,0,9782,4935,4847,50.44980577
KS,Rice ,2017,0,9563,4816,4747,50.36076545
KS,Rice ,2018,0,9483,4758,4725,50.17399557
KS,Rice ,2019,0,9537,4783,4754,50.15203943
KS,Riley ,2015,0,77185,41445,35740,53.69566626
KS,Riley ,2016,0,75172,40160,35012,53.42414729
KS,Riley ,2017,0,73977,39131,34846,52.89617043
KS,Riley ,2018,0,74712,39662,35050,53.0865189
KS,Riley ,2019,0,74232,39316,34916,52.96368143
KS,Rooks ,2015,0,5179,2494,2685,48.15601467
KS,Rooks ,2016,0,5118,2472,2646,48.30011723
KS,Rooks ,2017,0,5055,2437,2618,48.20969337
KS,Rooks ,2018,0,4995,2408,2587,48.20820821
KS,Rooks ,2019,0,4920,2397,2523,48.7195122
KS,Rush ,2015,0,3098,1544,1554,49.83860555
KS,Rush ,2016,0,3054,1539,1515,50.39292731
KS,Rush ,2017,0,3048,1522,1526,49.9343832
KS,Rush ,2018,0,3056,1560,1496,51.04712042
KS,Rush ,2019,0,3036,1552,1484,51.1198946
KS,Russell ,2015,0,7044,3496,3548,49.63089154
KS,Russell ,2016,0,7007,3462,3545,49.40773512
KS,Russell ,2017,0,6930,3430,3500,49.49494949
KS,Russell ,2018,0,6902,3406,3496,49.34801507
KS,Russell ,2019,0,6856,3375,3481,49.22695449
KS,Saline ,2015,0,55429,27427,28002,49.48131844
KS,Saline ,2016,0,54955,27205,27750,49.50413975
KS,Saline ,2017,0,54508,27013,27495,49.55786307
KS,Saline ,2018,0,54387,26932,27455,49.51918657
KS,Saline ,2019,0,54224,26909,27315,49.62562703
KS,Scott ,2015,0,4948,2511,2437,50.74777688
KS,Scott ,2016,0,4979,2514,2465,50.49206668
KS,Scott ,2017,0,4928,2491,2437,50.54788961
KS,Scott ,2018,0,4909,2483,2426,50.58056631
KS,Scott ,2019,0,4823,2431,2392,50.40431267
KS,Sedgwick ,2015,0,511083,252513,258570,49.4074348
KS,Sedgwick ,2016,0,513092,253512,259580,49.40868304
KS,Sedgwick ,2017,0,513176,253660,259516,49.42943552
KS,Sedgwick ,2018,0,513484,253766,259718,49.42042985
KS,Sedgwick ,2019,0,516042,254968,261074,49.40838149
KS,Seward ,2015,0,23273,12013,11260,51.61775448
KS,Seward ,2016,0,22897,11808,11089,51.57007468
KS,Seward ,2017,0,22245,11437,10808,51.41380085
KS,Seward ,2018,0,21902,11205,10697,51.15971144
KS,Seward ,2019,0,21428,10964,10464,51.16669778
KS,Shawnee ,2015,0,178689,86603,92086,48.46577014
KS,Shawnee ,2016,0,178350,86451,91899,48.47266611
KS,Shawnee ,2017,0,178056,86282,91774,48.45778856
KS,Shawnee ,2018,0,177290,85858,91432,48.42799932
KS,Shawnee ,2019,0,176875,85589,91286,48.38954064
KS,Sheridan ,2015,0,2475,1247,1228,50.38383838
KS,Sheridan ,2016,0,2485,1248,1237,50.22132797
KS,Sheridan ,2017,0,2526,1276,1250,50.51464766
KS,Sheridan ,2018,0,2522,1265,1257,50.15860428
KS,Sheridan ,2019,0,2521,1274,1247,50.53550179
KS,Sherman ,2015,0,5964,2983,2981,50.01676727
KS,Sherman ,2016,0,5955,2975,2980,49.95801847
KS,Sherman ,2017,0,5936,2977,2959,50.15161725
KS,Sherman ,2018,0,5917,2971,2946,50.2112557
KS,Sherman ,2019,0,5917,2957,2960,49.97464932
KS,Smith ,2015,0,3689,1833,1856,49.6882624
KS,Smith ,2016,0,3656,1810,1846,49.50765864
KS,Smith ,2017,0,3615,1787,1828,49.4329184
KS,Smith ,2018,0,3590,1790,1800,49.86072423
KS,Smith ,2019,0,3583,1804,1779,50.34886966
KS,Stafford ,2015,0,4215,2150,2065,51.00830368
KS,Stafford ,2016,0,4186,2150,2036,51.3616818
KS,Stafford ,2017,0,4186,2139,2047,51.0989011
KS,Stafford ,2018,0,4162,2114,2048,50.79288803
KS,Stafford ,2019,0,4156,2106,2050,50.67372474
KS,Stanton ,2015,0,2070,1038,1032,50.14492754
KS,Stanton ,2016,0,2105,1053,1052,50.02375297
KS,Stanton ,2017,0,2055,1033,1022,50.2676399
KS,Stanton ,2018,0,2025,1005,1020,49.62962963
KS,Stanton ,2019,0,2006,1001,1005,49.9002991
KS,Stevens ,2015,0,5789,2862,2927,49.43859043
KS,Stevens ,2016,0,5653,2802,2851,49.5666018
KS,Stevens ,2017,0,5551,2741,2810,49.37849036
KS,Stevens ,2018,0,5536,2730,2806,49.31358382
KS,Stevens ,2019,0,5485,2700,2785,49.22515953
KS,Sumner ,2015,0,23417,11674,11743,49.85267114
KS,Sumner ,2016,0,23183,11563,11620,49.87706509
KS,Sumner ,2017,0,23117,11565,11552,50.02811784
KS,Sumner ,2018,0,23019,11533,11486,50.10208958
KS,Sumner ,2019,0,22836,11450,11386,50.14012962
KS,Thomas ,2015,0,7895,3870,4025,49.01836605
KS,Thomas ,2016,0,7847,3833,4014,48.846693
KS,Thomas ,2017,0,7821,3814,4007,48.76614244
KS,Thomas ,2018,0,7710,3772,3938,48.92347601
KS,Thomas ,2019,0,7777,3795,3982,48.79773692
KS,Trego ,2015,0,2907,1458,1449,50.15479876
KS,Trego ,2016,0,2852,1437,1415,50.38569425
KS,Trego ,2017,0,2843,1437,1406,50.54519873
KS,Trego ,2018,0,2797,1406,1391,50.26814444
KS,Trego ,2019,0,2803,1426,1377,50.8740635
KS,Wabaunsee ,2015,0,6887,3492,3395,50.70422535
KS,Wabaunsee ,2016,0,6884,3497,3387,50.7989541
KS,Wabaunsee ,2017,0,6832,3465,3367,50.71721311
KS,Wabaunsee ,2018,0,6912,3532,3380,51.09953704
KS,Wabaunsee ,2019,0,6931,3550,3381,51.21916029
KS,Wallace ,2015,0,1505,737,768,48.97009967
KS,Wallace ,2016,0,1502,737,765,49.06790945
KS,Wallace ,2017,0,1515,752,763,49.6369637
KS,Wallace ,2018,0,1489,740,749,49.69778375
KS,Wallace ,2019,0,1518,760,758,50.06587615
KS,Washington ,2015,0,5568,2840,2728,51.00574713
KS,Washington ,2016,0,5564,2852,2712,51.25808771
KS,Washington ,2017,0,5479,2815,2664,51.37798868
KS,Washington ,2018,0,5450,2783,2667,51.06422018
KS,Washington ,2019,0,5406,2749,2657,50.8509064
KS,Wichita ,2015,0,2167,1117,1050,51.54591601
KS,Wichita ,2016,0,2131,1108,1023,51.99436884
KS,Wichita ,2017,0,2121,1095,1026,51.62659123
KS,Wichita ,2018,0,2112,1078,1034,51.04166667
KS,Wichita ,2019,0,2119,1097,1022,51.76970269
KS,Wilson ,2015,0,8845,4362,4483,49.31599774
KS,Wilson ,2016,0,8698,4269,4429,49.08024833
KS,Wilson ,2017,0,8707,4272,4435,49.06397152
KS,Wilson ,2018,0,8666,4276,4390,49.3422571
KS,Wilson ,2019,0,8525,4222,4303,49.52492669
KS,Woodson ,2015,0,3144,1582,1562,50.31806616
KS,Woodson ,2016,0,3189,1618,1571,50.73690812
KS,Woodson ,2017,0,3130,1598,1532,51.0543131
KS,Woodson ,2018,0,3184,1601,1583,50.28266332
KS,Woodson ,2019,0,3138,1576,1562,50.22307202
KS,Wyandotte ,2015,0,163682,80819,82863,49.37561858
KS,Wyandotte ,2016,0,164785,81569,83216,49.50025791
KS,Wyandotte ,2017,0,165087,81911,83176,49.61686868
KS,Wyandotte ,2018,0,165321,82137,83184,49.68334331
KS,Wyandotte ,2019,0,165429,82350,83079,49.77966378
KY,Adair ,2015,0,19162,9499,9663,49.57206972
KY,Adair ,2016,0,19259,9529,9730,49.47816605
KY,Adair ,2017,0,19287,9573,9714,49.63446881
KY,Adair ,2018,0,19199,9503,9696,49.49736965
KY,Adair ,2019,0,19202,9570,9632,49.83855848
KY,Allen ,2015,0,20660,10204,10456,49.39012585
KY,Allen ,2016,0,20721,10234,10487,49.38950823
KY,Allen ,2017,0,20903,10349,10554,49.50963976
KY,Allen ,2018,0,21122,10452,10670,49.48395038
KY,Allen ,2019,0,21315,10575,10740,49.61294863
KY,Anderson ,2015,0,21920,10683,11237,48.73631387
KY,Anderson ,2016,0,22191,10813,11378,48.72696138
KY,Anderson ,2017,0,22545,11060,11485,49.05744067
KY,Anderson ,2018,0,22641,11110,11531,49.07027075
KY,Anderson ,2019,0,22747,11138,11609,48.96469864
KY,Ballard ,2015,0,8216,4065,4151,49.47663096
KY,Ballard ,2016,0,8046,3991,4055,49.60228685
KY,Ballard ,2017,0,8018,3999,4019,49.87528062
KY,Ballard ,2018,0,7992,3983,4009,49.83733734
KY,Ballard ,2019,0,7888,3922,3966,49.72109533
KY,Barren ,2015,0,43546,21115,22431,48.48895421
KY,Barren ,2016,0,43763,21191,22572,48.42218312
KY,Barren ,2017,0,43746,21182,22564,48.42042701
KY,Barren ,2018,0,44115,21357,22758,48.41210473
KY,Barren ,2019,0,44249,21418,22831,48.40335375
KY,Bath ,2015,0,12203,6068,6135,49.72547734
KY,Bath ,2016,0,12246,6079,6167,49.640699
KY,Bath ,2017,0,12381,6152,6229,49.68903966
KY,Bath ,2018,0,12444,6141,6303,49.3490839
KY,Bath ,2019,0,12500,6177,6323,49.416
KY,Bell ,2015,0,27370,13404,13966,48.97332846
KY,Bell ,2016,0,27204,13310,13894,48.92662844
KY,Bell ,2017,0,26863,13148,13715,48.94464505
KY,Bell ,2018,0,26487,12989,13498,49.03915128
KY,Bell ,2019,0,26032,12745,13287,48.95897357
KY,Boone ,2015,0,128161,63254,64907,49.35510803
KY,Boone ,2016,0,129503,64080,65423,49.48147919
KY,Boone ,2017,0,130952,64769,66183,49.46010752
KY,Boone ,2018,0,131901,65338,66563,49.53563658
KY,Boone ,2019,0,133581,66161,67420,49.52875035
KY,Bourbon ,2015,0,20166,9835,10331,48.77020728
KY,Bourbon ,2016,0,20130,9808,10322,48.72329856
KY,Bourbon ,2017,0,20092,9795,10297,48.75074657
KY,Bourbon ,2018,0,20116,9798,10318,48.70749652
KY,Bourbon ,2019,0,19788,9672,10116,48.87810794
KY,Boyd ,2015,0,48471,24188,24283,49.90200326
KY,Boyd ,2016,0,48121,23923,24198,49.71426196
KY,Boyd ,2017,0,47808,23798,24010,49.77827979
KY,Boyd ,2018,0,47292,23518,23774,49.72934111
KY,Boyd ,2019,0,46718,23198,23520,49.65537908
KY,Boyle ,2015,0,29782,14894,14888,50.0100732
KY,Boyle ,2016,0,29965,14894,15071,49.70465543
KY,Boyle ,2017,0,29972,14866,15106,49.59962632
KY,Boyle ,2018,0,30082,14952,15130,49.70414201
KY,Boyle ,2019,0,30060,14985,15075,49.8502994
KY,Bracken ,2015,0,8290,4144,4146,49.98793727
KY,Bracken ,2016,0,8368,4184,4184,50
KY,Bracken ,2017,0,8285,4151,4134,50.10259505
KY,Bracken ,2018,0,8278,4148,4130,50.10872191
KY,Bracken ,2019,0,8303,4158,4145,50.07828496
KY,Breathitt ,2015,0,13363,6700,6663,50.13844197
KY,Breathitt ,2016,0,13177,6589,6588,50.00379449
KY,Breathitt ,2017,0,12929,6459,6470,49.95745997
KY,Breathitt ,2018,0,12787,6394,6393,50.00391022
KY,Breathitt ,2019,0,12630,6312,6318,49.97624703
KY,Breckinridge ,2015,0,19979,9994,9985,50.02252365
KY,Breckinridge ,2016,0,19982,10024,9958,50.16514863
KY,Breckinridge ,2017,0,20131,10124,10007,50.29059659
KY,Breckinridge ,2018,0,20309,10202,10107,50.23388645
KY,Breckinridge ,2019,0,20477,10268,10209,50.14406407
KY,Bullitt ,2015,0,78677,38976,39701,49.53925544
KY,Bullitt ,2016,0,79222,39319,39903,49.63141552
KY,Bullitt ,2017,0,80269,39857,40412,49.65428746
KY,Bullitt ,2018,0,81009,40305,40704,49.75373107
KY,Bullitt ,2019,0,81676,40599,41077,49.70738038
KY,Butler ,2015,0,12734,6387,6347,50.15705984
KY,Butler ,2016,0,12686,6387,6299,50.34683904
KY,Butler ,2017,0,12778,6418,6360,50.22695257
KY,Butler ,2018,0,12743,6409,6334,50.29427921
KY,Butler ,2019,0,12879,6459,6420,50.15140927
KY,Caldwell ,2015,0,12748,6175,6573,48.43897082
KY,Caldwell ,2016,0,12634,6122,6512,48.45654583
KY,Caldwell ,2017,0,12666,6132,6534,48.41307437
KY,Caldwell ,2018,0,12716,6135,6581,48.24630387
KY,Caldwell ,2019,0,12747,6188,6559,48.54475563
KY,Calloway ,2015,0,38656,18816,19840,48.67549669
KY,Calloway ,2016,0,38733,18875,19858,48.73105621
KY,Calloway ,2017,0,38832,18922,19910,48.72785332
KY,Calloway ,2018,0,38964,18930,20034,48.58330767
KY,Calloway ,2019,0,39001,18944,20057,48.57311351
KY,Campbell ,2015,0,92124,45287,46837,49.15874256
KY,Campbell ,2016,0,92257,45226,47031,49.02175445
KY,Campbell ,2017,0,92878,45494,47384,48.98253623
KY,Campbell ,2018,0,93464,45769,47695,48.96965677
KY,Campbell ,2019,0,93584,45917,47667,49.06501111
KY,Carlisle ,2015,0,4852,2369,2483,48.82522671
KY,Carlisle ,2016,0,4783,2343,2440,48.98599206
KY,Carlisle ,2017,0,4788,2347,2441,49.01837928
KY,Carlisle ,2018,0,4739,2337,2402,49.31420131
KY,Carlisle ,2019,0,4760,2358,2402,49.53781513
KY,Carroll ,2015,0,10682,5395,5287,50.50552331
KY,Carroll ,2016,0,10614,5338,5276,50.29206708
KY,Carroll ,2017,0,10714,5407,5307,50.46667911
KY,Carroll ,2018,0,10712,5402,5310,50.42942494
KY,Carroll ,2019,0,10631,5345,5286,50.27749036
KY,Carter ,2015,0,27439,13534,13905,49.32395495
KY,Carter ,2016,0,27304,13473,13831,49.3444184
KY,Carter ,2017,0,27214,13475,13739,49.51495554
KY,Carter ,2018,0,27040,13318,13722,49.25295858
KY,Carter ,2019,0,26797,13199,13598,49.25551368
KY,Casey ,2015,0,15749,7672,8077,48.71420408
KY,Casey ,2016,0,15775,7640,8135,48.43106181
KY,Casey ,2017,0,15818,7657,8161,48.40687824
KY,Casey ,2018,0,15926,7715,8211,48.44279794
KY,Casey ,2019,0,16159,7869,8290,48.69732038
KY,Christian ,2015,0,73075,38774,34301,53.06055423
KY,Christian ,2016,0,71796,38245,33551,53.26898434
KY,Christian ,2017,0,71024,38004,33020,53.50867312
KY,Christian ,2018,0,70712,37647,33065,53.2399027
KY,Christian ,2019,0,70461,37354,33107,53.0137239
KY,Clark ,2015,0,35660,17430,18230,48.87829501
KY,Clark ,2016,0,35851,17521,18330,48.87171906
KY,Clark ,2017,0,35899,17579,18320,48.96793783
KY,Clark ,2018,0,36180,17679,18501,48.86401327
KY,Clark ,2019,0,36263,17702,18561,48.81559717
KY,Clay ,2015,0,20974,11108,9866,52.96080862
KY,Clay ,2016,0,20626,10845,9781,52.57926888
KY,Clay ,2017,0,20251,10551,9700,52.10113081
KY,Clay ,2018,0,20088,10448,9640,52.01115094
KY,Clay ,2019,0,19901,10384,9517,52.1782825
KY,Clinton ,2015,0,10183,5047,5136,49.56299715
KY,Clinton ,2016,0,10200,5039,5161,49.40196078
KY,Clinton ,2017,0,10212,5031,5181,49.26556992
KY,Clinton ,2018,0,10152,4987,5165,49.12332545
KY,Clinton ,2019,0,10218,5017,5201,49.09962811
KY,Crittenden ,2015,0,9168,4621,4547,50.40357766
KY,Crittenden ,2016,0,9131,4588,4543,50.24641332
KY,Crittenden ,2017,0,8999,4511,4488,50.12779198
KY,Crittenden ,2018,0,8896,4469,4427,50.23606115
KY,Crittenden ,2019,0,8806,4434,4372,50.3520327
KY,Cumberland ,2015,0,6737,3307,3430,49.08713077
KY,Cumberland ,2016,0,6731,3285,3446,48.804041
KY,Cumberland ,2017,0,6710,3275,3435,48.80774963
KY,Cumberland ,2018,0,6693,3273,3420,48.90183774
KY,Cumberland ,2019,0,6614,3226,3388,48.77532507
KY,Daviess ,2015,0,99485,48366,51119,48.61637433
KY,Daviess ,2016,0,100032,48777,51255,48.76139635
KY,Daviess ,2017,0,100461,49012,51449,48.78709151
KY,Daviess ,2018,0,100883,49245,51638,48.81397262
KY,Daviess ,2019,0,101511,49577,51934,48.83904207
KY,Edmonson ,2015,0,11991,6001,5990,50.04586773
KY,Edmonson ,2016,0,12076,6047,6029,50.07452799
KY,Edmonson ,2017,0,12226,6134,6092,50.17176509
KY,Edmonson ,2018,0,12249,6156,6093,50.25716385
KY,Edmonson ,2019,0,12150,6151,5999,50.6255144
KY,Elliott ,2015,0,7548,4246,3302,56.25331214
KY,Elliott ,2016,0,7491,4235,3256,56.53450808
KY,Elliott ,2017,0,7493,4243,3250,56.62618444
KY,Elliott ,2018,0,7499,4250,3249,56.67422323
KY,Elliott ,2019,0,7517,4283,3234,56.97751763
KY,Estill ,2015,0,14373,7101,7272,49.40513463
KY,Estill ,2016,0,14315,7036,7279,49.15123996
KY,Estill ,2017,0,14178,6982,7196,49.24530963
KY,Estill ,2018,0,14150,6991,7159,49.40636042
KY,Estill ,2019,0,14106,6966,7140,49.38324117
KY,Fayette ,2015,0,315819,154984,160835,49.07367828
KY,Fayette ,2016,0,319644,156718,162926,49.02891967
KY,Fayette ,2017,0,321964,157905,164059,49.04430309
KY,Fayette ,2018,0,322426,158044,164382,49.01713882
KY,Fayette ,2019,0,323152,158164,164988,48.94415012
KY,Fleming ,2015,0,14578,7148,7430,49.03278913
KY,Fleming ,2016,0,14481,7120,7361,49.16787515
KY,Fleming ,2017,0,14439,7064,7375,48.92305561
KY,Fleming ,2018,0,14485,7113,7372,49.10597169
KY,Fleming ,2019,0,14581,7137,7444,48.94726013
KY,Floyd ,2015,0,37531,18366,19165,48.93554661
KY,Floyd ,2016,0,36968,18094,18874,48.94503354
KY,Floyd ,2017,0,36296,17737,18559,48.86764382
KY,Floyd ,2018,0,35896,17576,18320,48.96367283
KY,Floyd ,2019,0,35589,17362,18227,48.78473686
KY,Franklin ,2015,0,50070,24167,25903,48.266427
KY,Franklin ,2016,0,50292,24260,26032,48.2382884
KY,Franklin ,2017,0,50492,24331,26161,48.18783174
KY,Franklin ,2018,0,50801,24578,26223,48.38093738
KY,Franklin ,2019,0,50991,24651,26340,48.34382538
KY,Fulton ,2015,0,6266,3103,3163,49.52122566
KY,Fulton ,2016,0,6185,3051,3134,49.32902183
KY,Fulton ,2017,0,6163,3038,3125,49.29417491
KY,Fulton ,2018,0,6066,3017,3049,49.73623475
KY,Fulton ,2019,0,5969,2992,2977,50.12564919
KY,Gallatin ,2015,0,8613,4361,4252,50.63276443
KY,Gallatin ,2016,0,8719,4387,4332,50.31540314
KY,Gallatin ,2017,0,8720,4416,4304,50.64220183
KY,Gallatin ,2018,0,8766,4432,4334,50.55897787
KY,Gallatin ,2019,0,8869,4501,4368,50.74980268
KY,Garrard ,2015,0,17207,8493,8714,49.35781949
KY,Garrard ,2016,0,17382,8562,8820,49.25785295
KY,Garrard ,2017,0,17449,8557,8892,49.0400596
KY,Garrard ,2018,0,17519,8635,8884,49.289343
KY,Garrard ,2019,0,17666,8708,8958,49.29242613
KY,Grant ,2015,0,24736,12342,12394,49.89489004
KY,Grant ,2016,0,24910,12420,12490,49.85949418
KY,Grant ,2017,0,24973,12471,12502,49.93793297
KY,Grant ,2018,0,25065,12567,12498,50.13764213
KY,Grant ,2019,0,25069,12547,12522,50.04986238
KY,Graves ,2015,0,37248,18204,19044,48.87242268
KY,Graves ,2016,0,37217,18229,18988,48.9803047
KY,Graves ,2017,0,37190,18216,18974,48.98090885
KY,Graves ,2018,0,37319,18239,19080,48.87322811
KY,Graves ,2019,0,37266,18226,19040,48.90785166
KY,Grayson ,2015,0,26138,13144,12994,50.28693856
KY,Grayson ,2016,0,26093,13120,12973,50.28168474
KY,Grayson ,2017,0,26286,13200,13086,50.21684547
KY,Grayson ,2018,0,26293,13224,13069,50.29475526
KY,Grayson ,2019,0,26427,13274,13153,50.22893253
KY,Green ,2015,0,10951,5376,5575,49.09140718
KY,Green ,2016,0,10969,5409,5560,49.3116966
KY,Green ,2017,0,11036,5418,5618,49.09387459
KY,Green ,2018,0,10998,5402,5596,49.11802146
KY,Green ,2019,0,10941,5372,5569,49.09971666
KY,Greenup ,2015,0,36006,17466,18540,48.5085819
KY,Greenup ,2016,0,35824,17407,18417,48.5903305
KY,Greenup ,2017,0,35514,17295,18219,48.69910458
KY,Greenup ,2018,0,35332,17201,18131,48.6839126
KY,Greenup ,2019,0,35098,17094,18004,48.70362984
KY,Hancock ,2015,0,8641,4433,4208,51.30193265
KY,Hancock ,2016,0,8723,4493,4230,51.50750888
KY,Hancock ,2017,0,8778,4529,4249,51.59489633
KY,Hancock ,2018,0,8738,4489,4249,51.37331197
KY,Hancock ,2019,0,8722,4485,4237,51.42169227
KY,Hardin ,2015,0,106272,52967,53305,49.8409741
KY,Hardin ,2016,0,106964,53258,53706,49.79058375
KY,Hardin ,2017,0,108161,53891,54270,49.82479822
KY,Hardin ,2018,0,110279,55013,55266,49.88529094
KY,Hardin ,2019,0,110958,55356,55602,49.88914724
KY,Harlan ,2015,0,27506,13327,14179,48.451247
KY,Harlan ,2016,0,26996,13002,13994,48.16269077
KY,Harlan ,2017,0,26676,12826,13850,48.08067176
KY,Harlan ,2018,0,26309,12614,13695,47.94556996
KY,Harlan ,2019,0,26010,12439,13571,47.82391388
KY,Harrison ,2015,0,18641,9177,9464,49.23019151
KY,Harrison ,2016,0,18569,9098,9471,48.99563789
KY,Harrison ,2017,0,18735,9204,9531,49.12730184
KY,Harrison ,2018,0,18780,9225,9555,49.12140575
KY,Harrison ,2019,0,18886,9266,9620,49.06279784
KY,Hart ,2015,0,18421,9124,9297,49.53042723
KY,Hart ,2016,0,18541,9153,9388,49.36626935
KY,Hart ,2017,0,18745,9252,9493,49.35716191
KY,Hart ,2018,0,18902,9302,9600,49.21172363
KY,Hart ,2019,0,19035,9364,9671,49.19359075
KY,Henderson ,2015,0,46344,22455,23889,48.45287416
KY,Henderson ,2016,0,46212,22365,23847,48.39652038
KY,Henderson ,2017,0,45867,22161,23706,48.31578259
KY,Henderson ,2018,0,45512,22006,23506,48.35208297
KY,Henderson ,2019,0,45210,21841,23369,48.31010838
KY,Henry ,2015,0,15563,7670,7893,49.28355715
KY,Henry ,2016,0,15834,7843,7991,49.53265126
KY,Henry ,2017,0,15972,7909,8063,49.51790634
KY,Henry ,2018,0,16061,7950,8111,49.49878588
KY,Henry ,2019,0,16126,7978,8148,49.47290091
KY,Hickman ,2015,0,4612,2209,2403,47.89679098
KY,Hickman ,2016,0,4607,2203,2404,47.81853701
KY,Hickman ,2017,0,4518,2152,2366,47.63169544
KY,Hickman ,2018,0,4431,2095,2336,47.28052358
KY,Hickman ,2019,0,4380,2066,2314,47.16894977
KY,Hopkins ,2015,0,46055,22389,23666,48.61361416
KY,Hopkins ,2016,0,45598,22232,23366,48.75652441
KY,Hopkins ,2017,0,45293,22098,23195,48.78899609
KY,Hopkins ,2018,0,45024,21962,23062,48.77842928
KY,Hopkins ,2019,0,44686,21787,22899,48.75576243
KY,Jackson ,2015,0,13325,6618,6707,49.66604128
KY,Jackson ,2016,0,13364,6638,6726,49.67075726
KY,Jackson ,2017,0,13422,6670,6752,49.69453137
KY,Jackson ,2018,0,13403,6646,6757,49.5859136
KY,Jackson ,2019,0,13329,6638,6691,49.80118539
KY,Jefferson ,2015,0,764946,369785,395161,48.34132083
KY,Jefferson ,2016,0,767464,371171,396293,48.36331085
KY,Jefferson ,2017,0,769828,372253,397575,48.35534691
KY,Jefferson ,2018,0,768101,371267,396834,48.33570064
KY,Jefferson ,2019,0,766757,370607,396150,48.33434843
KY,Jessamine ,2015,0,51809,25238,26571,48.71354398
KY,Jessamine ,2016,0,52219,25424,26795,48.68725943
KY,Jessamine ,2017,0,53259,25932,27327,48.69036219
KY,Jessamine ,2018,0,53757,26148,27609,48.6411072
KY,Jessamine ,2019,0,54115,26306,27809,48.61129077
KY,Johnson ,2015,0,23128,11351,11777,49.0790384
KY,Johnson ,2016,0,22858,11192,11666,48.96316388
KY,Johnson ,2017,0,22606,11119,11487,49.1860568
KY,Johnson ,2018,0,22391,10986,11405,49.06435621
KY,Johnson ,2019,0,22188,10901,11287,49.13016045
KY,Kenton ,2015,0,164478,81383,83095,49.47956566
KY,Kenton ,2016,0,164962,81601,83361,49.46654381
KY,Kenton ,2017,0,165608,81878,83730,49.44084827
KY,Kenton ,2018,0,166292,82259,84033,49.46660092
KY,Kenton ,2019,0,166998,82647,84351,49.48981425
KY,Knott ,2015,0,15680,7789,7891,49.6747449
KY,Knott ,2016,0,15492,7680,7812,49.57397366
KY,Knott ,2017,0,15244,7540,7704,49.46208344
KY,Knott ,2018,0,15076,7467,7609,49.5290528
KY,Knott ,2019,0,14806,7307,7499,49.35161421
KY,Knox ,2015,0,31465,15359,16106,48.81296679
KY,Knox ,2016,0,31471,15354,16117,48.78777287
KY,Knox ,2017,0,31444,15352,16092,48.82330492
KY,Knox ,2018,0,31300,15281,16019,48.82108626
KY,Knox ,2019,0,31145,15190,15955,48.77187349
KY,Larue ,2015,0,14110,7005,7105,49.64564139
KY,Larue ,2016,0,14018,6952,7066,49.59337994
KY,Larue ,2017,0,14196,7062,7134,49.74640744
KY,Larue ,2018,0,14299,7097,7202,49.63284146
KY,Larue ,2019,0,14398,7111,7287,49.388804
KY,Laurel ,2015,0,59919,29352,30567,48.98613128
KY,Laurel ,2016,0,60078,29378,30700,48.89976364
KY,Laurel ,2017,0,60317,29521,30796,48.94308404
KY,Laurel ,2018,0,60660,29695,30965,48.95318167
KY,Laurel ,2019,0,60813,29826,30987,49.04543436
KY,Lawrence ,2015,0,15861,7892,7969,49.75726625
KY,Lawrence ,2016,0,15839,7903,7936,49.89582676
KY,Lawrence ,2017,0,15756,7824,7932,49.65727342
KY,Lawrence ,2018,0,15583,7749,7834,49.72726689
KY,Lawrence ,2019,0,15317,7581,7736,49.49402625
KY,Lee ,2015,0,6746,3400,3346,50.40023718
KY,Lee ,2016,0,6604,3351,3253,50.74197456
KY,Lee ,2017,0,6602,3363,3239,50.93910936
KY,Lee ,2018,0,7052,3827,3225,54.26829268
KY,Lee ,2019,0,7403,4144,3259,55.9773065
KY,Leslie ,2015,0,10644,5294,5350,49.736941
KY,Leslie ,2016,0,10431,5172,5259,49.58297383
KY,Leslie ,2017,0,10310,5161,5149,50.05819593
KY,Leslie ,2018,0,10151,5060,5091,49.84730568
KY,Leslie ,2019,0,9877,4934,4943,49.95443961
KY,Letcher ,2015,0,23049,11306,11743,49.05201961
KY,Letcher ,2016,0,22759,11148,11611,48.98281998
KY,Letcher ,2017,0,22303,10907,11396,48.90373492
KY,Letcher ,2018,0,21813,10654,11159,48.84243341
KY,Letcher ,2019,0,21553,10533,11020,48.87022688
KY,Lewis ,2015,0,13663,6812,6851,49.85727878
KY,Lewis ,2016,0,13516,6724,6792,49.74844629
KY,Lewis ,2017,0,13363,6652,6711,49.77924119
KY,Lewis ,2018,0,13268,6627,6641,49.94724148
KY,Lewis ,2019,0,13275,6621,6654,49.87570621
KY,Lincoln ,2015,0,24342,11942,12400,49.05923918
KY,Lincoln ,2016,0,24382,12007,12375,49.24534493
KY,Lincoln ,2017,0,24495,12028,12467,49.10389875
KY,Lincoln ,2018,0,24612,12073,12539,49.05330733
KY,Lincoln ,2019,0,24549,12038,12511,49.03662064
KY,Livingston ,2015,0,9289,4575,4714,49.25180321
KY,Livingston ,2016,0,9198,4519,4679,49.13024571
KY,Livingston ,2017,0,9249,4509,4740,48.75121635
KY,Livingston ,2018,0,9244,4539,4705,49.10212029
KY,Livingston ,2019,0,9194,4516,4678,49.11899065
KY,Logan ,2015,0,26746,13108,13638,49.00919764
KY,Logan ,2016,0,26678,13109,13569,49.13786641
KY,Logan ,2017,0,27003,13331,13672,49.36858868
KY,Logan ,2018,0,26983,13344,13639,49.45335952
KY,Logan ,2019,0,27102,13404,13698,49.4576046
KY,Lyon ,2015,0,8474,4788,3686,56.50224215
KY,Lyon ,2016,0,8238,4589,3649,55.70526827
KY,Lyon ,2017,0,8261,4609,3652,55.79227696
KY,Lyon ,2018,0,8171,4547,3624,55.6480235
KY,Lyon ,2019,0,8210,4600,3610,56.02923264
KY,McCracken ,2015,0,64948,31084,33864,47.85982632
KY,McCracken ,2016,0,65304,31250,34054,47.85311773
KY,McCracken ,2017,0,65364,31319,34045,47.9147543
KY,McCracken ,2018,0,65307,31340,33967,47.98873015
KY,McCracken ,2019,0,65418,31389,34029,47.98220673
KY,McCreary ,2015,0,17883,9809,8074,54.85097579
KY,McCreary ,2016,0,17548,9570,7978,54.53612947
KY,McCreary ,2017,0,17372,9463,7909,54.47271471
KY,McCreary ,2018,0,17290,9378,7912,54.23944477
KY,McCreary ,2019,0,17231,9400,7831,54.55284081
KY,McLean ,2015,0,9395,4663,4732,49.6327834
KY,McLean ,2016,0,9337,4622,4715,49.50198136
KY,McLean ,2017,0,9216,4560,4656,49.47916667
KY,McLean ,2018,0,9258,4555,4703,49.20069129
KY,McLean ,2019,0,9207,4526,4681,49.15824916
KY,Madison ,2015,0,88212,42808,45404,48.52854487
KY,Madison ,2016,0,89532,43469,46063,48.55135594
KY,Madison ,2017,0,91170,44322,46848,48.61467588
KY,Madison ,2018,0,92107,44727,47380,48.55982716
KY,Madison ,2019,0,92987,45127,47860,48.53043974
KY,Magoffin ,2015,0,12784,6421,6363,50.22684606
KY,Magoffin ,2016,0,12668,6340,6328,50.04736344
KY,Magoffin ,2017,0,12519,6255,6264,49.96405464
KY,Magoffin ,2018,0,12323,6160,6163,49.98782764
KY,Magoffin ,2019,0,12161,6090,6071,50.07811858
KY,Marion ,2015,0,19212,9509,9703,49.49510722
KY,Marion ,2016,0,19135,9470,9665,49.4904625
KY,Marion ,2017,0,19276,9567,9709,49.63166632
KY,Marion ,2018,0,19326,9584,9742,49.59122426
KY,Marion ,2019,0,19273,9567,9706,49.6393919
KY,Marshall ,2015,0,31059,15284,15775,49.20956889
KY,Marshall ,2016,0,31280,15359,15921,49.1016624
KY,Marshall ,2017,0,31318,15336,15982,48.96864423
KY,Marshall ,2018,0,31202,15268,15934,48.93276072
KY,Marshall ,2019,0,31100,15268,15832,49.09324759
KY,Martin ,2015,0,12285,6829,5456,55.58811559
KY,Martin ,2016,0,11945,6602,5343,55.26998744
KY,Martin ,2017,0,11492,6307,5185,54.8816568
KY,Martin ,2018,0,11325,6239,5086,55.09050773
KY,Martin ,2019,0,11195,6190,5005,55.29254131
KY,Mason ,2015,0,17050,8227,8823,48.25219941
KY,Mason ,2016,0,17167,8267,8900,48.15634648
KY,Mason ,2017,0,17192,8338,8854,48.499302
KY,Mason ,2018,0,17080,8281,8799,48.48360656
KY,Mason ,2019,0,17070,8320,8750,48.74048037
KY,Meade ,2015,0,27725,13934,13791,50.25788999
KY,Meade ,2016,0,27959,14047,13912,50.24142494
KY,Meade ,2017,0,28033,14115,13918,50.3513716
KY,Meade ,2018,0,28623,14420,14203,50.37906579
KY,Meade ,2019,0,28572,14483,14089,50.68948621
KY,Menifee ,2015,0,6373,3232,3141,50.71394947
KY,Menifee ,2016,0,6449,3264,3185,50.61249806
KY,Menifee ,2017,0,6465,3289,3176,50.87393658
KY,Menifee ,2018,0,6437,3287,3150,51.06416032
KY,Menifee ,2019,0,6489,3286,3203,50.63954384
KY,Mercer ,2015,0,21377,10477,10900,49.01061889
KY,Mercer ,2016,0,21405,10459,10946,48.86241532
KY,Mercer ,2017,0,21542,10577,10965,49.09943366
KY,Mercer ,2018,0,21702,10643,11059,49.04156299
KY,Mercer ,2019,0,21933,10742,11191,48.97642821
KY,Metcalfe ,2015,0,9925,4931,4994,49.68261965
KY,Metcalfe ,2016,0,10020,4967,5053,49.57085828
KY,Metcalfe ,2017,0,10093,5013,5080,49.66808679
KY,Metcalfe ,2018,0,10070,4994,5076,49.59285005
KY,Metcalfe ,2019,0,10071,4977,5094,49.41912422
KY,Monroe ,2015,0,10618,5283,5335,49.75513279
KY,Monroe ,2016,0,10539,5234,5305,49.6631559
KY,Monroe ,2017,0,10597,5286,5311,49.88204209
KY,Monroe ,2018,0,10732,5345,5387,49.80432352
KY,Monroe ,2019,0,10650,5299,5351,49.75586854
KY,Montgomery ,2015,0,27576,13456,14120,48.79605454
KY,Montgomery ,2016,0,27666,13546,14120,48.96262561
KY,Montgomery ,2017,0,27913,13689,14224,49.04166517
KY,Montgomery ,2018,0,28109,13743,14366,48.89181401
KY,Montgomery ,2019,0,28157,13747,14410,48.82267287
KY,Morgan ,2015,0,13267,7498,5769,56.51616794
KY,Morgan ,2016,0,13260,7485,5775,56.4479638
KY,Morgan ,2017,0,13230,7476,5754,56.50793651
KY,Morgan ,2018,0,13372,7651,5721,57.21657194
KY,Morgan ,2019,0,13309,7643,5666,57.42730483
KY,Muhlenberg ,2015,0,31245,15934,15311,50.99695951
KY,Muhlenberg ,2016,0,31150,15906,15244,51.06260032
KY,Muhlenberg ,2017,0,30925,15829,15096,51.1851253
KY,Muhlenberg ,2018,0,30811,15746,15065,51.10512479
KY,Muhlenberg ,2019,0,30622,15628,14994,51.03520345
KY,Nelson ,2015,0,45114,22217,22897,49.24635368
KY,Nelson ,2016,0,45497,22489,23008,49.42963272
KY,Nelson ,2017,0,45591,22529,23062,49.4154548
KY,Nelson ,2018,0,45813,22627,23186,49.38991116
KY,Nelson ,2019,0,46233,22832,23401,49.38463868
KY,Nicholas ,2015,0,7059,3534,3525,50.06374841
KY,Nicholas ,2016,0,7083,3517,3566,49.65410137
KY,Nicholas ,2017,0,7160,3545,3615,49.51117318
KY,Nicholas ,2018,0,7195,3573,3622,49.65948575
KY,Nicholas ,2019,0,7269,3586,3683,49.33278305
KY,Ohio ,2015,0,24021,11982,12039,49.88135382
KY,Ohio ,2016,0,24158,12022,12136,49.76405332
KY,Ohio ,2017,0,24116,12035,12081,49.90462763
KY,Ohio ,2018,0,24064,12010,12054,49.90857713
KY,Ohio ,2019,0,23994,12027,11967,50.12503126
KY,Oldham ,2015,0,64556,34230,30326,53.02373133
KY,Oldham ,2016,0,65410,34631,30779,52.9445039
KY,Oldham ,2017,0,66557,35193,31364,52.87648181
KY,Oldham ,2018,0,66512,34823,31689,52.35596584
KY,Oldham ,2019,0,66799,34884,31915,52.22233866
KY,Owen ,2015,0,10736,5309,5427,49.45044709
KY,Owen ,2016,0,10668,5290,5378,49.58755156
KY,Owen ,2017,0,10794,5378,5416,49.82397628
KY,Owen ,2018,0,10881,5416,5465,49.77483687
KY,Owen ,2019,0,10901,5442,5459,49.9220255
KY,Owsley ,2015,0,4445,2169,2276,48.79640045
KY,Owsley ,2016,0,4472,2185,2287,48.85957066
KY,Owsley ,2017,0,4402,2167,2235,49.22762381
KY,Owsley ,2018,0,4474,2209,2265,49.37416182
KY,Owsley ,2019,0,4415,2177,2238,49.30917327
KY,Pendleton ,2015,0,14487,7296,7191,50.36239387
KY,Pendleton ,2016,0,14595,7431,7164,50.91469681
KY,Pendleton ,2017,0,14602,7469,7133,51.15052733
KY,Pendleton ,2018,0,14588,7445,7143,51.03509734
KY,Pendleton ,2019,0,14590,7457,7133,51.11034955
KY,Perry ,2015,0,27373,13469,13904,49.2054214
KY,Perry ,2016,0,27197,13390,13807,49.23337133
KY,Perry ,2017,0,26586,13069,13517,49.15745129
KY,Perry ,2018,0,26208,12912,13296,49.26739927
KY,Perry ,2019,0,25758,12740,13018,49.46036183
KY,Pike ,2015,0,61781,30331,31450,49.09438177
KY,Pike ,2016,0,60431,29574,30857,48.93845874
KY,Pike ,2017,0,58905,28759,30146,48.82268059
KY,Pike ,2018,0,58492,28533,29959,48.78102988
KY,Pike ,2019,0,57876,28266,29610,48.83889695
KY,Powell ,2015,0,12226,6086,6140,49.77915917
KY,Powell ,2016,0,12266,6093,6173,49.67389532
KY,Powell ,2017,0,12297,6123,6174,49.79263235
KY,Powell ,2018,0,12371,6149,6222,49.70495514
KY,Powell ,2019,0,12359,6130,6229,49.59948216
KY,Pulaski ,2015,0,63862,31220,32642,48.88666186
KY,Pulaski ,2016,0,64013,31288,32725,48.87757174
KY,Pulaski ,2017,0,64314,31376,32938,48.78564543
KY,Pulaski ,2018,0,64584,31528,33056,48.81704447
KY,Pulaski ,2019,0,64979,31708,33271,48.79730374
KY,Robertson ,2015,0,2134,1075,1059,50.37488285
KY,Robertson ,2016,0,2125,1072,1053,50.44705882
KY,Robertson ,2017,0,2120,1063,1057,50.14150943
KY,Robertson ,2018,0,2130,1067,1063,50.09389671
KY,Robertson ,2019,0,2108,1060,1048,50.28462998
KY,Rockcastle ,2015,0,16932,8223,8709,48.56484763
KY,Rockcastle ,2016,0,16872,8232,8640,48.79089616
KY,Rockcastle ,2017,0,16778,8183,8595,48.77220169
KY,Rockcastle ,2018,0,16823,8216,8607,48.83790049
KY,Rockcastle ,2019,0,16695,8195,8500,49.08655286
KY,Rowan ,2015,0,24642,12004,12638,48.71357844
KY,Rowan ,2016,0,24416,11899,12517,48.73443644
KY,Rowan ,2017,0,24514,11908,12606,48.57632373
KY,Rowan ,2018,0,24503,11837,12666,48.3083704
KY,Rowan ,2019,0,24460,11782,12678,48.16843827
KY,Russell ,2015,0,17685,8700,8985,49.1942324
KY,Russell ,2016,0,17769,8744,9025,49.20929709
KY,Russell ,2017,0,17723,8732,8991,49.26931106
KY,Russell ,2018,0,17790,8761,9029,49.24676785
KY,Russell ,2019,0,17923,8814,9109,49.17703509
KY,Scott ,2015,0,52155,25634,26521,49.14965008
KY,Scott ,2016,0,53425,26287,27138,49.20355639
KY,Scott ,2017,0,54782,26908,27874,49.11832354
KY,Scott ,2018,0,55968,27557,28411,49.23706404
KY,Scott ,2019,0,57004,28066,28938,49.23514139
KY,Shelby ,2015,0,45787,22221,23566,48.53124249
KY,Shelby ,2016,0,46548,22566,23982,48.47898943
KY,Shelby ,2017,0,47209,22927,24282,48.56489229
KY,Shelby ,2018,0,48059,23376,24683,48.64021307
KY,Shelby ,2019,0,49024,23898,25126,48.74755222
KY,Simpson ,2015,0,17901,8798,9103,49.14809229
KY,Simpson ,2016,0,17992,8827,9165,49.06069364
KY,Simpson ,2017,0,18046,8862,9184,49.10783553
KY,Simpson ,2018,0,18403,9023,9380,49.03004945
KY,Simpson ,2019,0,18572,9119,9453,49.1007969
KY,Spencer ,2015,0,18072,9131,8941,50.52567508
KY,Spencer ,2016,0,18336,9285,9051,50.63808901
KY,Spencer ,2017,0,18619,9461,9158,50.81368495
KY,Spencer ,2018,0,19021,9651,9370,50.73865727
KY,Spencer ,2019,0,19351,9813,9538,50.71055759
KY,Taylor ,2015,0,25586,12450,13136,48.65942312
KY,Taylor ,2016,0,25441,12383,13058,48.6734012
KY,Taylor ,2017,0,25544,12510,13034,48.97431882
KY,Taylor ,2018,0,25514,12476,13038,48.89864388
KY,Taylor ,2019,0,25769,12601,13168,48.89984089
KY,Todd ,2015,0,12447,6177,6270,49.626416
KY,Todd ,2016,0,12357,6113,6244,49.46993607
KY,Todd ,2017,0,12177,6040,6137,49.60170814
KY,Todd ,2018,0,12306,6133,6173,49.83747765
KY,Todd ,2019,0,12294,6117,6177,49.75597853
KY,Trigg ,2015,0,14218,6988,7230,49.1489661
KY,Trigg ,2016,0,14302,7051,7251,49.30079709
KY,Trigg ,2017,0,14418,7134,7284,49.4798169
KY,Trigg ,2018,0,14658,7291,7367,49.7407559
KY,Trigg ,2019,0,14651,7288,7363,49.74404478
KY,Trimble ,2015,0,8733,4396,4337,50.33779915
KY,Trimble ,2016,0,8596,4339,4257,50.47696603
KY,Trimble ,2017,0,8521,4284,4237,50.27578923
KY,Trimble ,2018,0,8468,4239,4229,50.05904582
KY,Trimble ,2019,0,8471,4251,4220,50.18297722
KY,Union ,2015,0,14951,7818,7133,52.29081667
KY,Union ,2016,0,14765,7713,7052,52.23840163
KY,Union ,2017,0,14620,7624,6996,52.14774282
KY,Union ,2018,0,14471,7525,6946,52.00055283
KY,Union ,2019,0,14381,7524,6857,52.31903206
KY,Warren ,2015,0,124122,60820,63302,49.00017724
KY,Warren ,2016,0,126419,61976,64443,49.02427641
KY,Warren ,2017,0,129074,63169,65905,48.94014286
KY,Warren ,2018,0,130750,63997,66753,48.94608031
KY,Warren ,2019,0,132896,65096,67800,48.98266314
KY,Washington ,2015,0,12007,5897,6110,49.11301741
KY,Washington ,2016,0,12109,5928,6181,48.95532249
KY,Washington ,2017,0,11880,5827,6053,49.04882155
KY,Washington ,2018,0,12023,5928,6095,49.3054978
KY,Washington ,2019,0,12095,5986,6109,49.49152542
KY,Wayne ,2015,0,20609,10228,10381,49.62880295
KY,Wayne ,2016,0,20728,10300,10428,49.6912389
KY,Wayne ,2017,0,20628,10262,10366,49.74791545
KY,Wayne ,2018,0,20430,10158,10272,49.72099853
KY,Wayne ,2019,0,20333,10125,10208,49.79589829
KY,Webster ,2015,0,13155,6513,6642,49.50969213
KY,Webster ,2016,0,13181,6495,6686,49.27547227
KY,Webster ,2017,0,13012,6423,6589,49.36212727
KY,Webster ,2018,0,13051,6463,6588,49.52110949
KY,Webster ,2019,0,12942,6409,6533,49.52093958
KY,Whitley ,2015,0,36109,17798,18311,49.28965078
KY,Whitley ,2016,0,36108,17772,18336,49.21900964
KY,Whitley ,2017,0,36074,17691,18383,49.04086045
KY,Whitley ,2018,0,36101,17721,18380,49.0872829
KY,Whitley ,2019,0,36264,17840,18424,49.19479373
KY,Wolfe ,2015,0,7241,3549,3692,49.01256732
KY,Wolfe ,2016,0,7189,3511,3678,48.83850327
KY,Wolfe ,2017,0,7248,3544,3704,48.89624724
KY,Wolfe ,2018,0,7199,3522,3677,48.92346159
KY,Wolfe ,2019,0,7157,3503,3654,48.94508872
KY,Woodford ,2015,0,25860,12437,13423,48.09358082
KY,Woodford ,2016,0,26118,12582,13536,48.17367333
KY,Woodford ,2017,0,26385,12668,13717,48.0121281
KY,Woodford ,2018,0,26491,12723,13768,48.02763203
KY,Woodford ,2019,0,26734,12826,13908,47.97635969
LA,Acadia Parish,2015,0,62679,30558,32121,48.75317092
LA,Acadia Parish,2016,0,62786,30566,32220,48.68282738
LA,Acadia Parish,2017,0,62559,30472,32087,48.7092185
LA,Acadia Parish,2018,0,62214,30393,31821,48.85234835
LA,Acadia Parish,2019,0,62045,30359,31686,48.93061488
LA,Allen Parish,2015,0,25631,14488,11143,56.52530139
LA,Allen Parish,2016,0,25680,14554,11126,56.67445483
LA,Allen Parish,2017,0,25583,14487,11096,56.62744791
LA,Allen Parish,2018,0,25567,14480,11087,56.63550671
LA,Allen Parish,2019,0,25627,14486,11141,56.5263199
LA,Ascension Parish,2015,0,119374,59058,60316,49.47308459
LA,Ascension Parish,2016,0,121558,60149,61409,49.48172889
LA,Ascension Parish,2017,0,123177,60877,62300,49.42237593
LA,Ascension Parish,2018,0,124858,61609,63249,49.34325394
LA,Ascension Parish,2019,0,126604,62348,64256,49.24646931
LA,Assumption Parish,2015,0,22898,11171,11727,48.78592017
LA,Assumption Parish,2016,0,22756,11075,11681,48.66848304
LA,Assumption Parish,2017,0,22568,10968,11600,48.59978731
LA,Assumption Parish,2018,0,22279,10817,11462,48.55244849
LA,Assumption Parish,2019,0,21891,10647,11244,48.63642593
LA,Avoyelles Parish,2015,0,40979,20635,20344,50.35505991
LA,Avoyelles Parish,2016,0,40983,20639,20344,50.35990533
LA,Avoyelles Parish,2017,0,40836,20596,20240,50.4358899
LA,Avoyelles Parish,2018,0,40402,20333,20069,50.3267165
LA,Avoyelles Parish,2019,0,40144,20211,19933,50.34625349
LA,Beauregard Parish,2015,0,36531,18625,17906,50.9840957
LA,Beauregard Parish,2016,0,36973,18825,18148,50.91553296
LA,Beauregard Parish,2017,0,36847,18749,18098,50.88338264
LA,Beauregard Parish,2018,0,37369,18973,18396,50.77203029
LA,Beauregard Parish,2019,0,37497,19108,18389,50.95874337
LA,Bienville Parish,2015,0,13823,6605,7218,47.78268104
LA,Bienville Parish,2016,0,13780,6588,7192,47.808418
LA,Bienville Parish,2017,0,13631,6514,7117,47.78813
LA,Bienville Parish,2018,0,13343,6390,6953,47.89027955
LA,Bienville Parish,2019,0,13241,6338,6903,47.86647534
LA,Bossier Parish,2015,0,125554,62247,63307,49.57787088
LA,Bossier Parish,2016,0,125920,62381,63539,49.54018424
LA,Bossier Parish,2017,0,126959,62873,64086,49.52228672
LA,Bossier Parish,2018,0,127022,62826,64196,49.46072334
LA,Bossier Parish,2019,0,127039,62724,64315,49.37381434
LA,Caddo Parish,2015,0,251345,119318,132027,47.47180171
LA,Caddo Parish,2016,0,248837,117878,130959,47.37157256
LA,Caddo Parish,2017,0,245935,116496,129439,47.36861366
LA,Caddo Parish,2018,0,242833,114848,127985,47.29505463
LA,Caddo Parish,2019,0,240204,113498,126706,47.25067026
LA,Calcasieu Parish,2015,0,198450,96813,101637,48.7845805
LA,Calcasieu Parish,2016,0,200568,97957,102611,48.83979498
LA,Calcasieu Parish,2017,0,202466,98945,103521,48.86993372
LA,Calcasieu Parish,2018,0,203177,99366,103811,48.90612619
LA,Calcasieu Parish,2019,0,203436,99501,103935,48.91022238
LA,Caldwell Parish,2015,0,10045,5161,4884,51.37879542
LA,Caldwell Parish,2016,0,10074,5206,4868,51.67758586
LA,Caldwell Parish,2017,0,9959,5141,4818,51.62164876
LA,Caldwell Parish,2018,0,9964,5134,4830,51.52549177
LA,Caldwell Parish,2019,0,9918,5099,4819,51.41157491
LA,Cameron Parish,2015,0,6825,3396,3429,49.75824176
LA,Cameron Parish,2016,0,6896,3435,3461,49.81148492
LA,Cameron Parish,2017,0,6944,3468,3476,49.94239631
LA,Cameron Parish,2018,0,7013,3500,3513,49.90731499
LA,Cameron Parish,2019,0,6973,3442,3531,49.36182418
LA,Catahoula Parish,2015,0,10029,5308,4721,52.92651311
LA,Catahoula Parish,2016,0,9869,5238,4631,53.07528625
LA,Catahoula Parish,2017,0,9830,5194,4636,52.83825025
LA,Catahoula Parish,2018,0,9606,5064,4542,52.71705184
LA,Catahoula Parish,2019,0,9494,5004,4490,52.70697282
LA,Claiborne Parish,2015,0,16261,9149,7112,56.26345243
LA,Claiborne Parish,2016,0,16146,9117,7029,56.46599777
LA,Claiborne Parish,2017,0,15953,9055,6898,56.76048392
LA,Claiborne Parish,2018,0,15895,9002,6893,56.63416169
LA,Claiborne Parish,2019,0,15670,8909,6761,56.85386088
LA,Concordia Parish,2015,0,20228,10238,9990,50.61301167
LA,Concordia Parish,2016,0,19970,10150,9820,50.82623936
LA,Concordia Parish,2017,0,19846,10043,9803,50.60465585
LA,Concordia Parish,2018,0,19586,9930,9656,50.69947922
LA,Concordia Parish,2019,0,19259,9796,9463,50.86453087
LA,De Soto Parish,2015,0,27101,13100,14001,48.33769972
LA,De Soto Parish,2016,0,27190,13154,14036,48.37808018
LA,De Soto Parish,2017,0,27267,13204,14063,48.42483588
LA,De Soto Parish,2018,0,27426,13242,14184,48.2826515
LA,De Soto Parish,2019,0,27463,13252,14211,48.25401449
LA,East Baton Rouge Parish,2015,0,445512,213560,231952,47.93585807
LA,East Baton Rouge Parish,2016,0,446677,213834,232843,47.87217609
LA,East Baton Rouge Parish,2017,0,444511,212570,231941,47.82108879
LA,East Baton Rouge Parish,2018,0,442058,211111,230947,47.75640301
LA,East Baton Rouge Parish,2019,0,440059,209785,230274,47.67201671
LA,East Carroll Parish,2015,0,7277,3939,3338,54.12944895
LA,East Carroll Parish,2016,0,7235,3907,3328,54.00138217
LA,East Carroll Parish,2017,0,7111,3850,3261,54.14147096
LA,East Carroll Parish,2018,0,6994,3797,3197,54.28939091
LA,East Carroll Parish,2019,0,6861,3723,3138,54.26322693
LA,East Feliciana Parish,2015,0,19540,10609,8931,54.2937564
LA,East Feliciana Parish,2016,0,19513,10595,8918,54.29713524
LA,East Feliciana Parish,2017,0,19380,10525,8855,54.30856553
LA,East Feliciana Parish,2018,0,19286,10471,8815,54.29326973
LA,East Feliciana Parish,2019,0,19135,10441,8694,54.56493337
LA,Evangeline Parish,2015,0,33724,17187,16537,50.96370537
LA,Evangeline Parish,2016,0,33667,17134,16533,50.89256542
LA,Evangeline Parish,2017,0,33663,17102,16561,50.80355286
LA,Evangeline Parish,2018,0,33496,17052,16444,50.90757105
LA,Evangeline Parish,2019,0,33395,17024,16371,50.97769127
LA,Franklin Parish,2015,0,20386,9903,10483,48.57745512
LA,Franklin Parish,2016,0,20370,9890,10480,48.55179185
LA,Franklin Parish,2017,0,20256,9844,10412,48.59794629
LA,Franklin Parish,2018,0,20164,9759,10405,48.39813529
LA,Franklin Parish,2019,0,20015,9732,10283,48.62353235
LA,Grant Parish,2015,0,22302,12545,9757,56.25056049
LA,Grant Parish,2016,0,22279,12521,9758,56.20090668
LA,Grant Parish,2017,0,22296,12546,9750,56.27018299
LA,Grant Parish,2018,0,22436,12559,9877,55.97700125
LA,Grant Parish,2019,0,22389,12553,9836,56.06771182
LA,Iberia Parish,2015,0,73747,36151,37596,49.02029913
LA,Iberia Parish,2016,0,72971,35683,37288,48.90024804
LA,Iberia Parish,2017,0,71982,35163,36819,48.84971243
LA,Iberia Parish,2018,0,70905,34663,36242,48.88653833
LA,Iberia Parish,2019,0,69830,34162,35668,48.92166691
LA,Iberville Parish,2015,0,33136,16821,16315,50.76352004
LA,Iberville Parish,2016,0,32864,16641,16223,50.63595424
LA,Iberville Parish,2017,0,32906,16616,16290,50.49535039
LA,Iberville Parish,2018,0,32693,16533,16160,50.57045851
LA,Iberville Parish,2019,0,32511,16374,16137,50.36449202
LA,Jackson Parish,2015,0,15947,8131,7816,50.98764658
LA,Jackson Parish,2016,0,15895,8156,7739,51.31173325
LA,Jackson Parish,2017,0,15898,8176,7722,51.42785256
LA,Jackson Parish,2018,0,15912,8166,7746,51.31975867
LA,Jackson Parish,2019,0,15744,8087,7657,51.36559959
LA,Jefferson Parish,2015,0,435175,211360,223815,48.56896651
LA,Jefferson Parish,2016,0,436572,212003,224569,48.56083304
LA,Jefferson Parish,2017,0,436126,211372,224754,48.46581034
LA,Jefferson Parish,2018,0,433884,209988,223896,48.39726747
LA,Jefferson Parish,2019,0,432493,208905,223588,48.30251588
LA,Jefferson Davis Parish,2015,0,31431,15415,16016,49.04393751
LA,Jefferson Davis Parish,2016,0,31388,15349,16039,48.90085383
LA,Jefferson Davis Parish,2017,0,31480,15425,16055,48.99936468
LA,Jefferson Davis Parish,2018,0,31537,15462,16075,49.02812569
LA,Jefferson Davis Parish,2019,0,31368,15385,15983,49.04679929
LA,Lafayette Parish,2015,0,239332,117158,122174,48.9520833
LA,Lafayette Parish,2016,0,241275,117906,123369,48.86788934
LA,Lafayette Parish,2017,0,241756,117825,123931,48.73715647
LA,Lafayette Parish,2018,0,243113,118293,124820,48.65762012
LA,Lafayette Parish,2019,0,244390,118708,125682,48.57318221
LA,Lafourche Parish,2015,0,98314,48356,49958,49.18526354
LA,Lafourche Parish,2016,0,98506,48410,50096,49.14421457
LA,Lafourche Parish,2017,0,98123,48163,49960,49.08431255
LA,Lafourche Parish,2018,0,97981,48032,49949,49.02174911
LA,Lafourche Parish,2019,0,97614,47886,49728,49.0564878
LA,LaSalle Parish,2015,0,14979,7747,7232,51.71907337
LA,LaSalle Parish,2016,0,15022,7759,7263,51.650912
LA,LaSalle Parish,2017,0,14887,7685,7202,51.62222073
LA,LaSalle Parish,2018,0,14901,7720,7181,51.80860345
LA,LaSalle Parish,2019,0,14892,7749,7143,52.03464948
LA,Lincoln Parish,2015,0,47434,23148,24286,48.8004385
LA,Lincoln Parish,2016,0,47473,23121,24352,48.70347355
LA,Lincoln Parish,2017,0,47471,23091,24380,48.642329
LA,Lincoln Parish,2018,0,47112,22944,24168,48.70096791
LA,Lincoln Parish,2019,0,46742,22743,23999,48.65645458
LA,Livingston Parish,2015,0,137116,67571,69545,49.28017153
LA,Livingston Parish,2016,0,139627,68772,70855,49.2540841
LA,Livingston Parish,2017,0,137712,67881,69831,49.2920007
LA,Livingston Parish,2018,0,139394,68706,70688,49.28906553
LA,Livingston Parish,2019,0,140789,69268,71521,49.19986647
LA,Madison Parish,2015,0,11554,5750,5804,49.7663147
LA,Madison Parish,2016,0,11486,5715,5771,49.75622497
LA,Madison Parish,2017,0,11342,5645,5697,49.77076353
LA,Madison Parish,2018,0,11196,5560,5636,49.66059307
LA,Madison Parish,2019,0,10951,5429,5522,49.57538124
LA,Morehouse Parish,2015,0,26301,12647,13654,48.08562412
LA,Morehouse Parish,2016,0,25894,12503,13391,48.28531706
LA,Morehouse Parish,2017,0,25655,12358,13297,48.16994738
LA,Morehouse Parish,2018,0,25324,12176,13148,48.0808719
LA,Morehouse Parish,2019,0,24874,11911,12963,47.88534212
LA,Natchitoches Parish,2015,0,39004,18662,20342,47.84637473
LA,Natchitoches Parish,2016,0,39024,18696,20328,47.90897909
LA,Natchitoches Parish,2017,0,39042,18758,20284,48.04569438
LA,Natchitoches Parish,2018,0,38616,18570,20046,48.08887508
LA,Natchitoches Parish,2019,0,38158,18379,19779,48.1655223
LA,Orleans Parish,2015,0,389742,185915,203827,47.70206957
LA,Orleans Parish,2016,0,391843,186574,205269,47.61447825
LA,Orleans Parish,2017,0,391493,185721,205772,47.43916239
LA,Orleans Parish,2018,0,391004,185112,205892,47.34273818
LA,Orleans Parish,2019,0,390144,184302,205842,47.23948081
LA,Ouachita Parish,2015,0,156880,75251,81629,47.9672361
LA,Ouachita Parish,2016,0,156897,75272,81625,47.97542337
LA,Ouachita Parish,2017,0,155841,74832,81009,48.01817237
LA,Ouachita Parish,2018,0,154571,74114,80457,47.94819209
LA,Ouachita Parish,2019,0,153279,73314,79965,47.83042687
LA,Plaquemines Parish,2015,0,23437,11831,11606,50.48001024
LA,Plaquemines Parish,2016,0,23323,11720,11603,50.25082537
LA,Plaquemines Parish,2017,0,23348,11768,11580,50.40260408
LA,Plaquemines Parish,2018,0,23385,11801,11584,50.46397263
LA,Plaquemines Parish,2019,0,23197,11712,11485,50.48928741
LA,Pointe Coupee Parish,2015,0,22197,10688,11509,48.15065099
LA,Pointe Coupee Parish,2016,0,22111,10642,11469,48.1298901
LA,Pointe Coupee Parish,2017,0,22164,10654,11510,48.06894062
LA,Pointe Coupee Parish,2018,0,21879,10501,11378,47.99579505
LA,Pointe Coupee Parish,2019,0,21730,10422,11308,47.96134376
LA,Rapides Parish,2015,0,131780,63670,68110,48.31537411
LA,Rapides Parish,2016,0,131845,63764,68081,48.36285032
LA,Rapides Parish,2017,0,131253,63499,67754,48.37908467
LA,Rapides Parish,2018,0,130326,63124,67202,48.43546184
LA,Rapides Parish,2019,0,129648,62723,66925,48.37945823
LA,Red River Parish,2015,0,8711,4220,4491,48.44449547
LA,Red River Parish,2016,0,8621,4172,4449,48.39345784
LA,Red River Parish,2017,0,8527,4122,4405,48.34056526
LA,Red River Parish,2018,0,8526,4105,4421,48.14684494
LA,Red River Parish,2019,0,8442,4044,4398,47.90334044
LA,Richland Parish,2015,0,20546,9976,10570,48.55446316
LA,Richland Parish,2016,0,20446,9939,10507,48.61097525
LA,Richland Parish,2017,0,20413,9938,10475,48.68466174
LA,Richland Parish,2018,0,20223,9850,10373,48.70691787
LA,Richland Parish,2019,0,20122,9816,10306,48.78242719
LA,Sabine Parish,2015,0,24205,11976,12229,49.47738071
LA,Sabine Parish,2016,0,24055,11923,12132,49.56557888
LA,Sabine Parish,2017,0,23909,11795,12114,49.3328872
LA,Sabine Parish,2018,0,23901,11770,12131,49.24480147
LA,Sabine Parish,2019,0,23884,11823,12061,49.5017585
LA,St. Bernard Parish,2015,0,45421,22442,22979,49.40886374
LA,St. Bernard Parish,2016,0,45777,22607,23170,49.38506237
LA,St. Bernard Parish,2017,0,46110,22693,23417,49.21492084
LA,St. Bernard Parish,2018,0,46780,22922,23858,48.99957247
LA,St. Bernard Parish,2019,0,47244,23160,24084,49.02209804
LA,St. Charles Parish,2015,0,52572,25921,26651,49.30571407
LA,St. Charles Parish,2016,0,52796,25932,26864,49.11735738
LA,St. Charles Parish,2017,0,52620,25802,26818,49.03458761
LA,St. Charles Parish,2018,0,52775,25884,26891,49.04594979
LA,St. Charles Parish,2019,0,53100,26000,27100,48.96421846
LA,St. Helena Parish,2015,0,10457,5104,5353,48.80940996
LA,St. Helena Parish,2016,0,10389,5058,5331,48.68611031
LA,St. Helena Parish,2017,0,10322,4991,5331,48.35303236
LA,St. Helena Parish,2018,0,10187,4892,5295,48.02198881
LA,St. Helena Parish,2019,0,10132,4854,5278,47.90761942
LA,St. James Parish,2015,0,21481,10383,11098,48.33573856
LA,St. James Parish,2016,0,21433,10344,11089,48.26202585
LA,St. James Parish,2017,0,21380,10307,11073,48.20860617
LA,St. James Parish,2018,0,21151,10209,10942,48.26722141
LA,St. James Parish,2019,0,21096,10163,10933,48.17500948
LA,St. John the Baptist Parish,2015,0,43523,21199,22324,48.7075799
LA,St. John the Baptist Parish,2016,0,43401,21153,22248,48.73850833
LA,St. John the Baptist Parish,2017,0,43328,21110,22218,48.72138109
LA,St. John the Baptist Parish,2018,0,43119,20990,22129,48.67923653
LA,St. John the Baptist Parish,2019,0,42837,20903,21934,48.79660107
LA,St. Landry Parish,2015,0,83649,40233,43416,48.09740702
LA,St. Landry Parish,2016,0,83768,40408,43360,48.23799064
LA,St. Landry Parish,2017,0,83535,40337,43198,48.28754414
LA,St. Landry Parish,2018,0,82782,39908,42874,48.20854775
LA,St. Landry Parish,2019,0,82124,39568,42556,48.18079977
LA,St. Martin Parish,2015,0,53831,26527,27304,49.27829689
LA,St. Martin Parish,2016,0,53771,26473,27298,49.23285786
LA,St. Martin Parish,2017,0,54066,26589,27477,49.17878149
LA,St. Martin Parish,2018,0,53562,26324,27238,49.14678317
LA,St. Martin Parish,2019,0,53431,26237,27194,49.10445247
LA,St. Mary Parish,2015,0,52876,26163,26713,49.47991527
LA,St. Mary Parish,2016,0,52069,25757,26312,49.46705333
LA,St. Mary Parish,2017,0,50708,25008,25700,49.31766191
LA,St. Mary Parish,2018,0,49841,24574,25267,49.30478923
LA,St. Mary Parish,2019,0,49348,24335,25013,49.31304207
LA,St. Tammany Parish,2015,0,248930,121055,127875,48.63013699
LA,St. Tammany Parish,2016,0,252468,122773,129695,48.6291332
LA,St. Tammany Parish,2017,0,255921,124407,131514,48.61148558
LA,St. Tammany Parish,2018,0,258035,125374,132661,48.58798225
LA,St. Tammany Parish,2019,0,260419,126631,133788,48.62586831
LA,Tangipahoa Parish,2015,0,128716,62399,66317,48.47804469
LA,Tangipahoa Parish,2016,0,130619,63213,67406,48.3949502
LA,Tangipahoa Parish,2017,0,132353,64112,68241,48.44015625
LA,Tangipahoa Parish,2018,0,133837,64825,69012,48.43578383
LA,Tangipahoa Parish,2019,0,134758,65335,69423,48.48320693
LA,Tensas Parish,2015,0,4772,2301,2471,48.21877619
LA,Tensas Parish,2016,0,4656,2249,2407,48.3032646
LA,Tensas Parish,2017,0,4574,2206,2368,48.22912112
LA,Tensas Parish,2018,0,4470,2168,2302,48.50111857
LA,Tensas Parish,2019,0,4334,2134,2200,49.23857868
LA,Terrebonne Parish,2015,0,113817,56427,57390,49.57695248
LA,Terrebonne Parish,2016,0,113006,55830,57176,49.4044564
LA,Terrebonne Parish,2017,0,111823,55202,56621,49.36551514
LA,Terrebonne Parish,2018,0,111163,54713,56450,49.21871486
LA,Terrebonne Parish,2019,0,110461,54386,56075,49.23547677
LA,Union Parish,2015,0,22487,11189,11298,49.75763775
LA,Union Parish,2016,0,22528,11178,11350,49.61825284
LA,Union Parish,2017,0,22398,11122,11276,49.65621931
LA,Union Parish,2018,0,22243,11014,11229,49.51670188
LA,Union Parish,2019,0,22108,10956,11152,49.55672155
LA,Vermilion Parish,2015,0,59918,29061,30857,48.50128509
LA,Vermilion Parish,2016,0,60074,29134,30940,48.49685388
LA,Vermilion Parish,2017,0,59936,29008,30928,48.39829151
LA,Vermilion Parish,2018,0,59886,28990,30896,48.40864309
LA,Vermilion Parish,2019,0,59511,28733,30778,48.28183025
LA,Vernon Parish,2015,0,51431,27517,23914,53.50275126
LA,Vernon Parish,2016,0,51481,27592,23889,53.59647248
LA,Vernon Parish,2017,0,49789,26388,23401,52.99965856
LA,Vernon Parish,2018,0,48101,25389,22712,52.78268643
LA,Vernon Parish,2019,0,47429,24937,22492,52.57753695
LA,Washington Parish,2015,0,46358,22951,23407,49.5081755
LA,Washington Parish,2016,0,46387,22948,23439,49.47075689
LA,Washington Parish,2017,0,46649,23070,23579,49.45443632
LA,Washington Parish,2018,0,46588,23050,23538,49.47625998
LA,Washington Parish,2019,0,46194,22835,23359,49.43282677
LA,Webster Parish,2015,0,40061,19502,20559,48.68076184
LA,Webster Parish,2016,0,39751,19361,20390,48.70569294
LA,Webster Parish,2017,0,39264,19084,20180,48.60431948
LA,Webster Parish,2018,0,38792,18878,19914,48.66467313
LA,Webster Parish,2019,0,38340,18685,19655,48.73500261
LA,West Baton Rouge Parish,2015,0,25554,12663,12891,49.55388589
LA,West Baton Rouge Parish,2016,0,25901,12851,13050,49.61584495
LA,West Baton Rouge Parish,2017,0,26184,12938,13246,49.41185457
LA,West Baton Rouge Parish,2018,0,26400,13044,13356,49.40909091
LA,West Baton Rouge Parish,2019,0,26465,13028,13437,49.22728131
LA,West Carroll Parish,2015,0,11287,5728,5559,50.74864889
LA,West Carroll Parish,2016,0,11136,5671,5465,50.92492816
LA,West Carroll Parish,2017,0,10974,5595,5379,50.98414434
LA,West Carroll Parish,2018,0,10977,5582,5395,50.851781
LA,West Carroll Parish,2019,0,10830,5487,5343,50.66481994
LA,West Feliciana Parish,2015,0,15383,10105,5278,65.68939739
LA,West Feliciana Parish,2016,0,15327,10071,5256,65.70757487
LA,West Feliciana Parish,2017,0,15371,10032,5339,65.2657602
LA,West Feliciana Parish,2018,0,15492,10088,5404,65.11747999
LA,West Feliciana Parish,2019,0,15568,10114,5454,64.96659815
LA,Winn Parish,2015,0,14642,7816,6826,53.3806857
LA,Winn Parish,2016,0,14532,7767,6765,53.447564
LA,Winn Parish,2017,0,14350,7647,6703,53.28919861
LA,Winn Parish,2018,0,14138,7578,6560,53.60022634
LA,Winn Parish,2019,0,13904,7447,6457,53.56012658
ME,Androscoggin ,2015,0,107124,52563,54561,49.06743587
ME,Androscoggin ,2016,0,107296,52526,54770,48.95429466
ME,Androscoggin ,2017,0,107399,52612,54787,48.98742074
ME,Androscoggin ,2018,0,107914,52818,55096,48.9445299
ME,Androscoggin ,2019,0,108277,53032,55245,48.97808399
ME,Aroostook ,2015,0,68818,33993,34825,49.39550699
ME,Aroostook ,2016,0,68243,33700,34543,49.38235423
ME,Aroostook ,2017,0,67609,33425,34184,49.4386842
ME,Aroostook ,2018,0,67318,33289,34029,49.45036989
ME,Aroostook ,2019,0,67055,33157,33898,49.4474685
ME,Cumberland ,2015,0,289488,140627,148861,48.57783397
ME,Cumberland ,2016,0,291191,141335,149856,48.53687099
ME,Cumberland ,2017,0,292181,141818,150363,48.53772148
ME,Cumberland ,2018,0,293673,142452,151221,48.5070129
ME,Cumberland ,2019,0,295003,142916,152087,48.44560903
ME,Franklin ,2015,0,30017,14733,15284,49.08218676
ME,Franklin ,2016,0,29982,14747,15235,49.18617837
ME,Franklin ,2017,0,29799,14681,15118,49.26675392
ME,Franklin ,2018,0,29915,14661,15254,49.00885843
ME,Franklin ,2019,0,30199,14840,15359,49.14070002
ME,Hancock ,2015,0,54237,26320,27917,48.5277578
ME,Hancock ,2016,0,54509,26416,28093,48.46172192
ME,Hancock ,2017,0,54539,26450,28089,48.49740553
ME,Hancock ,2018,0,54734,26557,28177,48.52011547
ME,Hancock ,2019,0,54987,26659,28328,48.48236856
ME,Kennebec ,2015,0,121010,58994,62016,48.75134286
ME,Kennebec ,2016,0,121497,59331,62166,48.83330453
ME,Kennebec ,2017,0,121913,59516,62397,48.81841969
ME,Kennebec ,2018,0,122044,59437,62607,48.70128806
ME,Kennebec ,2019,0,122302,59584,62718,48.7187454
ME,Knox ,2015,0,39786,19683,20103,49.47217614
ME,Knox ,2016,0,39761,19671,20090,49.47310178
ME,Knox ,2017,0,39759,19629,20130,49.36995397
ME,Knox ,2018,0,39717,19649,20068,49.47251807
ME,Knox ,2019,0,39772,19723,20049,49.59016393
ME,Lincoln ,2015,0,33784,16459,17325,48.7183282
ME,Lincoln ,2016,0,33974,16640,17334,48.97863072
ME,Lincoln ,2017,0,34215,16753,17462,48.96390472
ME,Lincoln ,2018,0,34399,16890,17509,49.10026454
ME,Lincoln ,2019,0,34634,16956,17678,48.95767165
ME,Oxford ,2015,0,57164,28330,28834,49.55916311
ME,Oxford ,2016,0,57322,28400,28922,49.54467744
ME,Oxford ,2017,0,57534,28455,29079,49.45771196
ME,Oxford ,2018,0,57754,28534,29220,49.40610174
ME,Oxford ,2019,0,57975,28659,29316,49.43337646
ME,Penobscot ,2015,0,151929,75199,76730,49.49614623
ME,Penobscot ,2016,0,151333,74978,76355,49.54504305
ME,Penobscot ,2017,0,151645,75070,76575,49.50377526
ME,Penobscot ,2018,0,151817,75244,76573,49.56230198
ME,Penobscot ,2019,0,152148,75416,76732,49.56752636
ME,Piscataquis ,2015,0,16937,8457,8480,49.93210132
ME,Piscataquis ,2016,0,16910,8416,8494,49.76936724
ME,Piscataquis ,2017,0,16804,8385,8419,49.89883361
ME,Piscataquis ,2018,0,16746,8369,8377,49.9761137
ME,Piscataquis ,2019,0,16785,8391,8394,49.99106345
ME,Sagadahoc ,2015,0,35120,17066,18054,48.59339408
ME,Sagadahoc ,2016,0,35156,17076,18080,48.57207873
ME,Sagadahoc ,2017,0,35436,17249,18187,48.67648719
ME,Sagadahoc ,2018,0,35690,17378,18312,48.69151023
ME,Sagadahoc ,2019,0,35856,17437,18419,48.63063365
ME,Somerset ,2015,0,50729,25121,25608,49.51999842
ME,Somerset ,2016,0,50546,25070,25476,49.59838563
ME,Somerset ,2017,0,50351,25021,25330,49.69315406
ME,Somerset ,2018,0,50489,25109,25380,49.73162471
ME,Somerset ,2019,0,50484,25098,25386,49.71476111
ME,Waldo ,2015,0,39120,19252,19868,49.21267894
ME,Waldo ,2016,0,39429,19437,19992,49.2962033
ME,Waldo ,2017,0,39772,19640,20132,49.3814744
ME,Waldo ,2018,0,39657,19558,20099,49.317901
ME,Waldo ,2019,0,39715,19606,20109,49.36673801
ME,Washington ,2015,0,31776,15695,16081,49.39262336
ME,Washington ,2016,0,31603,15600,16003,49.3624023
ME,Washington ,2017,0,31374,15420,15954,49.14897686
ME,Washington ,2018,0,31321,15392,15929,49.14274768
ME,Washington ,2019,0,31379,15368,16011,48.97542943
ME,York ,2015,0,201223,97894,103329,48.64950826
ME,York ,2016,0,202565,98542,104023,48.64710093
ME,York ,2017,0,204282,99534,104748,48.72382295
ME,York ,2018,0,205869,100346,105523,48.74264702
ME,York ,2019,0,207641,101270,106371,48.77167804
MD,Allegany ,2015,0,72462,37592,34870,51.87822583
MD,Allegany ,2016,0,72053,37458,34595,51.98673199
MD,Allegany ,2017,0,71352,37113,34239,52.01395896
MD,Allegany ,2018,0,70941,36946,33995,52.07989738
MD,Allegany ,2019,0,70416,36692,33724,52.10747557
MD,Anne Arundel ,2015,0,563027,278908,284119,49.53723356
MD,Anne Arundel ,2016,0,567254,280862,286392,49.51256404
MD,Anne Arundel ,2017,0,571339,282901,288438,49.51543654
MD,Anne Arundel ,2018,0,575523,284750,290773,49.47673681
MD,Anne Arundel ,2019,0,579234,286470,292764,49.45669626
MD,Baltimore ,2015,0,827533,392191,435342,47.39279279
MD,Baltimore ,2016,0,828682,393010,435672,47.42591247
MD,Baltimore ,2017,0,828645,392786,435859,47.40099801
MD,Baltimore ,2018,0,827859,392223,435636,47.37799553
MD,Baltimore ,2019,0,827370,391735,435635,47.34701524
MD,Calvert ,2015,0,90477,44732,45745,49.44018922
MD,Calvert ,2016,0,91052,45050,46002,49.47722181
MD,Calvert ,2017,0,91435,45251,46184,49.4898015
MD,Calvert ,2018,0,92065,45610,46455,49.5410851
MD,Calvert ,2019,0,92525,45848,46677,49.55201297
MD,Caroline ,2015,0,32595,15956,16639,48.9522933
MD,Caroline ,2016,0,32840,16118,16722,49.08038977
MD,Caroline ,2017,0,33096,16255,16841,49.11469664
MD,Caroline ,2018,0,33306,16335,16971,49.04521708
MD,Caroline ,2019,0,33406,16340,17066,48.91336886
MD,Carroll ,2015,0,167132,82649,84483,49.45133188
MD,Carroll ,2016,0,167100,82624,84476,49.44584081
MD,Carroll ,2017,0,167547,82977,84570,49.524611
MD,Carroll ,2018,0,168267,83277,84990,49.49098754
MD,Carroll ,2019,0,168447,83303,85144,49.45353731
MD,Cecil ,2015,0,102382,50848,51534,49.66498017
MD,Cecil ,2016,0,102487,50930,51557,49.69410755
MD,Cecil ,2017,0,102394,50890,51504,49.70017774
MD,Cecil ,2018,0,102644,50934,51710,49.62199447
MD,Cecil ,2019,0,102855,50949,51906,49.53478197
MD,Charles ,2015,0,155665,75103,80562,48.2465551
MD,Charles ,2016,0,157292,75991,81301,48.31205656
MD,Charles ,2017,0,159450,76898,82552,48.22703042
MD,Charles ,2018,0,161476,77737,83739,48.14151948
MD,Charles ,2019,0,163257,78682,84575,48.19517693
MD,Dorchester ,2015,0,32419,15429,16990,47.59246121
MD,Dorchester ,2016,0,32276,15357,16919,47.58024538
MD,Dorchester ,2017,0,32105,15271,16834,47.56579972
MD,Dorchester ,2018,0,31960,15173,16787,47.47496871
MD,Dorchester ,2019,0,31929,15153,16776,47.45842338
MD,Frederick ,2015,0,245001,120666,124335,49.25122755
MD,Frederick ,2016,0,246999,121574,125425,49.22044219
MD,Frederick ,2017,0,250622,123403,127219,49.23869413
MD,Frederick ,2018,0,254943,125687,129256,49.30003962
MD,Frederick ,2019,0,259547,127888,131659,49.27354198
MD,Garrett ,2015,0,29426,14610,14816,49.64996941
MD,Garrett ,2016,0,29358,14548,14810,49.55378432
MD,Garrett ,2017,0,29242,14420,14822,49.31263251
MD,Garrett ,2018,0,29133,14397,14736,49.41818556
MD,Garrett ,2019,0,29014,14324,14690,49.36927001
MD,Harford ,2015,0,249558,122018,127540,48.89364396
MD,Harford ,2016,0,250370,122444,127926,48.90522027
MD,Harford ,2017,0,251858,123095,128763,48.87476276
MD,Harford ,2018,0,253882,124277,129605,48.95069363
MD,Harford ,2019,0,255441,125126,130315,48.98430557
MD,Howard ,2015,0,311297,152296,159001,48.92305419
MD,Howard ,2016,0,315416,154487,160929,48.97880894
MD,Howard ,2017,0,319251,156239,163012,48.9392359
MD,Howard ,2018,0,322621,157963,164658,48.9624048
MD,Howard ,2019,0,325690,159356,166334,48.92873591
MD,Kent ,2015,0,19715,9388,10327,47.61856454
MD,Kent ,2016,0,19666,9377,10289,47.68127733
MD,Kent ,2017,0,19442,9299,10143,47.82944142
MD,Kent ,2018,0,19434,9291,10143,47.80796542
MD,Kent ,2019,0,19422,9339,10083,48.08464628
MD,Montgomery ,2015,0,1032814,498814,534000,48.29659551
MD,Montgomery ,2016,0,1038846,501689,537157,48.29291348
MD,Montgomery ,2017,0,1046822,505815,541007,48.31910296
MD,Montgomery ,2018,0,1048478,506536,541942,48.31155256
MD,Montgomery ,2019,0,1050688,508057,542631,48.35469711
MD,Prince George's ,2015,0,906197,435988,470209,48.1118344
MD,Prince George's ,2016,0,908501,437389,471112,48.14403066
MD,Prince George's ,2017,0,909705,437904,471801,48.13692351
MD,Prince George's ,2018,0,909619,437630,471989,48.11135212
MD,Prince George's ,2019,0,909327,437023,472304,48.06004881
MD,Queen Anne's ,2015,0,48984,24316,24668,49.640699
MD,Queen Anne's ,2016,0,49063,24389,24674,49.7095571
MD,Queen Anne's ,2017,0,49586,24620,24966,49.6511112
MD,Queen Anne's ,2018,0,50148,24907,25241,49.66698572
MD,Queen Anne's ,2019,0,50381,25010,25371,49.64173002
MD,St. Mary's ,2015,0,110985,55390,55595,49.90764518
MD,St. Mary's ,2016,0,111750,55875,55875,50
MD,St. Mary's ,2017,0,112487,56220,56267,49.9791087
MD,St. Mary's ,2018,0,112720,56246,56474,49.89886444
MD,St. Mary's ,2019,0,113510,56766,56744,50.00969078
MD,Somerset ,2015,0,25687,13831,11856,53.84435707
MD,Somerset ,2016,0,25839,13891,11948,53.75982043
MD,Somerset ,2017,0,25896,13938,11958,53.82298424
MD,Somerset ,2018,0,25606,13833,11773,54.02249473
MD,Somerset ,2019,0,25616,13859,11757,54.10290443
MD,Talbot ,2015,0,37413,17760,19653,47.4701307
MD,Talbot ,2016,0,37135,17555,19580,47.27346169
MD,Talbot ,2017,0,37033,17532,19501,47.34156023
MD,Talbot ,2018,0,37074,17503,19571,47.21098344
MD,Talbot ,2019,0,37181,17598,19583,47.33062586
MD,Washington ,2015,0,149068,75733,73335,50.80433091
MD,Washington ,2016,0,149602,76124,73478,50.88434647
MD,Washington ,2017,0,150169,76378,73791,50.86136286
MD,Washington ,2018,0,150656,76638,74018,50.86953059
MD,Washington ,2019,0,151049,76858,74191,50.8828261
MD,Wicomico ,2015,0,101747,48415,53332,47.58371254
MD,Wicomico ,2016,0,102041,48488,53553,47.51815447
MD,Wicomico ,2017,0,102252,48484,53768,47.41618746
MD,Wicomico ,2018,0,103044,48864,54180,47.42051939
MD,Wicomico ,2019,0,103609,49035,54574,47.32696966
MD,Worcester ,2015,0,51456,25018,26438,48.62018035
MD,Worcester ,2016,0,51475,25064,26411,48.69159786
MD,Worcester ,2017,0,51659,25117,26542,48.62076308
MD,Worcester ,2018,0,51960,25212,26748,48.52193995
MD,Worcester ,2019,0,52276,25331,26945,48.45627056
MD,Baltimore city,2015,0,622522,292865,329657,47.04492371
MD,Baltimore city,2016,0,616226,289591,326635,46.99428456
MD,Baltimore city,2017,0,610481,286819,323662,46.98246137
MD,Baltimore city,2018,0,602443,282630,319813,46.9139819
MD,Baltimore city,2019,0,593490,278123,315367,46.86228917
MA,Barnstable ,2015,0,213877,102108,111769,47.74145888
MA,Barnstable ,2016,0,213559,102102,111457,47.80973876
MA,Barnstable ,2017,0,213581,102148,111433,47.82635159
MA,Barnstable ,2018,0,213471,102032,111439,47.79665622
MA,Barnstable ,2019,0,212990,101791,111199,47.79144561
MA,Berkshire ,2015,0,127858,61672,66186,48.23476044
MA,Berkshire ,2016,0,127067,61326,65741,48.26272754
MA,Berkshire ,2017,0,126353,61023,65330,48.29564791
MA,Berkshire ,2018,0,125901,60824,65077,48.3109745
MA,Berkshire ,2019,0,124944,60406,64538,48.34645921
MA,Bristol ,2015,0,556863,269891,286972,48.46631936
MA,Bristol ,2016,0,558070,270270,287800,48.4294085
MA,Bristol ,2017,0,560941,271702,289239,48.43682312
MA,Bristol ,2018,0,564092,272979,291113,48.39263808
MA,Bristol ,2019,0,565217,273426,291791,48.37540272
MA,Dukes ,2015,0,17274,8478,8796,49.07954151
MA,Dukes ,2016,0,17315,8475,8840,48.94600058
MA,Dukes ,2017,0,17311,8487,8824,49.02663047
MA,Dukes ,2018,0,17329,8536,8793,49.25846846
MA,Dukes ,2019,0,17332,8545,8787,49.30186937
MA,Essex ,2015,0,776865,374118,402747,48.15740187
MA,Essex ,2016,0,779847,375756,404091,48.18329749
MA,Essex ,2017,0,784453,378031,406422,48.19039509
MA,Essex ,2018,0,788183,379863,408320,48.19477203
MA,Essex ,2019,0,789034,380330,408704,48.20197862
MA,Franklin ,2015,0,70866,34586,36280,48.8047865
MA,Franklin ,2016,0,70622,34457,36165,48.79074509
MA,Franklin ,2017,0,70605,34457,36148,48.80249274
MA,Franklin ,2018,0,70611,34368,36243,48.67230318
MA,Franklin ,2019,0,70180,34171,36009,48.69051012
MA,Hampden ,2015,0,469113,226369,242744,48.25468491
MA,Hampden ,2016,0,467778,225852,241926,48.2818773
MA,Hampden ,2017,0,467705,226000,241705,48.32105708
MA,Hampden ,2018,0,468388,226214,242174,48.29628428
MA,Hampden ,2019,0,466372,225252,241120,48.29878295
MA,Hampshire ,2015,0,160709,75120,85589,46.74287065
MA,Hampshire ,2016,0,161404,75396,86008,46.71259696
MA,Hampshire ,2017,0,161077,75187,85890,46.67767589
MA,Hampshire ,2018,0,161139,75175,85964,46.65226916
MA,Hampshire ,2019,0,160830,75022,85808,46.64676988
MA,Middlesex ,2015,0,1585432,774383,811049,48.84365902
MA,Middlesex ,2016,0,1594664,779736,814928,48.89657006
MA,Middlesex ,2017,0,1603943,784386,819557,48.90360817
MA,Middlesex ,2018,0,1608470,787482,820988,48.9584512
MA,Middlesex ,2019,0,1611699,789545,822154,48.98836569
MA,Nantucket ,2015,0,10940,5589,5351,51.08775137
MA,Nantucket ,2016,0,11100,5664,5436,51.02702703
MA,Nantucket ,2017,0,11205,5741,5464,51.23605533
MA,Nantucket ,2018,0,11198,5747,5451,51.32166458
MA,Nantucket ,2019,0,11399,5856,5543,51.37292745
MA,Norfolk ,2015,0,694502,333239,361263,47.98243922
MA,Norfolk ,2016,0,697079,334698,362381,48.01435705
MA,Norfolk ,2017,0,700599,337007,363592,48.10269498
MA,Norfolk ,2018,0,703230,338455,364775,48.12863501
MA,Norfolk ,2019,0,706775,340263,366512,48.14304411
MA,Plymouth ,2015,0,509221,247479,261742,48.59952751
MA,Plymouth ,2016,0,512207,248865,263342,48.58680182
MA,Plymouth ,2017,0,515461,250338,265123,48.56584688
MA,Plymouth ,2018,0,518422,251815,266607,48.57336301
MA,Plymouth ,2019,0,521202,253241,267961,48.58787956
MA,Suffolk ,2015,0,782591,378500,404091,48.36498247
MA,Suffolk ,2016,0,792576,383435,409141,48.37832586
MA,Suffolk ,2017,0,800806,387245,413561,48.35690542
MA,Suffolk ,2018,0,803147,387505,415642,48.24832814
MA,Suffolk ,2019,0,803907,388110,415797,48.27797245
MA,Worcester ,2015,0,818117,403271,414846,49.29258285
MA,Worcester ,2016,0,820320,404481,415839,49.30770919
MA,Worcester ,2017,0,825749,407243,418506,49.3180131
MA,Worcester ,2018,0,829054,408715,420339,49.29896002
MA,Worcester ,2019,0,830622,409610,421012,49.31364688
MI,Alcona ,2015,0,10330,5214,5116,50.47434656
MI,Alcona ,2016,0,10360,5219,5141,50.37644788
MI,Alcona ,2017,0,10309,5201,5108,50.45106218
MI,Alcona ,2018,0,10360,5225,5135,50.43436293
MI,Alcona ,2019,0,10405,5233,5172,50.2931283
MI,Alger ,2015,0,9255,5097,4158,55.07293355
MI,Alger ,2016,0,9129,5032,4097,55.12104283
MI,Alger ,2017,0,9144,5056,4088,55.29308836
MI,Alger ,2018,0,9118,5055,4063,55.43978943
MI,Alger ,2019,0,9108,5035,4073,55.28107159
MI,Allegan ,2015,0,114112,56907,57205,49.86942653
MI,Allegan ,2016,0,114979,57365,57614,49.89171936
MI,Allegan ,2017,0,116368,58058,58310,49.89172281
MI,Allegan ,2018,0,117173,58511,58662,49.93556536
MI,Allegan ,2019,0,118081,59000,59081,49.96570151
MI,Alpena ,2015,0,28722,14164,14558,49.31411462
MI,Alpena ,2016,0,28663,14102,14561,49.19931619
MI,Alpena ,2017,0,28428,14008,14420,49.27536232
MI,Alpena ,2018,0,28384,13996,14388,49.30947012
MI,Alpena ,2019,0,28405,14033,14372,49.40327407
MI,Antrim ,2015,0,23035,11425,11610,49.59843716
MI,Antrim ,2016,0,23079,11472,11607,49.70752632
MI,Antrim ,2017,0,23270,11594,11676,49.82380748
MI,Antrim ,2018,0,23323,11606,11717,49.76203747
MI,Antrim ,2019,0,23324,11604,11720,49.7513291
MI,Arenac ,2015,0,15307,7748,7559,50.6173646
MI,Arenac ,2016,0,15138,7645,7493,50.50204783
MI,Arenac ,2017,0,15014,7549,7465,50.27973891
MI,Arenac ,2018,0,15008,7559,7449,50.36647122
MI,Arenac ,2019,0,14883,7494,7389,50.35275146
MI,Baraga ,2015,0,8585,4719,3866,54.96796738
MI,Baraga ,2016,0,8546,4713,3833,55.14860754
MI,Baraga ,2017,0,8441,4662,3779,55.23042294
MI,Baraga ,2018,0,8324,4583,3741,55.05766458
MI,Baraga ,2019,0,8209,4522,3687,55.08588135
MI,Barry ,2015,0,59426,29827,29599,50.19183522
MI,Barry ,2016,0,59810,30048,29762,50.23909045
MI,Barry ,2017,0,60682,30567,30115,50.37243334
MI,Barry ,2018,0,61231,30830,30401,50.35031275
MI,Barry ,2019,0,61550,31039,30511,50.42891958
MI,Bay ,2015,0,105237,51784,53453,49.20702795
MI,Bay ,2016,0,104411,51329,53082,49.16052906
MI,Bay ,2017,0,104045,51095,52950,49.1085588
MI,Bay ,2018,0,103702,50959,52743,49.13984301
MI,Bay ,2019,0,103126,50627,52499,49.09237244
MI,Benzie ,2015,0,17390,8603,8787,49.47096032
MI,Benzie ,2016,0,17534,8664,8870,49.41256986
MI,Benzie ,2017,0,17624,8741,8883,49.59714026
MI,Benzie ,2018,0,17761,8829,8932,49.71003885
MI,Benzie ,2019,0,17766,8864,8902,49.89305415
MI,Berrien ,2015,0,155022,75918,79104,48.97240392
MI,Berrien ,2016,0,154325,75528,78797,48.94087154
MI,Berrien ,2017,0,154128,75447,78681,48.950872
MI,Berrien ,2018,0,153790,75299,78491,48.96222121
MI,Berrien ,2019,0,153401,75042,78359,48.91884668
MI,Branch ,2015,0,43639,22493,21146,51.54334426
MI,Branch ,2016,0,43466,22417,21049,51.57364377
MI,Branch ,2017,0,43375,22407,20968,51.65878963
MI,Branch ,2018,0,43566,22486,21080,51.61364367
MI,Branch ,2019,0,43517,22524,20993,51.75908266
MI,Calhoun ,2015,0,134327,65622,68705,48.85242729
MI,Calhoun ,2016,0,134344,65746,68598,48.93854582
MI,Calhoun ,2017,0,134180,65644,68536,48.92234312
MI,Calhoun ,2018,0,134049,65615,68434,48.94851883
MI,Calhoun ,2019,0,134159,65760,68399,49.01646554
MI,Cass ,2015,0,51342,25692,25650,50.04090219
MI,Cass ,2016,0,51282,25666,25616,50.04875005
MI,Cass ,2017,0,51481,25820,25661,50.1544259
MI,Cass ,2018,0,51725,25986,25739,50.23876269
MI,Cass ,2019,0,51787,26021,25766,50.24620078
MI,Charlevoix ,2015,0,26210,12970,13240,49.48492942
MI,Charlevoix ,2016,0,26190,12926,13264,49.35471554
MI,Charlevoix ,2017,0,26212,12938,13274,49.35907218
MI,Charlevoix ,2018,0,26187,12959,13228,49.48638637
MI,Charlevoix ,2019,0,26143,12929,13214,49.45492101
MI,Cheboygan ,2015,0,25399,12681,12718,49.92716249
MI,Cheboygan ,2016,0,25455,12710,12745,49.93125123
MI,Cheboygan ,2017,0,25454,12686,12768,49.83892512
MI,Cheboygan ,2018,0,25504,12724,12780,49.8902133
MI,Cheboygan ,2019,0,25276,12616,12660,49.91296091
MI,Chippewa ,2015,0,37973,20957,17016,55.18921339
MI,Chippewa ,2016,0,37683,20792,16891,55.17607409
MI,Chippewa ,2017,0,37679,20807,16872,55.22174155
MI,Chippewa ,2018,0,37461,20614,16847,55.02789568
MI,Chippewa ,2019,0,37349,20705,16644,55.43655787
MI,Clare ,2015,0,30616,15224,15392,49.72563366
MI,Clare ,2016,0,30387,15138,15249,49.81735611
MI,Clare ,2017,0,30565,15268,15297,49.95256012
MI,Clare ,2018,0,30735,15356,15379,49.96258337
MI,Clare ,2019,0,30950,15480,15470,50.01615509
MI,Clinton ,2015,0,77009,38116,38893,49.49551351
MI,Clinton ,2016,0,77617,38360,39257,49.42216267
MI,Clinton ,2017,0,78506,38876,39630,49.51978193
MI,Clinton ,2018,0,79219,39175,40044,49.45152047
MI,Clinton ,2019,0,79595,39226,40369,49.28199007
MI,Crawford ,2015,0,13853,6954,6899,50.19851296
MI,Crawford ,2016,0,13768,6944,6824,50.43579314
MI,Crawford ,2017,0,13906,7010,6896,50.40989501
MI,Crawford ,2018,0,13905,7053,6852,50.7227616
MI,Crawford ,2019,0,14029,7162,6867,51.05139354
MI,Delta ,2015,0,36415,18052,18363,49.57297817
MI,Delta ,2016,0,36196,17983,18213,49.68228534
MI,Delta ,2017,0,35890,17833,18057,49.68793536
MI,Delta ,2018,0,35843,17811,18032,49.69171107
MI,Delta ,2019,0,35784,17774,18010,49.67024368
MI,Dickinson ,2015,0,25661,12791,12870,49.84606991
MI,Dickinson ,2016,0,25499,12710,12789,49.84509196
MI,Dickinson ,2017,0,25424,12664,12760,49.81120201
MI,Dickinson ,2018,0,25371,12706,12665,50.08080091
MI,Dickinson ,2019,0,25239,12694,12545,50.2951781
MI,Eaton ,2015,0,108661,53196,55465,48.95592715
MI,Eaton ,2016,0,109183,53471,55712,48.97374133
MI,Eaton ,2017,0,109456,53711,55745,49.07085952
MI,Eaton ,2018,0,109710,53940,55770,49.16598305
MI,Eaton ,2019,0,110268,54192,56076,49.14571771
MI,Emmet ,2015,0,32924,16211,16713,49.2376382
MI,Emmet ,2016,0,32875,16251,16624,49.43269962
MI,Emmet ,2017,0,33081,16342,16739,49.39995768
MI,Emmet ,2018,0,33225,16366,16859,49.25808879
MI,Emmet ,2019,0,33415,16510,16905,49.40894808
MI,Genesee ,2015,0,410461,198060,212401,48.2530618
MI,Genesee ,2016,0,408926,197369,211557,48.2652118
MI,Genesee ,2017,0,407488,196571,210917,48.23970276
MI,Genesee ,2018,0,406688,196190,210498,48.24091195
MI,Genesee ,2019,0,405813,195701,210112,48.22442849
MI,Gladwin ,2015,0,25227,12709,12518,50.37856265
MI,Gladwin ,2016,0,25154,12648,12506,50.28226127
MI,Gladwin ,2017,0,25241,12705,12536,50.33477279
MI,Gladwin ,2018,0,25326,12795,12531,50.52120351
MI,Gladwin ,2019,0,25449,12857,12592,50.52064914
MI,Gogebic ,2015,0,15536,8422,7114,54.20957775
MI,Gogebic ,2016,0,15340,8301,7039,54.11342894
MI,Gogebic ,2017,0,15340,8302,7038,54.11994785
MI,Gogebic ,2018,0,15116,8128,6988,53.77083885
MI,Gogebic ,2019,0,13975,7091,6884,50.74060823
MI,Grand Traverse ,2015,0,91541,45472,46069,49.67391661
MI,Grand Traverse ,2016,0,91957,45550,46407,49.53402134
MI,Grand Traverse ,2017,0,91791,45008,46783,49.03312961
MI,Grand Traverse ,2018,0,92530,45302,47228,48.95925646
MI,Grand Traverse ,2019,0,93088,45499,47589,48.87740633
MI,Gratiot ,2015,0,41331,22054,19277,53.35946384
MI,Gratiot ,2016,0,40955,21854,19101,53.36100598
MI,Gratiot ,2017,0,40979,21994,18985,53.67139266
MI,Gratiot ,2018,0,40602,21782,18820,53.64760357
MI,Gratiot ,2019,0,40711,21924,18787,53.85276707
MI,Hillsdale ,2015,0,45883,22888,22995,49.88339908
MI,Hillsdale ,2016,0,45773,22817,22956,49.84816376
MI,Hillsdale ,2017,0,45820,22808,23012,49.77738979
MI,Hillsdale ,2018,0,45702,22746,22956,49.77025075
MI,Hillsdale ,2019,0,45605,22750,22855,49.88488104
MI,Houghton ,2015,0,36228,19601,16627,54.10456001
MI,Houghton ,2016,0,36299,19619,16680,54.04832089
MI,Houghton ,2017,0,36198,19569,16629,54.06099785
MI,Houghton ,2018,0,35943,19454,16489,54.12458615
MI,Houghton ,2019,0,35684,19291,16393,54.06064343
MI,Huron ,2015,0,31763,15774,15989,49.6615559
MI,Huron ,2016,0,31486,15610,15876,49.57759004
MI,Huron ,2017,0,31306,15550,15756,49.67098959
MI,Huron ,2018,0,31211,15471,15740,49.56906219
MI,Huron ,2019,0,30981,15357,15624,49.56909073
MI,Ingham ,2015,0,287096,139614,147482,48.62972664
MI,Ingham ,2016,0,289804,141104,148700,48.68945908
MI,Ingham ,2017,0,292018,142221,149797,48.70281969
MI,Ingham ,2018,0,291612,142007,149605,48.69724154
MI,Ingham ,2019,0,292406,142456,149950,48.71856255
MI,Ionia ,2015,0,64056,34389,29667,53.68583739
MI,Ionia ,2016,0,64187,34519,29668,53.77880256
MI,Ionia ,2017,0,64284,34616,29668,53.84854707
MI,Ionia ,2018,0,64276,34491,29785,53.66077541
MI,Ionia ,2019,0,64697,34921,29776,53.97622765
MI,Iosco ,2015,0,25343,12570,12773,49.59949493
MI,Iosco ,2016,0,25284,12596,12688,49.81806676
MI,Iosco ,2017,0,25128,12517,12611,49.81295766
MI,Iosco ,2018,0,25103,12437,12666,49.54387922
MI,Iosco ,2019,0,25127,12469,12658,49.62391053
MI,Iron ,2015,0,11320,5591,5729,49.39045936
MI,Iron ,2016,0,11167,5532,5635,49.53881974
MI,Iron ,2017,0,11105,5513,5592,49.64430437
MI,Iron ,2018,0,11104,5524,5580,49.74783862
MI,Iron ,2019,0,11066,5520,5546,49.88252304
MI,Isabella ,2015,0,70767,34447,36320,48.67664307
MI,Isabella ,2016,0,71263,34731,36532,48.73637091
MI,Isabella ,2017,0,71077,34632,36445,48.72462259
MI,Isabella ,2018,0,70463,34289,36174,48.66241857
MI,Isabella ,2019,0,69872,33961,35911,48.60459125
MI,Jackson ,2015,0,159264,81411,77853,51.11701326
MI,Jackson ,2016,0,158277,80910,77367,51.11924032
MI,Jackson ,2017,0,158563,80983,77580,51.07307506
MI,Jackson ,2018,0,158566,81029,77537,51.10111878
MI,Jackson ,2019,0,158510,81003,77507,51.10276954
MI,Kalamazoo ,2015,0,259676,127304,132372,49.02416858
MI,Kalamazoo ,2016,0,261304,127927,133377,48.95715335
MI,Kalamazoo ,2017,0,262998,128626,134372,48.90759626
MI,Kalamazoo ,2018,0,264680,129503,135177,48.92813964
MI,Kalamazoo ,2019,0,265066,129606,135460,48.89574672
MI,Kalkaska ,2015,0,17248,8783,8465,50.92184601
MI,Kalkaska ,2016,0,17263,8803,8460,50.99345421
MI,Kalkaska ,2017,0,17571,8995,8576,51.1923055
MI,Kalkaska ,2018,0,17806,9115,8691,51.19060991
MI,Kalkaska ,2019,0,18038,9220,8818,51.11431423
MI,Kent ,2015,0,637164,313515,323649,49.20475733
MI,Kent ,2016,0,643858,317248,326610,49.27297634
MI,Kent ,2017,0,649278,320198,329080,49.31600948
MI,Kent ,2018,0,653350,322034,331316,49.28966098
MI,Kent ,2019,0,656955,324063,332892,49.32803617
MI,Keweenaw ,2015,0,2123,1106,1017,52.09609044
MI,Keweenaw ,2016,0,2139,1106,1033,51.70640486
MI,Keweenaw ,2017,0,2085,1078,1007,51.70263789
MI,Keweenaw ,2018,0,2090,1079,1011,51.62679426
MI,Keweenaw ,2019,0,2116,1082,1034,51.1342155
MI,Lake ,2015,0,11697,6022,5675,51.48328631
MI,Lake ,2016,0,11853,6108,5745,51.53125791
MI,Lake ,2017,0,11981,6168,5813,51.48151239
MI,Lake ,2018,0,11876,6061,5815,51.03570226
MI,Lake ,2019,0,11853,5988,5865,50.51885599
MI,Lapeer ,2015,0,88368,44718,43650,50.60429115
MI,Lapeer ,2016,0,88171,44661,43510,50.65270894
MI,Lapeer ,2017,0,88122,44684,43438,50.70697442
MI,Lapeer ,2018,0,87921,44569,43352,50.69209859
MI,Lapeer ,2019,0,87607,44424,43183,50.70827674
MI,Leelanau ,2015,0,21633,10637,10996,49.17024916
MI,Leelanau ,2016,0,21507,10584,10923,49.2118845
MI,Leelanau ,2017,0,21645,10663,10982,49.26310926
MI,Leelanau ,2018,0,21714,10719,10995,49.36446532
MI,Leelanau ,2019,0,21761,10721,11040,49.26703736
MI,Lenawee ,2015,0,98391,49773,48618,50.58694393
MI,Lenawee ,2016,0,98496,49808,48688,50.56855101
MI,Lenawee ,2017,0,98427,49741,48686,50.53593018
MI,Lenawee ,2018,0,98141,49536,48605,50.47431756
MI,Lenawee ,2019,0,98451,49712,48739,50.49415445
MI,Livingston ,2015,0,187171,93837,93334,50.13436911
MI,Livingston ,2016,0,188547,94469,94078,50.10368767
MI,Livingston ,2017,0,189869,95147,94722,50.11191927
MI,Livingston ,2018,0,191190,95845,95345,50.13075998
MI,Livingston ,2019,0,191995,96195,95800,50.10286726
MI,Luce ,2015,0,6430,3770,2660,58.63141524
MI,Luce ,2016,0,6335,3696,2639,58.34254144
MI,Luce ,2017,0,6370,3760,2610,59.0266876
MI,Luce ,2018,0,6327,3731,2596,58.96949581
MI,Luce ,2019,0,6229,3710,2519,59.56012201
MI,Mackinac ,2015,0,10821,5517,5304,50.98419739
MI,Mackinac ,2016,0,10724,5451,5273,50.82991421
MI,Mackinac ,2017,0,10768,5469,5299,50.78937593
MI,Mackinac ,2018,0,10781,5492,5289,50.94147111
MI,Mackinac ,2019,0,10799,5487,5312,50.81026021
MI,Macomb ,2015,0,864960,421117,443843,48.68629763
MI,Macomb ,2016,0,868534,422575,445959,48.65382357
MI,Macomb ,2017,0,871364,424160,447204,48.6777053
MI,Macomb ,2018,0,872795,424798,447997,48.67099376
MI,Macomb ,2019,0,873972,425615,448357,48.69892857
MI,Manistee ,2015,0,24457,12685,11772,51.86654128
MI,Manistee ,2016,0,24424,12657,11767,51.82197838
MI,Manistee ,2017,0,24393,12563,11830,51.50248022
MI,Manistee ,2018,0,24455,12640,11815,51.68677162
MI,Manistee ,2019,0,24558,12662,11896,51.55957326
MI,Marquette ,2015,0,67326,33994,33332,50.4916377
MI,Marquette ,2016,0,66532,33540,32992,50.4118319
MI,Marquette ,2017,0,66493,33404,33089,50.23686704
MI,Marquette ,2018,0,66381,33308,33073,50.17700848
MI,Marquette ,2019,0,66699,33570,33129,50.33058966
MI,Mason ,2015,0,28738,14345,14393,49.91648688
MI,Mason ,2016,0,28810,14367,14443,49.86810135
MI,Mason ,2017,0,28996,14416,14580,49.71720237
MI,Mason ,2018,0,29084,14430,14654,49.61490854
MI,Mason ,2019,0,29144,14439,14705,49.54364535
MI,Mecosta ,2015,0,43005,21612,21393,50.25462156
MI,Mecosta ,2016,0,43141,21623,21518,50.12169398
MI,Mecosta ,2017,0,43258,21739,21519,50.25428822
MI,Mecosta ,2018,0,43400,21832,21568,50.30414747
MI,Mecosta ,2019,0,43453,21857,21596,50.30032449
MI,Menominee ,2015,0,23476,11913,11563,50.74544215
MI,Menominee ,2016,0,23208,11802,11406,50.85315408
MI,Menominee ,2017,0,22981,11696,11285,50.89421696
MI,Menominee ,2018,0,22927,11640,11287,50.76983469
MI,Menominee ,2019,0,22780,11547,11233,50.68920105
MI,Midland ,2015,0,83662,41179,42483,49.22067366
MI,Midland ,2016,0,83422,41117,42305,49.28795761
MI,Midland ,2017,0,83314,41084,42230,49.31224044
MI,Midland ,2018,0,83223,41128,42095,49.4190308
MI,Midland ,2019,0,83156,41170,41986,49.50935591
MI,Missaukee ,2015,0,14882,7581,7301,50.94073377
MI,Missaukee ,2016,0,15018,7672,7346,51.08536423
MI,Missaukee ,2017,0,15020,7623,7397,50.75233023
MI,Missaukee ,2018,0,15101,7653,7448,50.678763
MI,Missaukee ,2019,0,15118,7620,7498,50.40349253
MI,Monroe ,2015,0,149353,73733,75620,49.36827516
MI,Monroe ,2016,0,149159,73660,75499,49.38354374
MI,Monroe ,2017,0,149449,73761,75688,49.35529846
MI,Monroe ,2018,0,150174,74137,76037,49.36740048
MI,Monroe ,2019,0,150500,74308,76192,49.37408638
MI,Montcalm ,2015,0,62763,32368,30395,51.57178592
MI,Montcalm ,2016,0,62953,32430,30523,51.51462202
MI,Montcalm ,2017,0,63527,32758,30769,51.5654761
MI,Montcalm ,2018,0,63936,33039,30897,51.67511261
MI,Montcalm ,2019,0,63888,33022,30866,51.68732782
MI,Montmorency ,2015,0,9287,4709,4578,50.70528696
MI,Montmorency ,2016,0,9203,4661,4542,50.64652831
MI,Montmorency ,2017,0,9233,4670,4563,50.5794433
MI,Montmorency ,2018,0,9275,4729,4546,50.98652291
MI,Montmorency ,2019,0,9328,4765,4563,51.08276158
MI,Muskegon ,2015,0,172447,85691,86756,49.69120947
MI,Muskegon ,2016,0,173227,86040,87187,49.66893152
MI,Muskegon ,2017,0,173645,86423,87222,49.76993291
MI,Muskegon ,2018,0,173599,86233,87366,49.67367324
MI,Muskegon ,2019,0,173566,85950,87616,49.52006729
MI,Newaygo ,2015,0,47882,24045,23837,50.21720062
MI,Newaygo ,2016,0,47811,23985,23826,50.16627973
MI,Newaygo ,2017,0,48320,24271,24049,50.22971854
MI,Newaygo ,2018,0,48839,24523,24316,50.2119208
MI,Newaygo ,2019,0,48980,24658,24322,50.34299714
MI,Oakland ,2015,0,1244602,606590,638012,48.73766875
MI,Oakland ,2016,0,1251027,611061,639966,48.84474915
MI,Oakland ,2017,0,1256016,614728,641288,48.94268863
MI,Oakland ,2018,0,1256694,615768,640926,48.99904034
MI,Oakland ,2019,0,1257584,616754,640830,49.04276772
MI,Oceana ,2015,0,26323,13292,13031,50.49576416
MI,Oceana ,2016,0,26311,13290,13021,50.51119304
MI,Oceana ,2017,0,26422,13343,13079,50.49958368
MI,Oceana ,2018,0,26555,13446,13109,50.6345321
MI,Oceana ,2019,0,26467,13389,13078,50.58752409
MI,Ogemaw ,2015,0,20877,10334,10543,49.49944915
MI,Ogemaw ,2016,0,20850,10379,10471,49.7793765
MI,Ogemaw ,2017,0,20882,10384,10498,49.72703764
MI,Ogemaw ,2018,0,20882,10397,10485,49.78929221
MI,Ogemaw ,2019,0,20997,10464,10533,49.83569081
MI,Ontonagon ,2015,0,6037,3081,2956,51.03528243
MI,Ontonagon ,2016,0,5939,3018,2921,50.8166358
MI,Ontonagon ,2017,0,5889,3009,2880,51.09526235
MI,Ontonagon ,2018,0,5801,2962,2839,51.06016204
MI,Ontonagon ,2019,0,5720,2924,2796,51.11888112
MI,Osceola ,2015,0,23177,11668,11509,50.34301247
MI,Osceola ,2016,0,23170,11723,11447,50.59559776
MI,Osceola ,2017,0,23267,11748,11519,50.49211329
MI,Osceola ,2018,0,23377,11792,11585,50.44274287
MI,Osceola ,2019,0,23460,11801,11659,50.3026428
MI,Oscoda ,2015,0,8277,4210,4067,50.86383956
MI,Oscoda ,2016,0,8259,4207,4052,50.93837026
MI,Oscoda ,2017,0,8238,4179,4059,50.72833212
MI,Oscoda ,2018,0,8224,4208,4016,51.16731518
MI,Oscoda ,2019,0,8241,4210,4031,51.08603325
MI,Otsego ,2015,0,24203,12018,12185,49.65500145
MI,Otsego ,2016,0,24408,12109,12299,49.61078335
MI,Otsego ,2017,0,24528,12230,12298,49.86138291
MI,Otsego ,2018,0,24641,12262,12379,49.7625908
MI,Otsego ,2019,0,24668,12269,12399,49.73650073
MI,Ottawa ,2015,0,280859,138554,142305,49.3322272
MI,Ottawa ,2016,0,283712,140057,143655,49.36590627
MI,Ottawa ,2017,0,286581,141516,145065,49.38080333
MI,Ottawa ,2018,0,289808,143180,146628,49.40512339
MI,Ottawa ,2019,0,291830,144245,147585,49.42774903
MI,Presque Isle ,2015,0,12801,6382,6419,49.85548004
MI,Presque Isle ,2016,0,12735,6334,6401,49.73694543
MI,Presque Isle ,2017,0,12742,6331,6411,49.68607754
MI,Presque Isle ,2018,0,12698,6302,6396,49.62986297
MI,Presque Isle ,2019,0,12592,6268,6324,49.77763659
MI,Roscommon ,2015,0,23912,11919,11993,49.84526598
MI,Roscommon ,2016,0,23779,11854,11925,49.85070861
MI,Roscommon ,2017,0,23731,11818,11913,49.79983987
MI,Roscommon ,2018,0,23812,11914,11898,50.03359651
MI,Roscommon ,2019,0,24019,12036,11983,50.11032932
MI,Saginaw ,2015,0,193305,93755,99550,48.50107343
MI,Saginaw ,2016,0,192507,93492,99015,48.56550671
MI,Saginaw ,2017,0,191965,93253,98712,48.57812622
MI,Saginaw ,2018,0,190791,92663,98128,48.56780456
MI,Saginaw ,2019,0,190539,92577,97962,48.58690347
MI,St. Clair ,2015,0,159700,79201,80499,49.59361302
MI,St. Clair ,2016,0,159369,79142,80227,49.65959503
MI,St. Clair ,2017,0,159005,79056,79949,49.71919122
MI,St. Clair ,2018,0,159031,79044,79987,49.70351692
MI,St. Clair ,2019,0,159128,79111,80017,49.71532351
MI,St. Joseph ,2015,0,60804,30265,30539,49.77468588
MI,St. Joseph ,2016,0,60790,30269,30521,49.79272907
MI,St. Joseph ,2017,0,60710,30185,30525,49.71998023
MI,St. Joseph ,2018,0,60912,30374,30538,49.86537956
MI,St. Joseph ,2019,0,60964,30507,30457,50.04100781
MI,Sanilac ,2015,0,41464,20559,20905,49.5827706
MI,Sanilac ,2016,0,41405,20598,20807,49.74761502
MI,Sanilac ,2017,0,41242,20479,20763,49.6556908
MI,Sanilac ,2018,0,41192,20533,20659,49.84705768
MI,Sanilac ,2019,0,41170,20544,20626,49.90041292
MI,Schoolcraft ,2015,0,8121,3982,4139,49.03337027
MI,Schoolcraft ,2016,0,7967,3911,4056,49.08999623
MI,Schoolcraft ,2017,0,8013,3941,4072,49.18257831
MI,Schoolcraft ,2018,0,8044,3966,4078,49.30382894
MI,Schoolcraft ,2019,0,8094,3980,4114,49.17222634
MI,Shiawassee ,2015,0,68505,33858,34647,49.42412963
MI,Shiawassee ,2016,0,68542,33851,34691,49.38723702
MI,Shiawassee ,2017,0,68400,33818,34582,49.44152047
MI,Shiawassee ,2018,0,68133,33723,34410,49.49583902
MI,Shiawassee ,2019,0,68122,33783,34339,49.59190863
MI,Tuscola ,2015,0,53726,26969,26757,50.1972974
MI,Tuscola ,2016,0,53276,26751,26525,50.21210301
MI,Tuscola ,2017,0,52815,26528,26287,50.22815488
MI,Tuscola ,2018,0,52633,26449,26184,50.2517432
MI,Tuscola ,2019,0,52245,26284,25961,50.30912049
MI,Van Buren ,2015,0,75060,37309,37751,49.70556888
MI,Van Buren ,2016,0,75267,37434,37833,49.7349436
MI,Van Buren ,2017,0,75303,37357,37946,49.60891332
MI,Van Buren ,2018,0,75481,37434,38047,49.59393755
MI,Van Buren ,2019,0,75677,37574,38103,49.65048826
MI,Washtenaw ,2015,0,362975,179827,183148,49.54253048
MI,Washtenaw ,2016,0,366135,181464,184671,49.56204679
MI,Washtenaw ,2017,0,368807,182848,185959,49.57823469
MI,Washtenaw ,2018,0,369483,183195,186288,49.58144218
MI,Washtenaw ,2019,0,367601,182191,185410,49.56216115
MI,Wayne ,2015,0,1764872,848886,915986,48.09901228
MI,Wayne ,2016,0,1760612,847781,912831,48.15263102
MI,Wayne ,2017,0,1757217,846541,910676,48.17509733
MI,Wayne ,2018,0,1754453,845185,909268,48.17370428
MI,Wayne ,2019,0,1749343,842466,906877,48.15899455
MI,Wexford ,2015,0,32889,16423,16466,49.9346286
MI,Wexford ,2016,0,33081,16507,16574,49.89873341
MI,Wexford ,2017,0,33234,16619,16615,50.00601793
MI,Wexford ,2018,0,33446,16751,16695,50.08371704
MI,Wexford ,2019,0,33631,16874,16757,50.17394666
MN,Aitkin ,2015,0,15852,8031,7821,50.66237699
MN,Aitkin ,2016,0,15754,7959,7795,50.52050273
MN,Aitkin ,2017,0,15792,8003,7789,50.67755826
MN,Aitkin ,2018,0,15887,8037,7850,50.5885315
MN,Aitkin ,2019,0,15886,8030,7856,50.54765202
MN,Anoka ,2015,0,344176,172092,172084,50.0011622
MN,Anoka ,2016,0,346526,173361,173165,50.02828071
MN,Anoka ,2017,0,350203,175200,175003,50.02812654
MN,Anoka ,2018,0,353441,176831,176610,50.03126406
MN,Anoka ,2019,0,356921,178572,178349,50.03123941
MN,Becker ,2015,0,33445,16676,16769,49.86096576
MN,Becker ,2016,0,33718,16822,16896,49.89026633
MN,Becker ,2017,0,34082,17009,17073,49.9061088
MN,Becker ,2018,0,34389,17161,17228,49.90258513
MN,Becker ,2019,0,34423,17168,17255,49.873631
MN,Beltrami ,2015,0,45605,22764,22841,49.91557943
MN,Beltrami ,2016,0,46008,22913,23095,49.80220831
MN,Beltrami ,2017,0,46477,23200,23277,49.91716333
MN,Beltrami ,2018,0,46735,23352,23383,49.96683428
MN,Beltrami ,2019,0,47188,23563,23625,49.93430533
MN,Benton ,2015,0,39422,19794,19628,50.21054234
MN,Benton ,2016,0,39687,19941,19746,50.24567239
MN,Benton ,2017,0,40135,20104,20031,50.09094307
MN,Benton ,2018,0,40510,20210,20300,49.88891632
MN,Benton ,2019,0,40889,20435,20454,49.97676637
MN,Big Stone ,2015,0,4993,2469,2524,49.44922892
MN,Big Stone ,2016,0,5002,2469,2533,49.3602559
MN,Big Stone ,2017,0,5004,2503,2501,50.01998401
MN,Big Stone ,2018,0,4990,2494,2496,49.97995992
MN,Big Stone ,2019,0,4991,2494,2497,49.9699459
MN,Blue Earth ,2015,0,65673,33059,32614,50.33879981
MN,Blue Earth ,2016,0,66355,33464,32891,50.43176852
MN,Blue Earth ,2017,0,66916,33766,33150,50.46027856
MN,Blue Earth ,2018,0,67378,33906,33472,50.32206358
MN,Blue Earth ,2019,0,67653,34014,33639,50.27714957
MN,Brown ,2015,0,25240,12597,12643,49.9088748
MN,Brown ,2016,0,25272,12590,12682,49.81798037
MN,Brown ,2017,0,25172,12569,12603,49.93246464
MN,Brown ,2018,0,25125,12543,12582,49.92238806
MN,Brown ,2019,0,25008,12474,12534,49.88003839
MN,Carlton ,2015,0,35409,18563,16846,52.42452484
MN,Carlton ,2016,0,35555,18618,16937,52.36394319
MN,Carlton ,2017,0,35509,18552,16957,52.24590949
MN,Carlton ,2018,0,35822,18696,17126,52.19139077
MN,Carlton ,2019,0,35871,18739,17132,52.23997101
MN,Carver ,2015,0,98630,49037,49593,49.7181385
MN,Carver ,2016,0,100374,49802,50572,49.61643453
MN,Carver ,2017,0,102118,50679,51439,49.62788147
MN,Carver ,2018,0,103533,51397,52136,49.64310896
MN,Carver ,2019,0,105089,52197,52892,49.6693279
MN,Cass ,2015,0,28698,14651,14047,51.05233814
MN,Cass ,2016,0,29030,14831,14199,51.08852911
MN,Cass ,2017,0,29324,14954,14370,50.99577138
MN,Cass ,2018,0,29511,15067,14444,51.05553861
MN,Cass ,2019,0,29779,15223,14556,51.11991672
MN,Chippewa ,2015,0,12084,5955,6129,49.28003972
MN,Chippewa ,2016,0,12036,5957,6079,49.49318711
MN,Chippewa ,2017,0,11944,5936,6008,49.69859344
MN,Chippewa ,2018,0,11901,5963,5938,50.10503319
MN,Chippewa ,2019,0,11800,5916,5884,50.13559322
MN,Chisago ,2015,0,54129,27984,26145,51.69871973
MN,Chisago ,2016,0,54638,28307,26331,51.80826531
MN,Chisago ,2017,0,55257,28567,26690,51.69842735
MN,Chisago ,2018,0,55972,28884,27088,51.60437362
MN,Chisago ,2019,0,56579,29136,27443,51.49613814
MN,Clay ,2015,0,62169,30619,31550,49.25123454
MN,Clay ,2016,0,63055,31145,31910,49.39338673
MN,Clay ,2017,0,63766,31556,32210,49.48718753
MN,Clay ,2018,0,64017,31727,32290,49.56027305
MN,Clay ,2019,0,64222,31849,32373,49.59204011
MN,Clearwater ,2015,0,8797,4447,4350,50.55132432
MN,Clearwater ,2016,0,8831,4490,4341,50.84361907
MN,Clearwater ,2017,0,8845,4492,4353,50.78575466
MN,Clearwater ,2018,0,8815,4492,4323,50.95859331
MN,Clearwater ,2019,0,8818,4484,4334,50.850533
MN,Cook ,2015,0,5245,2626,2619,50.06673022
MN,Cook ,2016,0,5338,2665,2673,49.92506557
MN,Cook ,2017,0,5411,2693,2718,49.7689891
MN,Cook ,2018,0,5425,2714,2711,50.02764977
MN,Cook ,2019,0,5463,2728,2735,49.93593264
MN,Cottonwood ,2015,0,11422,5656,5766,49.51847312
MN,Cottonwood ,2016,0,11367,5662,5705,49.81085599
MN,Cottonwood ,2017,0,11249,5594,5655,49.72886479
MN,Cottonwood ,2018,0,11259,5627,5632,49.97779554
MN,Cottonwood ,2019,0,11196,5611,5585,50.1161129
MN,Crow Wing ,2015,0,63229,31474,31755,49.77779184
MN,Crow Wing ,2016,0,63729,31758,31971,49.83288613
MN,Crow Wing ,2017,0,64278,32013,32265,49.80397648
MN,Crow Wing ,2018,0,64794,32209,32585,49.70984968
MN,Crow Wing ,2019,0,65055,32328,32727,49.69333641
MN,Dakota ,2015,0,414131,203720,210411,49.19216383
MN,Dakota ,2016,0,417555,205565,211990,49.23064027
MN,Dakota ,2017,0,421518,207873,213645,49.31533173
MN,Dakota ,2018,0,425040,209771,215269,49.35323734
MN,Dakota ,2019,0,429021,211756,217265,49.35795684
MN,Dodge ,2015,0,20410,10224,10186,50.09309162
MN,Dodge ,2016,0,20540,10286,10254,50.07789679
MN,Dodge ,2017,0,20696,10369,10327,50.10146888
MN,Dodge ,2018,0,20767,10395,10372,50.05537632
MN,Dodge ,2019,0,20934,10462,10472,49.97611541
MN,Douglas ,2015,0,36790,18403,18387,50.02174504
MN,Douglas ,2016,0,37154,18604,18550,50.07267051
MN,Douglas ,2017,0,37520,18731,18789,49.92270789
MN,Douglas ,2018,0,37960,18980,18980,50
MN,Douglas ,2019,0,38141,19072,19069,50.00393278
MN,Faribault ,2015,0,13981,6922,7059,49.51004935
MN,Faribault ,2016,0,13867,6897,6970,49.73678517
MN,Faribault ,2017,0,13768,6883,6885,49.99273678
MN,Faribault ,2018,0,13736,6866,6870,49.98543972
MN,Faribault ,2019,0,13653,6865,6788,50.28198931
MN,Fillmore ,2015,0,20739,10411,10328,50.20010608
MN,Fillmore ,2016,0,20916,10492,10424,50.16255498
MN,Fillmore ,2017,0,20980,10540,10440,50.23832221
MN,Fillmore ,2018,0,21044,10563,10481,50.19482988
MN,Fillmore ,2019,0,21067,10585,10482,50.24445816
MN,Freeborn ,2015,0,30522,15210,15312,49.83290741
MN,Freeborn ,2016,0,30449,15217,15232,49.97536865
MN,Freeborn ,2017,0,30582,15310,15272,50.06212805
MN,Freeborn ,2018,0,30480,15216,15264,49.92125984
MN,Freeborn ,2019,0,30281,15110,15171,49.89927677
MN,Goodhue ,2015,0,46060,22950,23110,49.8263135
MN,Goodhue ,2016,0,46226,23021,23205,49.8009778
MN,Goodhue ,2017,0,46307,23032,23275,49.73762066
MN,Goodhue ,2018,0,46299,22950,23349,49.56910516
MN,Goodhue ,2019,0,46340,22993,23347,49.61804057
MN,Grant ,2015,0,5867,2926,2941,49.87216635
MN,Grant ,2016,0,5930,2980,2950,50.2529511
MN,Grant ,2017,0,5916,2982,2934,50.40567951
MN,Grant ,2018,0,5989,3001,2988,50.10853231
MN,Grant ,2019,0,5972,3013,2959,50.45210985
MN,Hennepin ,2015,0,1222200,603242,618958,49.35706104
MN,Hennepin ,2016,0,1235371,610760,624611,49.43939918
MN,Hennepin ,2017,0,1247847,617177,630670,49.45934878
MN,Hennepin ,2018,0,1257925,622244,635681,49.46590615
MN,Hennepin ,2019,0,1265843,626750,639093,49.51245929
MN,Houston ,2015,0,18686,9301,9385,49.77523279
MN,Houston ,2016,0,18703,9347,9356,49.97593969
MN,Houston ,2017,0,18677,9365,9312,50.14188574
MN,Houston ,2018,0,18572,9320,9252,50.18307129
MN,Houston ,2019,0,18600,9339,9261,50.20967742
MN,Hubbard ,2015,0,20646,10391,10255,50.32936162
MN,Hubbard ,2016,0,20701,10477,10224,50.61108159
MN,Hubbard ,2017,0,20965,10620,10345,50.655855
MN,Hubbard ,2018,0,21291,10794,10497,50.69747781
MN,Hubbard ,2019,0,21491,10903,10588,50.73286492
MN,Isanti ,2015,0,38281,19378,18903,50.62041221
MN,Isanti ,2016,0,38778,19644,19134,50.65758935
MN,Isanti ,2017,0,39543,19968,19575,50.4969274
MN,Isanti ,2018,0,39950,20236,19714,50.65331665
MN,Isanti ,2019,0,40596,20483,20113,50.45570992
MN,Itasca ,2015,0,45267,22854,22413,50.48710982
MN,Itasca ,2016,0,45168,22855,22313,50.59998229
MN,Itasca ,2017,0,45088,22776,22312,50.51454933
MN,Itasca ,2018,0,45051,22761,22290,50.52274089
MN,Itasca ,2019,0,45130,22817,22313,50.55838688
MN,Jackson ,2015,0,10096,5141,4955,50.92115689
MN,Jackson ,2016,0,9968,5087,4881,51.03330658
MN,Jackson ,2017,0,9965,5092,4873,51.09884596
MN,Jackson ,2018,0,9895,5046,4849,50.99545225
MN,Jackson ,2019,0,9846,5056,4790,51.35080236
MN,Kanabec ,2015,0,15888,8054,7834,50.69234642
MN,Kanabec ,2016,0,15912,8064,7848,50.67873303
MN,Kanabec ,2017,0,16060,8131,7929,50.62889166
MN,Kanabec ,2018,0,16246,8172,8074,50.3016127
MN,Kanabec ,2019,0,16337,8219,8118,50.30911428
MN,Kandiyohi ,2015,0,42623,21390,21233,50.18417286
MN,Kandiyohi ,2016,0,42697,21440,21257,50.21430077
MN,Kandiyohi ,2017,0,42778,21482,21296,50.21740147
MN,Kandiyohi ,2018,0,42910,21592,21318,50.3192729
MN,Kandiyohi ,2019,0,43199,21766,21433,50.38542559
MN,Kittson ,2015,0,4409,2218,2191,50.30619188
MN,Kittson ,2016,0,4320,2166,2154,50.13888889
MN,Kittson ,2017,0,4261,2148,2113,50.41070171
MN,Kittson ,2018,0,4268,2138,2130,50.09372071
MN,Kittson ,2019,0,4298,2139,2159,49.76733364
MN,Koochiching ,2015,0,12797,6398,6399,49.99609283
MN,Koochiching ,2016,0,12610,6306,6304,50.00793021
MN,Koochiching ,2017,0,12506,6252,6254,49.99200384
MN,Koochiching ,2018,0,12431,6223,6208,50.06033304
MN,Koochiching ,2019,0,12229,6115,6114,50.00408864
MN,Lac qui Parle ,2015,0,6877,3454,3423,50.22538898
MN,Lac qui Parle ,2016,0,6746,3399,3347,50.38541358
MN,Lac qui Parle ,2017,0,6683,3349,3334,50.11222505
MN,Lac qui Parle ,2018,0,6664,3351,3313,50.28511405
MN,Lac qui Parle ,2019,0,6623,3329,3294,50.26423071
MN,Lake ,2015,0,10541,5368,5173,50.92495968
MN,Lake ,2016,0,10514,5380,5134,51.16986875
MN,Lake ,2017,0,10493,5388,5105,51.34851806
MN,Lake ,2018,0,10610,5439,5171,51.26295947
MN,Lake ,2019,0,10641,5462,5179,51.32976224
MN,Lake of the Woods ,2015,0,3868,1987,1881,51.37021717
MN,Lake of the Woods ,2016,0,3781,1956,1825,51.73234594
MN,Lake of the Woods ,2017,0,3727,1940,1787,52.05258921
MN,Lake of the Woods ,2018,0,3737,1965,1772,52.58228526
MN,Lake of the Woods ,2019,0,3740,1964,1776,52.51336898
MN,Le Sueur ,2015,0,27755,13989,13766,50.40172942
MN,Le Sueur ,2016,0,27772,13973,13799,50.31326516
MN,Le Sueur ,2017,0,28210,14199,14011,50.33321517
MN,Le Sueur ,2018,0,28588,14414,14174,50.41975654
MN,Le Sueur ,2019,0,28887,14596,14291,50.52791913
MN,Lincoln ,2015,0,5710,2890,2820,50.61295972
MN,Lincoln ,2016,0,5703,2884,2819,50.5698755
MN,Lincoln ,2017,0,5665,2867,2798,50.60900265
MN,Lincoln ,2018,0,5668,2860,2808,50.4587156
MN,Lincoln ,2019,0,5639,2845,2794,50.45220784
MN,Lyon ,2015,0,25826,12850,12976,49.75605978
MN,Lyon ,2016,0,25971,12935,13036,49.80555235
MN,Lyon ,2017,0,25929,12948,12981,49.93636469
MN,Lyon ,2018,0,25583,12757,12826,49.86514482
MN,Lyon ,2019,0,25474,12720,12754,49.93326529
MN,McLeod ,2015,0,35814,17843,17971,49.82129893
MN,McLeod ,2016,0,35749,17832,17917,49.88111556
MN,McLeod ,2017,0,35876,17942,17934,50.01114951
MN,McLeod ,2018,0,35827,17932,17895,50.05163703
MN,McLeod ,2019,0,35893,17942,17951,49.98746274
MN,Mahnomen ,2015,0,5432,2718,2714,50.03681885
MN,Mahnomen ,2016,0,5484,2750,2734,50.14587892
MN,Mahnomen ,2017,0,5567,2803,2764,50.35027843
MN,Mahnomen ,2018,0,5497,2782,2715,50.60942332
MN,Mahnomen ,2019,0,5527,2797,2730,50.60611543
MN,Marshall ,2015,0,9409,4775,4634,50.7492826
MN,Marshall ,2016,0,9369,4741,4628,50.60305262
MN,Marshall ,2017,0,9361,4724,4637,50.46469394
MN,Marshall ,2018,0,9383,4736,4647,50.47426196
MN,Marshall ,2019,0,9336,4696,4640,50.29991431
MN,Martin ,2015,0,20036,9919,10117,49.5058894
MN,Martin ,2016,0,19904,9841,10063,49.44232315
MN,Martin ,2017,0,19866,9852,10014,49.5922682
MN,Martin ,2018,0,19772,9800,9972,49.56504147
MN,Martin ,2019,0,19683,9749,9934,49.53005131
MN,Meeker ,2015,0,23045,11702,11343,50.77891083
MN,Meeker ,2016,0,23064,11730,11334,50.85848075
MN,Meeker ,2017,0,23047,11731,11316,50.9003341
MN,Meeker ,2018,0,23145,11788,11357,50.93108663
MN,Meeker ,2019,0,23222,11801,11421,50.81818965
MN,Mille Lacs ,2015,0,25494,12794,12700,50.1843571
MN,Mille Lacs ,2016,0,25594,12872,12722,50.29303743
MN,Mille Lacs ,2017,0,25861,13000,12861,50.26874444
MN,Mille Lacs ,2018,0,26100,13109,12991,50.22605364
MN,Mille Lacs ,2019,0,26277,13230,13047,50.34821327
MN,Morrison ,2015,0,32775,16574,16201,50.56903127
MN,Morrison ,2016,0,32918,16575,16343,50.35239079
MN,Morrison ,2017,0,33084,16699,16385,50.47454963
MN,Morrison ,2018,0,33158,16735,16423,50.4704747
MN,Morrison ,2019,0,33386,16812,16574,50.35643683
MN,Mower ,2015,0,39492,19811,19681,50.1645903
MN,Mower ,2016,0,39567,19835,19732,50.13015897
MN,Mower ,2017,0,39773,19977,19796,50.2275413
MN,Mower ,2018,0,40142,20182,19960,50.27651836
MN,Mower ,2019,0,40062,20138,19924,50.26708602
MN,Murray ,2015,0,8394,4179,4215,49.78556112
MN,Murray ,2016,0,8305,4132,4173,49.75316075
MN,Murray ,2017,0,8332,4174,4158,50.09601536
MN,Murray ,2018,0,8254,4131,4123,50.04846135
MN,Murray ,2019,0,8194,4104,4090,50.08542836
MN,Nicollet ,2015,0,33526,16913,16613,50.44741395
MN,Nicollet ,2016,0,33720,17012,16708,50.45077106
MN,Nicollet ,2017,0,34052,17212,16840,50.54622342
MN,Nicollet ,2018,0,34199,17287,16912,50.54826165
MN,Nicollet ,2019,0,34274,17271,17003,50.39096691
MN,Nobles ,2015,0,21748,11250,10498,51.72889461
MN,Nobles ,2016,0,21878,11248,10630,51.41237773
MN,Nobles ,2017,0,21671,11122,10549,51.32204328
MN,Nobles ,2018,0,21744,11193,10551,51.47626932
MN,Nobles ,2019,0,21629,11144,10485,51.52341763
MN,Norman ,2015,0,6621,3342,3279,50.47575895
MN,Norman ,2016,0,6534,3287,3247,50.30609122
MN,Norman ,2017,0,6589,3322,3267,50.41736227
MN,Norman ,2018,0,6479,3257,3222,50.27010341
MN,Norman ,2019,0,6375,3189,3186,50.02352941
MN,Olmsted ,2015,0,151397,73989,77408,48.87084949
MN,Olmsted ,2016,0,153272,74838,78434,48.82692207
MN,Olmsted ,2017,0,154727,75518,79209,48.80725407
MN,Olmsted ,2018,0,156358,76376,79982,48.84687704
MN,Olmsted ,2019,0,158293,77275,81018,48.81769882
MN,Otter Tail ,2015,0,57520,28996,28524,50.41029207
MN,Otter Tail ,2016,0,57820,29113,28707,50.35108959
MN,Otter Tail ,2017,0,58219,29341,28878,50.39763651
MN,Otter Tail ,2018,0,58670,29539,29131,50.34770752
MN,Otter Tail ,2019,0,58746,29563,29183,50.32342628
MN,Pennington ,2015,0,14237,7110,7127,49.94029641
MN,Pennington ,2016,0,14206,7087,7119,49.88737153
MN,Pennington ,2017,0,14178,7029,7149,49.57680914
MN,Pennington ,2018,0,14173,7017,7156,49.50963099
MN,Pennington ,2019,0,14119,7015,7104,49.68482187
MN,Pine ,2015,0,29045,15512,13533,53.40678258
MN,Pine ,2016,0,28866,15422,13444,53.42617612
MN,Pine ,2017,0,29159,15602,13557,53.50663603
MN,Pine ,2018,0,29468,15840,13628,53.75322384
MN,Pine ,2019,0,29579,15853,13726,53.59545624
MN,Pipestone ,2015,0,9295,4518,4777,48.60677784
MN,Pipestone ,2016,0,9248,4524,4724,48.91868512
MN,Pipestone ,2017,0,9157,4459,4698,48.69498744
MN,Pipestone ,2018,0,9127,4449,4678,48.74548044
MN,Pipestone ,2019,0,9126,4468,4658,48.95901819
MN,Polk ,2015,0,31497,15823,15674,50.23653046
MN,Polk ,2016,0,31698,15930,15768,50.25553663
MN,Polk ,2017,0,31637,15883,15754,50.20387521
MN,Polk ,2018,0,31411,15772,15639,50.21170927
MN,Polk ,2019,0,31364,15790,15574,50.34434383
MN,Pope ,2015,0,10936,5561,5375,50.85040234
MN,Pope ,2016,0,10970,5599,5371,51.03919781
MN,Pope ,2017,0,10988,5617,5371,51.11940299
MN,Pope ,2018,0,11095,5662,5433,51.03199639
MN,Pope ,2019,0,11249,5735,5514,50.98230954
MN,Ramsey ,2015,0,536631,261110,275521,48.65727101
MN,Ramsey ,2016,0,541502,263699,277803,48.69769641
MN,Ramsey ,2017,0,544886,265581,279305,48.74065401
MN,Ramsey ,2018,0,548872,267913,280959,48.81156262
MN,Ramsey ,2019,0,550321,268768,281553,48.83840522
MN,Red Lake ,2015,0,4031,2028,2003,50.31009675
MN,Red Lake ,2016,0,3987,2023,1964,50.73990469
MN,Red Lake ,2017,0,4009,2036,1973,50.7857321
MN,Red Lake ,2018,0,3992,2034,1958,50.95190381
MN,Red Lake ,2019,0,4055,2079,1976,51.27003699
MN,Redwood ,2015,0,15425,7668,7757,49.71150729
MN,Redwood ,2016,0,15216,7584,7632,49.84227129
MN,Redwood ,2017,0,15244,7597,7647,49.83600105
MN,Redwood ,2018,0,15252,7610,7642,49.89509573
MN,Redwood ,2019,0,15170,7573,7597,49.92089651
MN,Renville ,2015,0,14798,7550,7248,51.02040816
MN,Renville ,2016,0,14613,7420,7193,50.77670567
MN,Renville ,2017,0,14693,7463,7230,50.79289458
MN,Renville ,2018,0,14609,7411,7198,50.72900267
MN,Renville ,2019,0,14548,7420,7128,51.00357437
MN,Rice ,2015,0,65323,33365,31958,51.07695605
MN,Rice ,2016,0,65868,33569,32299,50.96404931
MN,Rice ,2017,0,66196,33733,32463,50.95927246
MN,Rice ,2018,0,66566,33951,32615,51.00351531
MN,Rice ,2019,0,66972,34235,32737,51.11837783
MN,Rock ,2015,0,9442,4633,4809,49.06799407
MN,Rock ,2016,0,9392,4638,4754,49.38245315
MN,Rock ,2017,0,9459,4651,4808,49.17010255
MN,Rock ,2018,0,9401,4618,4783,49.12243378
MN,Rock ,2019,0,9315,4610,4705,49.49006978
MN,Roseau ,2015,0,15621,8011,7610,51.28352858
MN,Roseau ,2016,0,15557,8001,7556,51.43022434
MN,Roseau ,2017,0,15305,7869,7436,51.4145704
MN,Roseau ,2018,0,15158,7791,7367,51.3986014
MN,Roseau ,2019,0,15165,7813,7352,51.51994725
MN,St. Louis ,2015,0,200296,100639,99657,50.2451372
MN,St. Louis ,2016,0,199967,100268,99699,50.14227348
MN,St. Louis ,2017,0,199778,100080,99698,50.09560612
MN,St. Louis ,2018,0,199685,100222,99463,50.19004933
MN,St. Louis ,2019,0,199070,99714,99356,50.08991812
MN,Scott ,2015,0,141329,70499,70830,49.88289735
MN,Scott ,2016,0,143309,71438,71871,49.84892784
MN,Scott ,2017,0,145535,72519,73016,49.8292507
MN,Scott ,2018,0,147191,73403,73788,49.86921755
MN,Scott ,2019,0,149013,74199,74814,49.79364217
MN,Sherburne ,2015,0,91415,46820,44595,51.21697752
MN,Sherburne ,2016,0,93228,47837,45391,51.31183765
MN,Sherburne ,2017,0,94476,48469,46007,51.30297642
MN,Sherburne ,2018,0,95957,49152,46805,51.22294361
MN,Sherburne ,2019,0,97238,49861,47377,51.27727843
MN,Sibley ,2015,0,14889,7511,7378,50.44663846
MN,Sibley ,2016,0,14812,7473,7339,50.45233594
MN,Sibley ,2017,0,14899,7501,7398,50.34566078
MN,Sibley ,2018,0,14997,7560,7437,50.41008202
MN,Sibley ,2019,0,14865,7512,7353,50.53481332
MN,Stearns ,2015,0,156003,78564,77439,50.36056999
MN,Stearns ,2016,0,157225,79212,78013,50.38130068
MN,Stearns ,2017,0,158301,79838,78463,50.43429921
MN,Stearns ,2018,0,159656,80491,79165,50.41526783
MN,Stearns ,2019,0,161075,81127,79948,50.36597858
MN,Steele ,2015,0,36599,18147,18452,49.58332195
MN,Steele ,2016,0,36644,18183,18461,49.6206746
MN,Steele ,2017,0,36787,18265,18522,49.65069182
MN,Steele ,2018,0,36738,18281,18457,49.760466
MN,Steele ,2019,0,36649,18252,18397,49.80217741
MN,Stevens ,2015,0,9874,4969,4905,50.32408345
MN,Stevens ,2016,0,9810,4910,4900,50.0509684
MN,Stevens ,2017,0,9706,4857,4849,50.04121162
MN,Stevens ,2018,0,9752,4865,4887,49.88720263
MN,Stevens ,2019,0,9805,4899,4906,49.96430393
MN,Swift ,2015,0,9376,4745,4631,50.60793515
MN,Swift ,2016,0,9442,4758,4684,50.39186613
MN,Swift ,2017,0,9387,4707,4680,50.14381592
MN,Swift ,2018,0,9323,4689,4634,50.29496943
MN,Swift ,2019,0,9266,4660,4606,50.29138787
MN,Todd ,2015,0,24328,12458,11870,51.20848405
MN,Todd ,2016,0,24381,12543,11838,51.44579796
MN,Todd ,2017,0,24526,12613,11913,51.427057
MN,Todd ,2018,0,24570,12671,11899,51.57102157
MN,Todd ,2019,0,24664,12755,11909,51.71505028
MN,Traverse ,2015,0,3373,1694,1679,50.22235399
MN,Traverse ,2016,0,3330,1673,1657,50.24024024
MN,Traverse ,2017,0,3304,1657,1647,50.15133172
MN,Traverse ,2018,0,3291,1660,1631,50.44059556
MN,Traverse ,2019,0,3259,1653,1606,50.72108009
MN,Wabasha ,2015,0,21387,10667,10720,49.87609295
MN,Wabasha ,2016,0,21435,10697,10738,49.90436202
MN,Wabasha ,2017,0,21590,10808,10782,50.06021306
MN,Wabasha ,2018,0,21645,10851,10794,50.13167013
MN,Wabasha ,2019,0,21627,10850,10777,50.16877052
MN,Wadena ,2015,0,13667,6801,6866,49.76220092
MN,Wadena ,2016,0,13550,6718,6832,49.57933579
MN,Wadena ,2017,0,13647,6767,6880,49.58598959
MN,Wadena ,2018,0,13723,6800,6923,49.55184726
MN,Wadena ,2019,0,13682,6785,6897,49.59070311
MN,Waseca ,2015,0,18926,8934,9992,47.20490331
MN,Waseca ,2016,0,18783,8953,9830,47.66544216
MN,Waseca ,2017,0,18713,8975,9738,47.96131032
MN,Waseca ,2018,0,18664,9000,9664,48.22117445
MN,Waseca ,2019,0,18612,9003,9609,48.37201805
MN,Washington ,2015,0,250386,123895,126491,49.48160041
MN,Washington ,2016,0,252502,124762,127740,49.4103017
MN,Washington ,2017,0,255464,126279,129185,49.43123101
MN,Washington ,2018,0,258899,127922,130977,49.41000158
MN,Washington ,2019,0,262440,129680,132760,49.41319921
MN,Watonwan ,2015,0,11018,5461,5557,49.56434925
MN,Watonwan ,2016,0,11002,5449,5553,49.52735866
MN,Watonwan ,2017,0,10934,5409,5525,49.46954454
MN,Watonwan ,2018,0,11007,5447,5560,49.48669029
MN,Watonwan ,2019,0,10897,5387,5510,49.43562448
MN,Wilkin ,2015,0,6357,3251,3106,51.14047507
MN,Wilkin ,2016,0,6323,3250,3073,51.39965206
MN,Wilkin ,2017,0,6322,3269,3053,51.70832015
MN,Wilkin ,2018,0,6244,3233,3011,51.7777066
MN,Wilkin ,2019,0,6207,3230,2977,52.03802159
MN,Winona ,2015,0,50827,25256,25571,49.69012533
MN,Winona ,2016,0,50861,25230,25631,49.60578833
MN,Winona ,2017,0,50718,25156,25562,49.59974762
MN,Winona ,2018,0,50735,25109,25626,49.4904898
MN,Winona ,2019,0,50484,24989,25495,49.49885112
MN,Wright ,2015,0,130973,65945,65028,50.35007215
MN,Wright ,2016,0,132324,66719,65605,50.42093649
MN,Wright ,2017,0,134205,67685,66520,50.43403748
MN,Wright ,2018,0,136313,68855,67458,50.51242361
MN,Wright ,2019,0,138377,69973,68404,50.56692948
MN,Yellow Medicine ,2015,0,9837,4995,4842,50.77767612
MN,Yellow Medicine ,2016,0,9888,4997,4891,50.53600324
MN,Yellow Medicine ,2017,0,9836,4941,4895,50.23383489
MN,Yellow Medicine ,2018,0,9799,4937,4862,50.38269211
MN,Yellow Medicine ,2019,0,9709,4892,4817,50.38623957
MS,Adams ,2015,0,31561,16023,15538,50.76835335
MS,Adams ,2016,0,31569,16043,15526,50.81884127
MS,Adams ,2017,0,31462,16236,15226,51.60511093
MS,Adams ,2018,0,31044,16054,14990,51.71369669
MS,Adams ,2019,0,30693,15946,14747,51.95321409
MS,Alcorn ,2015,0,37276,18265,19011,48.99935615
MS,Alcorn ,2016,0,37246,18194,19052,48.84819846
MS,Alcorn ,2017,0,37165,18199,18966,48.96811516
MS,Alcorn ,2018,0,36810,17923,18887,48.69057321
MS,Alcorn ,2019,0,36953,18003,18950,48.7186426
MS,Amite ,2015,0,12553,6067,6486,48.33107624
MS,Amite ,2016,0,12433,6038,6395,48.56430467
MS,Amite ,2017,0,12448,6028,6420,48.42544987
MS,Amite ,2018,0,12327,5970,6357,48.43027501
MS,Amite ,2019,0,12297,5934,6363,48.25567212
MS,Attala ,2015,0,18665,8832,9833,47.31851058
MS,Attala ,2016,0,18551,8762,9789,47.23195515
MS,Attala ,2017,0,18467,8695,9772,47.08398765
MS,Attala ,2018,0,18328,8661,9667,47.25556526
MS,Attala ,2019,0,18174,8590,9584,47.26532409
MS,Benton ,2015,0,8155,4059,4096,49.77314531
MS,Benton ,2016,0,8247,4064,4183,49.27852552
MS,Benton ,2017,0,8255,4064,4191,49.23076923
MS,Benton ,2018,0,8243,4084,4159,49.54506854
MS,Benton ,2019,0,8259,4079,4180,49.38854583
MS,Bolivar ,2015,0,33230,15589,17641,46.91242853
MS,Bolivar ,2016,0,32549,15220,17329,46.76026913
MS,Bolivar ,2017,0,31718,14751,16967,46.50671543
MS,Bolivar ,2018,0,31115,14505,16610,46.61738711
MS,Bolivar ,2019,0,30628,14261,16367,46.56196944
MS,Calhoun ,2015,0,14639,6988,7651,47.73550106
MS,Calhoun ,2016,0,14553,6966,7587,47.86641929
MS,Calhoun ,2017,0,14508,6979,7529,48.10449407
MS,Calhoun ,2018,0,14432,6930,7502,48.01829268
MS,Calhoun ,2019,0,14361,6902,7459,48.06072001
MS,Carroll ,2015,0,10203,5142,5061,50.39694208
MS,Carroll ,2016,0,10186,5123,5063,50.29452189
MS,Carroll ,2017,0,10094,5091,5003,50.43590252
MS,Carroll ,2018,0,9920,5006,4914,50.46370968
MS,Carroll ,2019,0,9947,5005,4942,50.3166784
MS,Chickasaw ,2015,0,17395,8479,8916,48.74389192
MS,Chickasaw ,2016,0,17224,8400,8824,48.76915931
MS,Chickasaw ,2017,0,17144,8420,8724,49.11339244
MS,Chickasaw ,2018,0,17100,8408,8692,49.16959064
MS,Chickasaw ,2019,0,17103,8446,8657,49.38314916
MS,Choctaw ,2015,0,8372,4092,4280,48.87720975
MS,Choctaw ,2016,0,8299,4081,4218,49.17459935
MS,Choctaw ,2017,0,8240,4038,4202,49.00485437
MS,Choctaw ,2018,0,8265,4040,4225,48.88082275
MS,Choctaw ,2019,0,8210,4009,4201,48.83069428
MS,Claiborne ,2015,0,9209,4345,4864,47.18210446
MS,Claiborne ,2016,0,9152,4338,4814,47.39947552
MS,Claiborne ,2017,0,9026,4258,4768,47.17482827
MS,Claiborne ,2018,0,9072,4288,4784,47.26631393
MS,Claiborne ,2019,0,8988,4251,4737,47.29639519
MS,Clarke ,2015,0,16022,7620,8402,47.55960554
MS,Clarke ,2016,0,15896,7521,8375,47.31378963
MS,Clarke ,2017,0,15805,7466,8339,47.23821575
MS,Clarke ,2018,0,15585,7333,8252,47.05165223
MS,Clarke ,2019,0,15541,7297,8244,46.95322051
MS,Clay ,2015,0,20005,9417,10588,47.07323169
MS,Clay ,2016,0,19854,9367,10487,47.17940969
MS,Clay ,2017,0,19621,9185,10436,46.81208909
MS,Clay ,2018,0,19404,9095,10309,46.87177901
MS,Clay ,2019,0,19316,9041,10275,46.80575689
MS,Coahoma ,2015,0,24500,11297,13203,46.11020408
MS,Coahoma ,2016,0,23834,10995,12839,46.13157674
MS,Coahoma ,2017,0,23214,10720,12494,46.1790299
MS,Coahoma ,2018,0,22605,10443,12162,46.19774386
MS,Coahoma ,2019,0,22124,10254,11870,46.34785753
MS,Copiah ,2015,0,28865,13865,15000,48.03395115
MS,Copiah ,2016,0,28647,13740,14907,47.9631375
MS,Copiah ,2017,0,28528,13719,14809,48.08959619
MS,Copiah ,2018,0,28400,13676,14724,48.15492958
MS,Copiah ,2019,0,28065,13466,14599,47.98147158
MS,Covington ,2015,0,19243,9401,9842,48.85412877
MS,Covington ,2016,0,19174,9336,9838,48.69093564
MS,Covington ,2017,0,19014,9235,9779,48.56947512
MS,Covington ,2018,0,18825,9179,9646,48.75962815
MS,Covington ,2019,0,18636,9094,9542,48.79802533
MS,DeSoto ,2015,0,173271,83788,89483,48.35662055
MS,DeSoto ,2016,0,175721,84843,90878,48.28278919
MS,DeSoto ,2017,0,179005,86419,92586,48.27742242
MS,DeSoto ,2018,0,181932,87661,94271,48.1833872
MS,DeSoto ,2019,0,184945,88910,96035,48.07375166
MS,Forrest ,2015,0,75593,35975,39618,47.59038535
MS,Forrest ,2016,0,75564,35897,39667,47.50542586
MS,Forrest ,2017,0,75155,35764,39391,47.58698689
MS,Forrest ,2018,0,74912,35540,39372,47.44233234
MS,Forrest ,2019,0,74897,35322,39575,47.16076745
MS,Franklin ,2015,0,7729,3776,3953,48.85496183
MS,Franklin ,2016,0,7709,3769,3940,48.89090673
MS,Franklin ,2017,0,7754,3795,3959,48.9424813
MS,Franklin ,2018,0,7758,3814,3944,49.16215519
MS,Franklin ,2019,0,7713,3786,3927,49.08595877
MS,George ,2015,0,23378,11824,11554,50.57746599
MS,George ,2016,0,23645,11973,11672,50.6364982
MS,George ,2017,0,23951,12115,11836,50.58243915
MS,George ,2018,0,24110,12161,11949,50.4396516
MS,George ,2019,0,24500,12382,12118,50.53877551
MS,Greene ,2015,0,13549,7753,5796,57.2219352
MS,Greene ,2016,0,13566,7782,5784,57.36399823
MS,Greene ,2017,0,13529,7829,5700,57.86828295
MS,Greene ,2018,0,13996,8242,5754,58.88825379
MS,Greene ,2019,0,13586,7855,5731,57.81687031
MS,Grenada ,2015,0,21444,10218,11226,47.64969222
MS,Grenada ,2016,0,21219,10105,11114,47.62241387
MS,Grenada ,2017,0,21037,10007,11030,47.56856966
MS,Grenada ,2018,0,20984,9967,11017,47.49809379
MS,Grenada ,2019,0,20758,9863,10895,47.51421139
MS,Hancock ,2015,0,46305,22777,23528,49.18907245
MS,Hancock ,2016,0,46643,22925,23718,49.14992603
MS,Hancock ,2017,0,46949,23010,23939,49.01062855
MS,Hancock ,2018,0,47278,23128,24150,48.91915902
MS,Hancock ,2019,0,47632,23239,24393,48.78862949
MS,Harrison ,2015,0,200674,98958,101716,49.31281581
MS,Harrison ,2016,0,202504,99607,102897,49.18767037
MS,Harrison ,2017,0,204966,100708,104258,49.13400271
MS,Harrison ,2018,0,206284,101011,105273,48.96695817
MS,Harrison ,2019,0,208080,101683,106397,48.86726259
MS,Hinds ,2015,0,244216,114270,129946,46.79054607
MS,Hinds ,2016,0,242176,113093,129083,46.69868195
MS,Hinds ,2017,0,239929,111979,127950,46.67172372
MS,Hinds ,2018,0,235824,110097,125727,46.68608793
MS,Hinds ,2019,0,231840,108268,123572,46.6994479
MS,Holmes ,2015,0,18367,8745,9622,47.61256602
MS,Holmes ,2016,0,18017,8591,9426,47.68274408
MS,Holmes ,2017,0,17849,8547,9302,47.88503558
MS,Holmes ,2018,0,17444,8300,9144,47.58083008
MS,Holmes ,2019,0,17010,8090,8920,47.56025867
MS,Humphreys ,2015,0,8705,4105,4600,47.15680643
MS,Humphreys ,2016,0,8588,4047,4541,47.12389381
MS,Humphreys ,2017,0,8333,3939,4394,47.2698908
MS,Humphreys ,2018,0,8256,3888,4368,47.09302326
MS,Humphreys ,2019,0,8064,3803,4261,47.16021825
MS,Issaquena ,2015,0,1337,774,563,57.8908003
MS,Issaquena ,2016,0,1326,780,546,58.82352941
MS,Issaquena ,2017,0,1341,779,562,58.09097688
MS,Issaquena ,2018,0,1307,773,534,59.14307575
MS,Issaquena ,2019,0,1327,794,533,59.83421251
MS,Itawamba ,2015,0,23543,11565,11978,49.12288154
MS,Itawamba ,2016,0,23416,11562,11854,49.3764947
MS,Itawamba ,2017,0,23499,11589,11910,49.31699221
MS,Itawamba ,2018,0,23461,11589,11872,49.3968714
MS,Itawamba ,2019,0,23390,11574,11816,49.48268491
MS,Jackson ,2015,0,141354,69516,71838,49.17865784
MS,Jackson ,2016,0,141535,69683,71852,49.23375843
MS,Jackson ,2017,0,142246,70001,72245,49.21122562
MS,Jackson ,2018,0,143127,70358,72769,49.15774103
MS,Jackson ,2019,0,143617,70467,73150,49.06591838
MS,Jasper ,2015,0,16554,8027,8527,48.48979099
MS,Jasper ,2016,0,16588,8043,8545,48.48685797
MS,Jasper ,2017,0,16574,8053,8521,48.58815011
MS,Jasper ,2018,0,16425,7969,8456,48.51750381
MS,Jasper ,2019,0,16383,7924,8459,48.36720991
MS,Jefferson ,2015,0,7503,3706,3797,49.3935759
MS,Jefferson ,2016,0,7312,3587,3725,49.05634573
MS,Jefferson ,2017,0,7227,3547,3680,49.07983949
MS,Jefferson ,2018,0,7093,3487,3606,49.16114479
MS,Jefferson ,2019,0,6990,3436,3554,49.15593705
MS,Jefferson Davis ,2015,0,11632,5534,6098,47.57565337
MS,Jefferson Davis ,2016,0,11436,5450,5986,47.65652326
MS,Jefferson Davis ,2017,0,11284,5359,5925,47.4920241
MS,Jefferson Davis ,2018,0,11215,5317,5898,47.40971913
MS,Jefferson Davis ,2019,0,11128,5258,5870,47.25017973
MS,Jones ,2015,0,68629,33328,35301,48.56256102
MS,Jones ,2016,0,68473,33302,35171,48.63522848
MS,Jones ,2017,0,68364,33195,35169,48.55625768
MS,Jones ,2018,0,68196,33117,35079,48.56149921
MS,Jones ,2019,0,68098,33059,35039,48.54621281
MS,Kemper ,2015,0,10111,5053,5058,49.97527445
MS,Kemper ,2016,0,10035,4994,5041,49.76581963
MS,Kemper ,2017,0,10093,5023,5070,49.76716536
MS,Kemper ,2018,0,9733,4822,4911,49.54279256
MS,Kemper ,2019,0,9742,4889,4853,50.18476699
MS,Lafayette ,2015,0,52736,25720,27016,48.77123786
MS,Lafayette ,2016,0,53476,26088,27388,48.78450146
MS,Lafayette ,2017,0,54178,26334,27844,48.60644542
MS,Lafayette ,2018,0,53542,26018,27524,48.59362743
MS,Lafayette ,2019,0,54019,26222,27797,48.5421796
MS,Lamar ,2015,0,60966,29301,31665,48.06121445
MS,Lamar ,2016,0,61364,29513,31851,48.09497425
MS,Lamar ,2017,0,61536,29599,31937,48.10029901
MS,Lamar ,2018,0,62637,30083,32554,48.02752367
MS,Lamar ,2019,0,63343,30387,32956,47.97215162
MS,Lauderdale ,2015,0,78348,37908,40440,48.38413233
MS,Lauderdale ,2016,0,77376,37449,39927,48.39872829
MS,Lauderdale ,2017,0,76309,37065,39244,48.57225229
MS,Lauderdale ,2018,0,75238,36487,38751,48.49544113
MS,Lauderdale ,2019,0,74125,35903,38222,48.43575042
MS,Lawrence ,2015,0,12691,6206,6485,48.90079584
MS,Lawrence ,2016,0,12812,6242,6570,48.71995005
MS,Lawrence ,2017,0,12629,6106,6523,48.34903793
MS,Lawrence ,2018,0,12448,6022,6426,48.37724936
MS,Lawrence ,2019,0,12586,6101,6485,48.47449547
MS,Leake ,2015,0,22777,11725,11052,51.47736752
MS,Leake ,2016,0,22789,11727,11062,51.45903725
MS,Leake ,2017,0,22819,11812,11007,51.76388098
MS,Leake ,2018,0,22791,11735,11056,51.4896231
MS,Leake ,2019,0,22786,11755,11031,51.58869481
MS,Lee ,2015,0,84740,40708,44032,48.03870663
MS,Lee ,2016,0,84837,40718,44119,47.99556797
MS,Lee ,2017,0,85071,40718,44353,47.86354927
MS,Lee ,2018,0,85276,40710,44566,47.73910596
MS,Lee ,2019,0,85436,40792,44644,47.74568098
MS,Leflore ,2015,0,30241,14129,16112,46.72133858
MS,Leflore ,2016,0,29779,13929,15850,46.77457269
MS,Leflore ,2017,0,29292,13686,15606,46.72265465
MS,Leflore ,2018,0,28616,13332,15284,46.58932066
MS,Leflore ,2019,0,28183,13117,15066,46.54224178
MS,Lincoln ,2015,0,34522,16506,18016,47.81298882
MS,Lincoln ,2016,0,34375,16418,17957,47.76145455
MS,Lincoln ,2017,0,34340,16385,17955,47.71403611
MS,Lincoln ,2018,0,34210,16362,17848,47.82812043
MS,Lincoln ,2019,0,34153,16313,17840,47.76447164
MS,Lowndes ,2015,0,59697,28507,31190,47.7528184
MS,Lowndes ,2016,0,59549,28420,31129,47.72540261
MS,Lowndes ,2017,0,59147,28199,30948,47.67612897
MS,Lowndes ,2018,0,58760,28034,30726,47.70932607
MS,Lowndes ,2019,0,58595,27911,30684,47.63375715
MS,Madison ,2015,0,102453,49054,53399,47.87951549
MS,Madison ,2016,0,103852,49710,54142,47.8661942
MS,Madison ,2017,0,104584,50097,54487,47.9012086
MS,Madison ,2018,0,105648,50605,55043,47.89962896
MS,Madison ,2019,0,106272,50767,55505,47.77081451
MS,Marion ,2015,0,25412,12255,13157,48.22524791
MS,Marion ,2016,0,25106,12139,12967,48.35099179
MS,Marion ,2017,0,25108,12161,12947,48.43476183
MS,Marion ,2018,0,24752,11967,12785,48.34760827
MS,Marion ,2019,0,24573,11937,12636,48.57770724
MS,Marshall ,2015,0,35891,17753,18138,49.46365384
MS,Marshall ,2016,0,35785,17727,18058,49.53751572
MS,Marshall ,2017,0,35590,17666,17924,49.63753863
MS,Marshall ,2018,0,35436,17577,17859,49.60209956
MS,Marshall ,2019,0,35294,17466,17828,49.48716496
MS,Monroe ,2015,0,35823,17077,18746,47.67049103
MS,Monroe ,2016,0,35897,17130,18767,47.71986517
MS,Monroe ,2017,0,35851,17112,18739,47.73088617
MS,Monroe ,2018,0,35543,16933,18610,47.64088569
MS,Monroe ,2019,0,35252,16780,18472,47.60013616
MS,Montgomery ,2015,0,10195,4860,5335,47.67042668
MS,Montgomery ,2016,0,10235,4868,5367,47.56228627
MS,Montgomery ,2017,0,10143,4819,5324,47.51059844
MS,Montgomery ,2018,0,9994,4765,5229,47.67860716
MS,Montgomery ,2019,0,9775,4699,5076,48.07161125
MS,Neshoba ,2015,0,29481,14055,15426,47.67477358
MS,Neshoba ,2016,0,29473,14055,15418,47.68771418
MS,Neshoba ,2017,0,29435,14028,15407,47.65755054
MS,Neshoba ,2018,0,29151,13893,15258,47.65874241
MS,Neshoba ,2019,0,29118,13895,15223,47.7196236
MS,Newton ,2015,0,21569,10317,11252,47.83253744
MS,Newton ,2016,0,21461,10290,11171,47.94743954
MS,Newton ,2017,0,21396,10252,11144,47.91549822
MS,Newton ,2018,0,21355,10213,11142,47.82486537
MS,Newton ,2019,0,21018,10059,10959,47.85897802
MS,Noxubee ,2015,0,10942,5190,5752,47.43191373
MS,Noxubee ,2016,0,10879,5143,5736,47.27456568
MS,Noxubee ,2017,0,10711,5062,5649,47.25982635
MS,Noxubee ,2018,0,10550,4965,5585,47.06161137
MS,Noxubee ,2019,0,10417,4916,5501,47.19208985
MS,Oktibbeha ,2015,0,49510,24813,24697,50.11714805
MS,Oktibbeha ,2016,0,49534,24831,24703,50.12920418
MS,Oktibbeha ,2017,0,49678,24850,24828,50.0221426
MS,Oktibbeha ,2018,0,49249,24593,24656,49.93603931
MS,Oktibbeha ,2019,0,49587,24750,24837,49.91227539
MS,Panola ,2015,0,34202,16474,17728,48.16677387
MS,Panola ,2016,0,34241,16542,17699,48.31050495
MS,Panola ,2017,0,34158,16461,17697,48.19076058
MS,Panola ,2018,0,34156,16407,17749,48.03548425
MS,Panola ,2019,0,34192,16373,17819,47.88547029
MS,Pearl River ,2015,0,54944,27128,27816,49.37390798
MS,Pearl River ,2016,0,55037,27152,27885,49.33408434
MS,Pearl River ,2017,0,55255,27245,28010,49.30775495
MS,Pearl River ,2018,0,55323,27214,28109,49.191114
MS,Pearl River ,2019,0,55535,27314,28221,49.18339786
MS,Perry ,2015,0,12071,5928,6143,49.10943584
MS,Perry ,2016,0,12056,5939,6117,49.26177837
MS,Perry ,2017,0,12014,5892,6122,49.04278342
MS,Perry ,2018,0,11918,5841,6077,49.00990099
MS,Perry ,2019,0,11973,5858,6115,48.92675186
MS,Pike ,2015,0,39890,18900,20990,47.38029581
MS,Pike ,2016,0,39592,18745,20847,47.34542332
MS,Pike ,2017,0,39510,18671,20839,47.25639079
MS,Pike ,2018,0,39380,18606,20774,47.24733367
MS,Pike ,2019,0,39288,18571,20717,47.26888617
MS,Pontotoc ,2015,0,30857,15215,15642,49.30809865
MS,Pontotoc ,2016,0,31470,15441,16029,49.06577693
MS,Pontotoc ,2017,0,31709,15505,16204,48.89778927
MS,Pontotoc ,2018,0,31881,15567,16314,48.82845582
MS,Pontotoc ,2019,0,32174,15735,16439,48.9059489
MS,Prentiss ,2015,0,25440,12470,12970,49.0172956
MS,Prentiss ,2016,0,25405,12439,12966,48.9628026
MS,Prentiss ,2017,0,25215,12373,12842,49.06999802
MS,Prentiss ,2018,0,25088,12311,12777,49.07126913
MS,Prentiss ,2019,0,25126,12331,12795,49.07665367
MS,Quitman ,2015,0,7511,3559,3952,47.38383704
MS,Quitman ,2016,0,7368,3478,3890,47.20412595
MS,Quitman ,2017,0,7208,3372,3836,46.78135405
MS,Quitman ,2018,0,7055,3283,3772,46.53437279
MS,Quitman ,2019,0,6792,3153,3639,46.42226148
MS,Rankin ,2015,0,149447,72148,77299,48.27664657
MS,Rankin ,2016,0,151514,73105,78409,48.2496667
MS,Rankin ,2017,0,152904,73805,79099,48.26884843
MS,Rankin ,2018,0,154250,74297,79953,48.16661264
MS,Rankin ,2019,0,155271,74718,80553,48.12102711
MS,Scott ,2015,0,28432,13888,14544,48.84637029
MS,Scott ,2016,0,28351,13833,14518,48.79192974
MS,Scott ,2017,0,28436,13850,14586,48.7058658
MS,Scott ,2018,0,28319,13907,14412,49.10837247
MS,Scott ,2019,0,28124,13813,14311,49.11463519
MS,Sharkey ,2015,0,4563,2123,2440,46.52640806
MS,Sharkey ,2016,0,4513,2130,2383,47.19698648
MS,Sharkey ,2017,0,4415,2109,2306,47.76896942
MS,Sharkey ,2018,0,4375,2089,2286,47.74857143
MS,Sharkey ,2019,0,4321,2065,2256,47.78986346
MS,Simpson ,2015,0,27169,13198,13971,48.5774228
MS,Simpson ,2016,0,26992,13113,13879,48.58106106
MS,Simpson ,2017,0,26905,13006,13899,48.34045716
MS,Simpson ,2018,0,26717,12923,13794,48.36995172
MS,Simpson ,2019,0,26658,12893,13765,48.36446845
MS,Smith ,2015,0,16079,7745,8334,48.16841843
MS,Smith ,2016,0,15949,7696,8253,48.25380902
MS,Smith ,2017,0,16073,7748,8325,48.20506439
MS,Smith ,2018,0,16029,7714,8315,48.12527294
MS,Smith ,2019,0,15916,7685,8231,48.28474491
MS,Stone ,2015,0,18271,9215,9056,50.43511576
MS,Stone ,2016,0,18183,9218,8965,50.69570478
MS,Stone ,2017,0,18593,9424,9169,50.68574195
MS,Stone ,2018,0,17997,9028,8969,50.16391621
MS,Stone ,2019,0,18336,9186,9150,50.09816754
MS,Sunflower ,2015,0,26877,14136,12741,52.59515571
MS,Sunflower ,2016,0,26493,13992,12501,52.81395085
MS,Sunflower ,2017,0,26142,13903,12239,53.18261801
MS,Sunflower ,2018,0,26211,14185,12026,54.11849987
MS,Sunflower ,2019,0,25110,13407,11703,53.39307049
MS,Tallahatchie ,2015,0,14582,8075,6507,55.37649156
MS,Tallahatchie ,2016,0,14342,7964,6378,55.52921489
MS,Tallahatchie ,2017,0,14094,7814,6280,55.44203207
MS,Tallahatchie ,2018,0,13961,7739,6222,55.43299191
MS,Tallahatchie ,2019,0,13809,7661,6148,55.47831125
MS,Tate ,2015,0,28465,13725,14740,48.21710873
MS,Tate ,2016,0,28306,13662,14644,48.26538543
MS,Tate ,2017,0,28581,13734,14847,48.05290228
MS,Tate ,2018,0,28347,13628,14719,48.07563411
MS,Tate ,2019,0,28321,13602,14719,48.02796511
MS,Tippah ,2015,0,22018,10818,11200,49.13252793
MS,Tippah ,2016,0,22063,10761,11302,48.77396546
MS,Tippah ,2017,0,21953,10680,11273,48.64938733
MS,Tippah ,2018,0,22039,10714,11325,48.61382095
MS,Tippah ,2019,0,22015,10712,11303,48.65773336
MS,Tishomingo ,2015,0,19481,9445,10036,48.48313742
MS,Tishomingo ,2016,0,19442,9436,10006,48.53410143
MS,Tishomingo ,2017,0,19518,9478,10040,48.56030331
MS,Tishomingo ,2018,0,19383,9468,9915,48.84692772
MS,Tishomingo ,2019,0,19383,9459,9924,48.80049528
MS,Tunica ,2015,0,10264,4838,5426,47.13561964
MS,Tunica ,2016,0,10139,4770,5369,47.04605977
MS,Tunica ,2017,0,9984,4712,5272,47.19551282
MS,Tunica ,2018,0,9922,4651,5271,46.87562991
MS,Tunica ,2019,0,9632,4512,5120,46.84385382
MS,Union ,2015,0,28311,13883,14428,49.0374766
MS,Union ,2016,0,28308,13843,14465,48.90137064
MS,Union ,2017,0,28486,13963,14523,49.01706101
MS,Union ,2018,0,28615,14028,14587,49.02323956
MS,Union ,2019,0,28815,14090,14725,48.89814333
MS,Walthall ,2015,0,14601,7040,7561,48.21587562
MS,Walthall ,2016,0,14556,6999,7557,48.08326463
MS,Walthall ,2017,0,14505,6991,7514,48.19717339
MS,Walthall ,2018,0,14436,6953,7483,48.16431144
MS,Walthall ,2019,0,14286,6911,7375,48.37603248
MS,Warren ,2015,0,47481,22605,24876,47.60851709
MS,Warren ,2016,0,46958,22362,24596,47.62127859
MS,Warren ,2017,0,46682,22191,24491,47.53652371
MS,Warren ,2018,0,46093,21899,24194,47.51046797
MS,Warren ,2019,0,45381,21613,23768,47.62565832
MS,Washington ,2015,0,47959,22432,25527,46.77328551
MS,Washington ,2016,0,47183,21950,25233,46.52099273
MS,Washington ,2017,0,46197,21461,24736,46.45539754
MS,Washington ,2018,0,45036,20829,24207,46.24966693
MS,Washington ,2019,0,43909,20248,23661,46.11355303
MS,Wayne ,2015,0,20497,9911,10586,48.35341757
MS,Wayne ,2016,0,20460,9867,10593,48.22580645
MS,Wayne ,2017,0,20430,9849,10581,48.20851689
MS,Wayne ,2018,0,20296,9750,10546,48.03902247
MS,Wayne ,2019,0,20183,9697,10486,48.04538473
MS,Webster ,2015,0,9873,4846,5027,49.08335865
MS,Webster ,2016,0,9758,4771,4987,48.89321582
MS,Webster ,2017,0,9732,4737,4995,48.67447596
MS,Webster ,2018,0,9788,4783,5005,48.86595832
MS,Webster ,2019,0,9689,4729,4960,48.80792651
MS,Wilkinson ,2015,0,9089,4821,4268,53.04213885
MS,Wilkinson ,2016,0,9020,4814,4206,53.37028825
MS,Wilkinson ,2017,0,8855,4760,4095,53.75494071
MS,Wilkinson ,2018,0,8781,4729,4052,53.85491402
MS,Wilkinson ,2019,0,8630,4657,3973,53.96292005
MS,Winston ,2015,0,18447,8977,9470,48.66373936
MS,Winston ,2016,0,18340,8940,9400,48.74591058
MS,Winston ,2017,0,18237,8915,9322,48.88413665
MS,Winston ,2018,0,18164,8887,9277,48.92644792
MS,Winston ,2019,0,17955,8796,9159,48.98913952
MS,Yalobusha ,2015,0,12458,5975,6483,47.96114946
MS,Yalobusha ,2016,0,12461,5941,6520,47.67675146
MS,Yalobusha ,2017,0,12449,5944,6505,47.74680697
MS,Yalobusha ,2018,0,12361,5902,6459,47.74694604
MS,Yalobusha ,2019,0,12108,5800,6308,47.90221341
MS,Yazoo ,2015,0,27411,15041,12370,54.87213163
MS,Yazoo ,2016,0,27972,15729,12243,56.23123123
MS,Yazoo ,2017,0,28659,16512,12147,57.61540877
MS,Yazoo ,2018,0,29093,17061,12032,58.64297254
MS,Yazoo ,2019,0,29690,17753,11937,59.79454362
MO,Adair ,2015,0,25353,12163,13190,47.97459867
MO,Adair ,2016,0,25244,12128,13116,48.04309935
MO,Adair ,2017,0,25429,12203,13226,47.98851705
MO,Adair ,2018,0,25476,12208,13268,47.91961061
MO,Adair ,2019,0,25343,12171,13172,48.02509569
MO,Andrew ,2015,0,17314,8555,8759,49.41088137
MO,Andrew ,2016,0,17351,8616,8735,49.65708028
MO,Andrew ,2017,0,17474,8681,8793,49.67952386
MO,Andrew ,2018,0,17662,8764,8898,49.62065451
MO,Andrew ,2019,0,17712,8764,8948,49.48057814
MO,Atchison ,2015,0,5295,2630,2665,49.66949953
MO,Atchison ,2016,0,5281,2603,2678,49.28990721
MO,Atchison ,2017,0,5243,2599,2644,49.57085638
MO,Atchison ,2018,0,5183,2591,2592,49.99035308
MO,Atchison ,2019,0,5143,2571,2572,49.99027805
MO,Audrain ,2015,0,25950,11772,14178,45.36416185
MO,Audrain ,2016,0,25870,11767,14103,45.4851179
MO,Audrain ,2017,0,25590,11668,13922,45.59593591
MO,Audrain ,2018,0,25423,11681,13742,45.9465838
MO,Audrain ,2019,0,25388,11650,13738,45.88782102
MO,Barry ,2015,0,35293,17729,17564,50.2337574
MO,Barry ,2016,0,35226,17659,17567,50.13058536
MO,Barry ,2017,0,35631,17921,17710,50.29609048
MO,Barry ,2018,0,35712,18022,17690,50.46482975
MO,Barry ,2019,0,35789,17990,17799,50.26684177
MO,Barton ,2015,0,11825,5838,5987,49.36997886
MO,Barton ,2016,0,11825,5864,5961,49.58985201
MO,Barton ,2017,0,11793,5822,5971,49.36826931
MO,Barton ,2018,0,11790,5801,5989,49.20271416
MO,Barton ,2019,0,11754,5772,5982,49.10668709
MO,Bates ,2015,0,16362,8100,8262,49.5049505
MO,Bates ,2016,0,16351,8071,8280,49.36089536
MO,Bates ,2017,0,16293,8065,8228,49.49978518
MO,Bates ,2018,0,16304,8072,8232,49.50932287
MO,Bates ,2019,0,16172,8057,8115,49.82067771
MO,Benton ,2015,0,18791,9432,9359,50.19424192
MO,Benton ,2016,0,18934,9488,9446,50.11091159
MO,Benton ,2017,0,19072,9552,9520,50.08389262
MO,Benton ,2018,0,19297,9671,9626,50.11659843
MO,Benton ,2019,0,19443,9746,9697,50.12600936
MO,Bollinger ,2015,0,12316,6146,6170,49.90256577
MO,Bollinger ,2016,0,12205,6082,6123,49.83203605
MO,Bollinger ,2017,0,12280,6153,6127,50.10586319
MO,Bollinger ,2018,0,12189,6145,6044,50.41430798
MO,Bollinger ,2019,0,12133,6083,6050,50.13599275
MO,Boone ,2015,0,174404,84613,89791,48.5155157
MO,Boone ,2016,0,176315,85562,90753,48.52791878
MO,Boone ,2017,0,178012,86319,91693,48.4905512
MO,Boone ,2018,0,179061,86849,92212,48.50246564
MO,Boone ,2019,0,180463,87487,92976,48.47918964
MO,Buchanan ,2015,0,89082,44958,44124,50.46810804
MO,Buchanan ,2016,0,89032,44949,44083,50.48634199
MO,Buchanan ,2017,0,88660,44729,43931,50.45003384
MO,Buchanan ,2018,0,88163,44499,43664,50.47355467
MO,Buchanan ,2019,0,87364,44186,43178,50.57689666
MO,Butler ,2015,0,42829,20775,22054,48.50685283
MO,Butler ,2016,0,42769,20797,21972,48.62634151
MO,Butler ,2017,0,42618,20695,21923,48.55929419
MO,Butler ,2018,0,42587,20680,21907,48.55941954
MO,Butler ,2019,0,42478,20626,21852,48.55690004
MO,Caldwell ,2015,0,9002,4541,4461,50.4443457
MO,Caldwell ,2016,0,9043,4572,4471,50.55844299
MO,Caldwell ,2017,0,9059,4584,4475,50.60161166
MO,Caldwell ,2018,0,9071,4608,4463,50.79925036
MO,Caldwell ,2019,0,9020,4580,4440,50.77605322
MO,Callaway ,2015,0,44699,22933,21766,51.30539833
MO,Callaway ,2016,0,45069,23135,21934,51.33240143
MO,Callaway ,2017,0,44982,23087,21895,51.32497443
MO,Callaway ,2018,0,44954,22973,21981,51.10335009
MO,Callaway ,2019,0,44743,22904,21839,51.1901303
MO,Camden ,2015,0,44735,22175,22560,49.56968816
MO,Camden ,2016,0,44906,22264,22642,49.57912083
MO,Camden ,2017,0,45473,22536,22937,49.55907901
MO,Camden ,2018,0,45913,22816,23097,49.69398645
MO,Camden ,2019,0,46305,22982,23323,49.63178922
MO,Cape Girardeau ,2015,0,78238,37920,40318,48.46749661
MO,Cape Girardeau ,2016,0,78445,38011,40434,48.45560584
MO,Cape Girardeau ,2017,0,78261,37943,40318,48.48264142
MO,Cape Girardeau ,2018,0,78638,38069,40569,48.4104377
MO,Cape Girardeau ,2019,0,78871,38183,40688,48.41196384
MO,Carroll ,2015,0,8879,4342,4537,48.90190337
MO,Carroll ,2016,0,8844,4346,4498,49.14066033
MO,Carroll ,2017,0,8779,4275,4504,48.69575122
MO,Carroll ,2018,0,8726,4245,4481,48.64771946
MO,Carroll ,2019,0,8679,4211,4468,48.51941468
MO,Carter ,2015,0,6280,3058,3222,48.69426752
MO,Carter ,2016,0,6210,3004,3206,48.37359098
MO,Carter ,2017,0,6179,2989,3190,48.37352322
MO,Carter ,2018,0,6083,2950,3133,48.49580799
MO,Carter ,2019,0,5982,2899,3083,48.46205283
MO,Cass ,2015,0,101339,49481,51858,48.82720374
MO,Cass ,2016,0,102622,50083,52539,48.80337549
MO,Cass ,2017,0,103477,50489,52988,48.79248529
MO,Cass ,2018,0,104769,51073,53696,48.74819842
MO,Cass ,2019,0,105780,51584,54196,48.76536207
MO,Cedar ,2015,0,13782,6847,6935,49.680743
MO,Cedar ,2016,0,13876,6923,6953,49.89189968
MO,Cedar ,2017,0,14070,7008,7062,49.80810235
MO,Cedar ,2018,0,14136,7050,7086,49.87266553
MO,Cedar ,2019,0,14349,7139,7210,49.752596
MO,Chariton ,2015,0,7576,3792,3784,50.05279831
MO,Chariton ,2016,0,7501,3746,3755,49.940008
MO,Chariton ,2017,0,7457,3720,3737,49.88601314
MO,Chariton ,2018,0,7457,3710,3747,49.75191096
MO,Chariton ,2019,0,7426,3704,3722,49.8788042
MO,Christian ,2015,0,83077,40632,42445,48.9088436
MO,Christian ,2016,0,84184,41174,43010,48.9095315
MO,Christian ,2017,0,85392,41753,43639,48.89568109
MO,Christian ,2018,0,87044,42685,44359,49.03841735
MO,Christian ,2019,0,88595,43435,45160,49.02646876
MO,Clark ,2015,0,6808,3451,3357,50.69036428
MO,Clark ,2016,0,6739,3409,3330,50.58614038
MO,Clark ,2017,0,6720,3416,3304,50.83333333
MO,Clark ,2018,0,6833,3494,3339,51.13420167
MO,Clark ,2019,0,6797,3478,3319,51.16963366
MO,Clay ,2015,0,235161,115209,119952,48.99154196
MO,Clay ,2016,0,238583,116953,121630,49.01983796
MO,Clay ,2017,0,242527,118815,123712,48.99042169
MO,Clay ,2018,0,246360,120944,125416,49.09238513
MO,Clay ,2019,0,249948,122611,127337,49.05460336
MO,Clinton ,2015,0,20581,10340,10241,50.24051309
MO,Clinton ,2016,0,20548,10325,10223,50.24819934
MO,Clinton ,2017,0,20551,10341,10210,50.31871928
MO,Clinton ,2018,0,20435,10263,10172,50.22265721
MO,Clinton ,2019,0,20387,10187,10200,49.96811694
MO,Cole ,2015,0,76818,38828,37990,50.54544508
MO,Cole ,2016,0,76702,38777,37925,50.55539621
MO,Cole ,2017,0,76632,38760,37872,50.57939242
MO,Cole ,2018,0,76720,38744,37976,50.50052138
MO,Cole ,2019,0,76745,38745,38000,50.48537364
MO,Cooper ,2015,0,17614,9246,8368,52.49233564
MO,Cooper ,2016,0,17702,9266,8436,52.34436787
MO,Cooper ,2017,0,17647,9221,8426,52.25250751
MO,Cooper ,2018,0,17626,9195,8431,52.16725292
MO,Cooper ,2019,0,17709,9233,8476,52.1373313
MO,Crawford ,2015,0,24511,12152,12359,49.57774061
MO,Crawford ,2016,0,24265,12036,12229,49.60230785
MO,Crawford ,2017,0,24107,11904,12203,49.37984818
MO,Crawford ,2018,0,23968,11865,12103,49.50350467
MO,Crawford ,2019,0,23920,11885,12035,49.68645485
MO,Dade ,2015,0,7574,3834,3740,50.62054397
MO,Dade ,2016,0,7606,3855,3751,50.68367079
MO,Dade ,2017,0,7586,3853,3733,50.79093066
MO,Dade ,2018,0,7564,3867,3697,51.12374405
MO,Dade ,2019,0,7561,3861,3700,51.06467398
MO,Dallas ,2015,0,16344,8088,8256,49.48604993
MO,Dallas ,2016,0,16381,8133,8248,49.64898358
MO,Dallas ,2017,0,16699,8320,8379,49.82334272
MO,Dallas ,2018,0,16782,8358,8424,49.80336074
MO,Dallas ,2019,0,16878,8358,8520,49.52008532
MO,Daviess ,2015,0,8283,4186,4097,50.53724496
MO,Daviess ,2016,0,8224,4152,4072,50.48638132
MO,Daviess ,2017,0,8358,4218,4140,50.46661881
MO,Daviess ,2018,0,8334,4200,4134,50.39596832
MO,Daviess ,2019,0,8278,4157,4121,50.21744383
MO,DeKalb ,2015,0,12540,7912,4628,63.09409888
MO,DeKalb ,2016,0,12496,7860,4636,62.90012804
MO,DeKalb ,2017,0,12532,7868,4664,62.78327482
MO,DeKalb ,2018,0,12515,7846,4669,62.69276868
MO,DeKalb ,2019,0,12547,7848,4699,62.54881645
MO,Dent ,2015,0,15656,7806,7850,49.85947879
MO,Dent ,2016,0,15454,7729,7725,50.01294163
MO,Dent ,2017,0,15497,7724,7773,49.84190488
MO,Dent ,2018,0,15547,7754,7793,49.87457387
MO,Dent ,2019,0,15573,7767,7806,49.87478328
MO,Douglas ,2015,0,13356,6640,6716,49.71548368
MO,Douglas ,2016,0,13353,6656,6697,49.84647645
MO,Douglas ,2017,0,13276,6641,6635,50.02259717
MO,Douglas ,2018,0,13359,6700,6659,50.1534546
MO,Douglas ,2019,0,13185,6612,6573,50.14789534
MO,Dunklin ,2015,0,30844,14766,16078,47.8731682
MO,Dunklin ,2016,0,30562,14624,15938,47.85027158
MO,Dunklin ,2017,0,30121,14427,15694,47.89681617
MO,Dunklin ,2018,0,29478,14084,15394,47.77800394
MO,Dunklin ,2019,0,29131,13959,15172,47.91802547
MO,Franklin ,2015,0,102251,50709,51542,49.59266902
MO,Franklin ,2016,0,102704,50984,51720,49.64168874
MO,Franklin ,2017,0,103315,51324,51991,49.67720079
MO,Franklin ,2018,0,103716,51535,52181,49.68857264
MO,Franklin ,2019,0,103967,51617,52350,49.6474843
MO,Gasconade ,2015,0,14742,7341,7401,49.7964998
MO,Gasconade ,2016,0,14746,7383,7363,50.067815
MO,Gasconade ,2017,0,14683,7336,7347,49.96254171
MO,Gasconade ,2018,0,14680,7330,7350,49.93188011
MO,Gasconade ,2019,0,14706,7349,7357,49.97280022
MO,Gentry ,2015,0,6654,3212,3442,48.27171626
MO,Gentry ,2016,0,6624,3198,3426,48.27898551
MO,Gentry ,2017,0,6634,3193,3441,48.13084112
MO,Gentry ,2018,0,6598,3192,3406,48.37829645
MO,Gentry ,2019,0,6571,3169,3402,48.22705829
MO,Greene ,2015,0,287312,140042,147270,48.74213399
MO,Greene ,2016,0,287818,140385,147433,48.77561515
MO,Greene ,2017,0,289512,141005,148507,48.70437149
MO,Greene ,2018,0,291054,141414,149640,48.58686017
MO,Greene ,2019,0,293086,142417,150669,48.59222208
MO,Grundy ,2015,0,10031,4805,5226,47.90150533
MO,Grundy ,2016,0,10111,4894,5217,48.4027297
MO,Grundy ,2017,0,9991,4872,5119,48.7638875
MO,Grundy ,2018,0,9975,4871,5104,48.8320802
MO,Grundy ,2019,0,9850,4790,5060,48.62944162
MO,Harrison ,2015,0,8622,4256,4366,49.36209696
MO,Harrison ,2016,0,8579,4228,4351,49.28313323
MO,Harrison ,2017,0,8506,4167,4339,48.98894898
MO,Harrison ,2018,0,8394,4130,4264,49.20181082
MO,Harrison ,2019,0,8352,4139,4213,49.55699234
MO,Henry ,2015,0,21725,10713,11012,49.3118527
MO,Henry ,2016,0,21625,10627,10998,49.14219653
MO,Henry ,2017,0,21695,10662,11033,49.14496428
MO,Henry ,2018,0,21808,10722,11086,49.16544387
MO,Henry ,2019,0,21824,10741,11083,49.21645894
MO,Hickory ,2015,0,9266,4547,4719,49.07187567
MO,Hickory ,2016,0,9356,4600,4756,49.16631039
MO,Hickory ,2017,0,9395,4629,4766,49.27088877
MO,Hickory ,2018,0,9458,4674,4784,49.41848171
MO,Hickory ,2019,0,9544,4723,4821,49.48658843
MO,Holt ,2015,0,4483,2208,2275,49.25273255
MO,Holt ,2016,0,4453,2185,2268,49.06804402
MO,Holt ,2017,0,4407,2168,2239,49.19446335
MO,Holt ,2018,0,4412,2157,2255,48.88939257
MO,Holt ,2019,0,4403,2159,2244,49.03474903
MO,Howard ,2015,0,10134,5048,5086,49.81251233
MO,Howard ,2016,0,10032,5006,5026,49.90031898
MO,Howard ,2017,0,10066,5052,5014,50.18875422
MO,Howard ,2018,0,10059,5043,5016,50.13420817
MO,Howard ,2019,0,10001,5013,4988,50.1249875
MO,Howell ,2015,0,40070,19491,20579,48.64237584
MO,Howell ,2016,0,40132,19509,20623,48.61208014
MO,Howell ,2017,0,40074,19541,20533,48.76228976
MO,Howell ,2018,0,40126,19520,20606,48.6467627
MO,Howell ,2019,0,40117,19530,20587,48.68260339
MO,Iron ,2015,0,10203,5060,5143,49.59325689
MO,Iron ,2016,0,10123,5026,5097,49.64931344
MO,Iron ,2017,0,10181,5070,5111,49.79864453
MO,Iron ,2018,0,10187,5078,5109,49.84784529
MO,Iron ,2019,0,10125,5048,5077,49.85679012
MO,Jackson ,2015,0,686783,332114,354669,48.35792383
MO,Jackson ,2016,0,692430,334965,357465,48.37528703
MO,Jackson ,2017,0,698072,337777,360295,48.38712912
MO,Jackson ,2018,0,700784,338897,361887,48.35969429
MO,Jackson ,2019,0,703011,339932,363079,48.35372419
MO,Jasper ,2015,0,118548,57864,60684,48.81060836
MO,Jasper ,2016,0,119219,58113,61106,48.74474706
MO,Jasper ,2017,0,120048,58591,61457,48.80631081
MO,Jasper ,2018,0,120455,58859,61596,48.86389108
MO,Jasper ,2019,0,121328,59280,62048,48.85929052
MO,Jefferson ,2015,0,223116,110930,112186,49.71853206
MO,Jefferson ,2016,0,223377,110989,112388,49.68685227
MO,Jefferson ,2017,0,223769,111224,112545,49.70482953
MO,Jefferson ,2018,0,224410,111422,112988,49.65108507
MO,Jefferson ,2019,0,225081,111762,113319,49.65412452
MO,Johnson ,2015,0,53496,27507,25989,51.41879767
MO,Johnson ,2016,0,53497,27582,25915,51.55803129
MO,Johnson ,2017,0,53735,27664,26071,51.48227412
MO,Johnson ,2018,0,53621,27505,26116,51.29520151
MO,Johnson ,2019,0,54062,27652,26410,51.14868114
MO,Knox ,2015,0,3907,1943,1964,49.7312516
MO,Knox ,2016,0,3933,1970,1963,50.08899059
MO,Knox ,2017,0,3970,1985,1985,50
MO,Knox ,2018,0,3965,1983,1982,50.01261034
MO,Knox ,2019,0,3959,1981,1978,50.03788836
MO,Laclede ,2015,0,35469,17477,17992,49.27401393
MO,Laclede ,2016,0,35450,17449,18001,49.22143865
MO,Laclede ,2017,0,35418,17456,17962,49.28567395
MO,Laclede ,2018,0,35596,17508,18088,49.18530172
MO,Laclede ,2019,0,35723,17590,18133,49.23998544
MO,Lafayette ,2015,0,32624,16147,16477,49.49423737
MO,Lafayette ,2016,0,32534,16095,16439,49.47132231
MO,Lafayette ,2017,0,32579,16140,16439,49.54111544
MO,Lafayette ,2018,0,32542,16127,16415,49.55749493
MO,Lafayette ,2019,0,32708,16228,16480,49.61477314
MO,Lawrence ,2015,0,37981,18834,19147,49.58795187
MO,Lawrence ,2016,0,38164,18952,19212,49.65936485
MO,Lawrence ,2017,0,38256,19010,19246,49.69155165
MO,Lawrence ,2018,0,38264,19049,19215,49.78308593
MO,Lawrence ,2019,0,38355,19054,19301,49.67800808
MO,Lewis ,2015,0,10138,5080,5058,50.10850266
MO,Lewis ,2016,0,10072,5049,5023,50.12907069
MO,Lewis ,2017,0,9952,4973,4979,49.96985531
MO,Lewis ,2018,0,9839,4933,4906,50.13720907
MO,Lewis ,2019,0,9776,4912,4864,50.24549918
MO,Lincoln ,2015,0,54567,27317,27250,50.06139242
MO,Lincoln ,2016,0,55146,27619,27527,50.08341493
MO,Lincoln ,2017,0,56045,28081,27964,50.10438041
MO,Lincoln ,2018,0,57613,28834,28779,50.04773228
MO,Lincoln ,2019,0,59013,29513,29500,50.01101452
MO,Linn ,2015,0,12293,5985,6308,48.6862442
MO,Linn ,2016,0,12146,5870,6276,48.32866787
MO,Linn ,2017,0,12168,5937,6231,48.79191321
MO,Linn ,2018,0,12039,5886,6153,48.89110391
MO,Linn ,2019,0,11920,5808,6112,48.72483221
MO,Livingston ,2015,0,14938,6627,8311,44.36336859
MO,Livingston ,2016,0,15127,6630,8497,43.82891518
MO,Livingston ,2017,0,15157,6645,8512,43.84112951
MO,Livingston ,2018,0,15181,6620,8561,43.6071405
MO,Livingston ,2019,0,15227,6643,8584,43.62645301
MO,McDonald ,2015,0,22683,11467,11216,50.55327779
MO,McDonald ,2016,0,22705,11512,11193,50.70248844
MO,McDonald ,2017,0,22722,11512,11210,50.66455418
MO,McDonald ,2018,0,22963,11601,11362,50.52040239
MO,McDonald ,2019,0,22837,11543,11294,50.54516793
MO,Macon ,2015,0,15284,7555,7729,49.43077728
MO,Macon ,2016,0,15164,7465,7699,49.22843577
MO,Macon ,2017,0,15262,7524,7738,49.29891233
MO,Macon ,2018,0,15167,7518,7649,49.56814136
MO,Macon ,2019,0,15117,7471,7646,49.42118145
MO,Madison ,2015,0,12178,5983,6195,49.12957793
MO,Madison ,2016,0,12213,6027,6186,49.34905429
MO,Madison ,2017,0,12230,6029,6201,49.29681112
MO,Madison ,2018,0,12188,5989,6199,49.13849688
MO,Madison ,2019,0,12088,5925,6163,49.01555261
MO,Maries ,2015,0,8936,4485,4451,50.19024172
MO,Maries ,2016,0,8821,4406,4415,49.94898538
MO,Maries ,2017,0,8790,4403,4387,50.09101251
MO,Maries ,2018,0,8770,4391,4379,50.06841505
MO,Maries ,2019,0,8697,4361,4336,50.14372772
MO,Marion ,2015,0,28697,13910,14787,48.47196571
MO,Marion ,2016,0,28689,13915,14774,48.50291052
MO,Marion ,2017,0,28585,13884,14701,48.57092881
MO,Marion ,2018,0,28540,13875,14665,48.61597758
MO,Marion ,2019,0,28530,13877,14653,48.64002804
MO,Mercer ,2015,0,3660,1831,1829,50.0273224
MO,Mercer ,2016,0,3661,1837,1824,50.17754712
MO,Mercer ,2017,0,3656,1844,1812,50.43763676
MO,Mercer ,2018,0,3626,1837,1789,50.66188638
MO,Mercer ,2019,0,3617,1824,1793,50.42853193
MO,Miller ,2015,0,24872,12414,12458,49.91154712
MO,Miller ,2016,0,24998,12435,12563,49.74397952
MO,Miller ,2017,0,25202,12566,12636,49.86112213
MO,Miller ,2018,0,25315,12632,12683,49.89926921
MO,Miller ,2019,0,25619,12795,12824,49.94340138
MO,Mississippi ,2015,0,13965,7528,6437,53.90619406
MO,Mississippi ,2016,0,13738,7398,6340,53.85063328
MO,Mississippi ,2017,0,13594,7338,6256,53.97969693
MO,Mississippi ,2018,0,13394,7237,6157,54.03165597
MO,Mississippi ,2019,0,13180,7132,6048,54.11229135
MO,Moniteau ,2015,0,15873,8439,7434,53.16575317
MO,Moniteau ,2016,0,15991,8529,7462,53.33625164
MO,Moniteau ,2017,0,16047,8529,7518,53.15012152
MO,Moniteau ,2018,0,16186,8596,7590,53.10762387
MO,Moniteau ,2019,0,16132,8591,7541,53.25440119
MO,Monroe ,2015,0,8637,4363,4274,50.51522519
MO,Monroe ,2016,0,8633,4366,4267,50.57338121
MO,Monroe ,2017,0,8596,4369,4227,50.82596557
MO,Monroe ,2018,0,8636,4380,4256,50.71792497
MO,Monroe ,2019,0,8644,4399,4245,50.8907913
MO,Montgomery ,2015,0,11572,5805,5767,50.16418942
MO,Montgomery ,2016,0,11447,5724,5723,50.00436796
MO,Montgomery ,2017,0,11378,5678,5700,49.9033222
MO,Montgomery ,2018,0,11488,5762,5726,50.15668524
MO,Montgomery ,2019,0,11551,5787,5764,50.09955848
MO,Morgan ,2015,0,20065,10101,9964,50.34139048
MO,Morgan ,2016,0,20089,10100,9989,50.2762706
MO,Morgan ,2017,0,20162,10138,10024,50.28271005
MO,Morgan ,2018,0,20414,10232,10182,50.12246498
MO,Morgan ,2019,0,20627,10355,10272,50.20119261
MO,New Madrid ,2015,0,18067,8684,9383,48.06553385
MO,New Madrid ,2016,0,17839,8565,9274,48.01278099
MO,New Madrid ,2017,0,17544,8436,9108,48.08481532
MO,New Madrid ,2018,0,17272,8317,8955,48.15308013
MO,New Madrid ,2019,0,17076,8211,8865,48.08503162
MO,Newton ,2015,0,58138,28873,29265,49.6628711
MO,Newton ,2016,0,58178,28901,29277,49.67685379
MO,Newton ,2017,0,58191,28948,29243,49.74652438
MO,Newton ,2018,0,58158,28969,29189,49.81086007
MO,Newton ,2019,0,58236,28999,29237,49.79565904
MO,Nodaway ,2015,0,22625,11367,11258,50.24088398
MO,Nodaway ,2016,0,22455,11272,11183,50.19817413
MO,Nodaway ,2017,0,22401,11262,11139,50.27454132
MO,Nodaway ,2018,0,22223,11205,11018,50.42073527
MO,Nodaway ,2019,0,22092,11076,11016,50.13579576
MO,Oregon ,2015,0,10850,5311,5539,48.94930876
MO,Oregon ,2016,0,10746,5287,5459,49.19970221
MO,Oregon ,2017,0,10553,5172,5381,49.00976026
MO,Oregon ,2018,0,10558,5184,5374,49.10020837
MO,Oregon ,2019,0,10529,5180,5349,49.19745465
MO,Osage ,2015,0,13538,6998,6540,51.69153494
MO,Osage ,2016,0,13613,7028,6585,51.62712113
MO,Osage ,2017,0,13658,7047,6611,51.59613413
MO,Osage ,2018,0,13652,7034,6618,51.52358629
MO,Osage ,2019,0,13615,7016,6599,51.53139919
MO,Ozark ,2015,0,9364,4730,4634,50.51260145
MO,Ozark ,2016,0,9199,4614,4585,50.15762583
MO,Ozark ,2017,0,9227,4616,4611,50.0270944
MO,Ozark ,2018,0,9070,4550,4520,50.16538037
MO,Ozark ,2019,0,9174,4603,4571,50.17440593
MO,Pemiscot ,2015,0,17410,8227,9183,47.25445146
MO,Pemiscot ,2016,0,17060,8069,8991,47.29777257
MO,Pemiscot ,2017,0,16783,7920,8863,47.19060955
MO,Pemiscot ,2018,0,16256,7667,8589,47.16412402
MO,Pemiscot ,2019,0,15805,7431,8374,47.01676685
MO,Perry ,2015,0,19068,9489,9579,49.76400252
MO,Perry ,2016,0,19216,9553,9663,49.71378018
MO,Perry ,2017,0,19262,9604,9658,49.85982764
MO,Perry ,2018,0,19274,9627,9647,49.94811663
MO,Perry ,2019,0,19136,9526,9610,49.78051839
MO,Pettis ,2015,0,42300,20835,21465,49.25531915
MO,Pettis ,2016,0,42249,20872,21377,49.40235272
MO,Pettis ,2017,0,42445,21027,21418,49.53940393
MO,Pettis ,2018,0,42441,21064,21377,49.6312528
MO,Pettis ,2019,0,42339,21003,21336,49.60674555
MO,Phelps ,2015,0,44766,23436,21330,52.3522316
MO,Phelps ,2016,0,44708,23358,21350,52.2456831
MO,Phelps ,2017,0,44551,23284,21267,52.26369778
MO,Phelps ,2018,0,44551,23265,21286,52.22105003
MO,Phelps ,2019,0,44573,23285,21288,52.24014538
MO,Pike ,2015,0,18409,10094,8315,54.83187571
MO,Pike ,2016,0,18507,10206,8301,55.14670125
MO,Pike ,2017,0,18557,10201,8356,54.97116991
MO,Pike ,2018,0,18502,10245,8257,55.37239217
MO,Pike ,2019,0,18302,10129,8173,55.34367829
MO,Platte ,2015,0,96445,47655,48790,49.41158173
MO,Platte ,2016,0,98641,48671,49970,49.34155169
MO,Platte ,2017,0,101141,49852,51289,49.2896056
MO,Platte ,2018,0,102764,50638,52126,49.27601105
MO,Platte ,2019,0,104418,51565,52853,49.3832481
MO,Polk ,2015,0,31256,15324,15932,49.02738674
MO,Polk ,2016,0,31380,15346,16034,48.90376036
MO,Polk ,2017,0,31742,15542,16200,48.96351837
MO,Polk ,2018,0,32214,15814,16400,49.09045757
MO,Polk ,2019,0,32149,15828,16321,49.23325764
MO,Pulaski ,2015,0,53204,30271,22933,56.89609804
MO,Pulaski ,2016,0,52456,29843,22613,56.89149001
MO,Pulaski ,2017,0,51862,29426,22436,56.73903822
MO,Pulaski ,2018,0,51997,29408,22589,56.55710906
MO,Pulaski ,2019,0,52607,29616,22991,56.29669055
MO,Putnam ,2015,0,4860,2458,2402,50.57613169
MO,Putnam ,2016,0,4825,2429,2396,50.34196891
MO,Putnam ,2017,0,4778,2414,2364,50.52323148
MO,Putnam ,2018,0,4748,2406,2342,50.67396799
MO,Putnam ,2019,0,4696,2374,2322,50.55366269
MO,Ralls ,2015,0,10169,5119,5050,50.3392664
MO,Ralls ,2016,0,10230,5177,5053,50.60606061
MO,Ralls ,2017,0,10226,5148,5078,50.34226482
MO,Ralls ,2018,0,10234,5154,5080,50.36153996
MO,Ralls ,2019,0,10309,5183,5126,50.27645746
MO,Randolph ,2015,0,25041,13115,11926,52.37410647
MO,Randolph ,2016,0,24970,13125,11845,52.56307569
MO,Randolph ,2017,0,24899,13068,11831,52.4840355
MO,Randolph ,2018,0,24732,12890,11842,52.1187126
MO,Randolph ,2019,0,24748,12835,11913,51.86277679
MO,Ray ,2015,0,22793,11380,11413,49.92760935
MO,Ray ,2016,0,22741,11306,11435,49.71637131
MO,Ray ,2017,0,22877,11392,11485,49.79673908
MO,Ray ,2018,0,22945,11446,11499,49.88450643
MO,Ray ,2019,0,23018,11491,11527,49.92180033
MO,Reynolds ,2015,0,6292,3238,3054,51.46217419
MO,Reynolds ,2016,0,6347,3274,3073,51.58342524
MO,Reynolds ,2017,0,6260,3231,3029,51.61341853
MO,Reynolds ,2018,0,6282,3236,3046,51.51225724
MO,Reynolds ,2019,0,6270,3245,3025,51.75438596
MO,Ripley ,2015,0,13788,6808,6980,49.37626922
MO,Ripley ,2016,0,13775,6763,7012,49.09618875
MO,Ripley ,2017,0,13565,6687,6878,49.29598231
MO,Ripley ,2018,0,13420,6650,6770,49.55290611
MO,Ripley ,2019,0,13288,6601,6687,49.67639976
MO,St. Charles ,2015,0,384978,189143,195835,49.13085943
MO,St. Charles ,2016,0,390541,191890,198651,49.13440586
MO,St. Charles ,2017,0,395130,194200,200930,49.14838155
MO,St. Charles ,2018,0,398780,195979,202801,49.14464116
MO,St. Charles ,2019,0,402022,197493,204529,49.12492351
MO,St. Clair ,2015,0,9411,4733,4678,50.29221124
MO,St. Clair ,2016,0,9288,4663,4625,50.20456503
MO,St. Clair ,2017,0,9365,4705,4660,50.24025627
MO,St. Clair ,2018,0,9389,4701,4688,50.06922995
MO,St. Clair ,2019,0,9397,4751,4646,50.55868894
MO,Ste. Genevieve ,2015,0,17804,9009,8795,50.60098854
MO,Ste. Genevieve ,2016,0,17875,9059,8816,50.67972028
MO,Ste. Genevieve ,2017,0,17792,9009,8783,50.63511691
MO,Ste. Genevieve ,2018,0,17877,9045,8832,50.59573754
MO,Ste. Genevieve ,2019,0,17894,9082,8812,50.75444283
MO,St. Francois ,2015,0,66232,35348,30884,53.36997222
MO,St. Francois ,2016,0,66356,35442,30914,53.41189945
MO,St. Francois ,2017,0,66674,35676,30998,53.50811411
MO,St. Francois ,2018,0,66737,35638,31099,53.4006623
MO,St. Francois ,2019,0,67215,35876,31339,53.3749907
MO,St. Louis ,2015,0,1001109,474789,526320,47.42630423
MO,St. Louis ,2016,0,997837,473369,524468,47.43951166
MO,St. Louis ,2017,0,996227,472456,523771,47.42453276
MO,St. Louis ,2018,0,995219,472088,523131,47.43558955
MO,St. Louis ,2019,0,994205,472059,522146,47.4810527
MO,Saline ,2015,0,23226,11607,11619,49.97416688
MO,Saline ,2016,0,23095,11533,11562,49.93721585
MO,Saline ,2017,0,22910,11446,11464,49.96071584
MO,Saline ,2018,0,22890,11421,11469,49.89515072
MO,Saline ,2019,0,22761,11360,11401,49.90993366
MO,Schuyler ,2015,0,4500,2231,2269,49.57777778
MO,Schuyler ,2016,0,4501,2238,2263,49.72228394
MO,Schuyler ,2017,0,4518,2258,2260,49.97786631
MO,Schuyler ,2018,0,4594,2294,2300,49.93469743
MO,Schuyler ,2019,0,4660,2311,2349,49.59227468
MO,Scotland ,2015,0,4821,2391,2430,49.5955196
MO,Scotland ,2016,0,4902,2441,2461,49.79600163
MO,Scotland ,2017,0,4948,2446,2502,49.43411479
MO,Scotland ,2018,0,4938,2437,2501,49.35196436
MO,Scotland ,2019,0,4902,2420,2482,49.36760506
MO,Scott ,2015,0,39007,18923,20084,48.51180557
MO,Scott ,2016,0,38760,18855,19905,48.64551084
MO,Scott ,2017,0,38576,18790,19786,48.70904189
MO,Scott ,2018,0,38541,18740,19801,48.62354376
MO,Scott ,2019,0,38280,18576,19704,48.52664577
MO,Shannon ,2015,0,8273,4122,4151,49.82473105
MO,Shannon ,2016,0,8222,4091,4131,49.75675018
MO,Shannon ,2017,0,8235,4085,4150,49.60534305
MO,Shannon ,2018,0,8189,4102,4087,50.09158627
MO,Shannon ,2019,0,8166,4068,4098,49.81631154
MO,Shelby ,2015,0,6101,3039,3062,49.81150631
MO,Shelby ,2016,0,6044,3020,3024,49.96690933
MO,Shelby ,2017,0,5995,2981,3014,49.72477064
MO,Shelby ,2018,0,5997,2992,3005,49.89161247
MO,Shelby ,2019,0,5930,2981,2949,50.2698145
MO,Stoddard ,2015,0,29736,14599,15137,49.09537261
MO,Stoddard ,2016,0,29498,14542,14956,49.29825751
MO,Stoddard ,2017,0,29364,14500,14864,49.38019343
MO,Stoddard ,2018,0,29264,14439,14825,49.3404866
MO,Stoddard ,2019,0,29025,14264,14761,49.14384152
MO,Stone ,2015,0,31307,15315,15992,48.91877216
MO,Stone ,2016,0,31471,15380,16091,48.87038861
MO,Stone ,2017,0,31642,15477,16165,48.91283737
MO,Stone ,2018,0,31701,15556,16145,49.07100722
MO,Stone ,2019,0,31952,15709,16243,49.16437156
MO,Sullivan ,2015,0,6366,3270,3096,51.36663525
MO,Sullivan ,2016,0,6333,3276,3057,51.72903837
MO,Sullivan ,2017,0,6212,3185,3027,51.27173213
MO,Sullivan ,2018,0,6233,3204,3029,51.40381839
MO,Sullivan ,2019,0,6089,3107,2982,51.02644112
MO,Taney ,2015,0,54216,26291,27925,48.49306478
MO,Taney ,2016,0,54608,26458,28150,48.45077644
MO,Taney ,2017,0,55100,26617,28483,48.30671506
MO,Taney ,2018,0,55719,26910,28809,48.29591342
MO,Taney ,2019,0,55928,27017,28911,48.30675154
MO,Texas ,2015,0,25660,13333,12327,51.96024942
MO,Texas ,2016,0,25805,13474,12331,52.21468708
MO,Texas ,2017,0,25650,13441,12209,52.40155945
MO,Texas ,2018,0,25506,13406,12100,52.56018192
MO,Texas ,2019,0,25398,13322,12076,52.45294905
MO,Vernon ,2015,0,20758,10081,10677,48.5644089
MO,Vernon ,2016,0,20653,10066,10587,48.73868203
MO,Vernon ,2017,0,20507,9995,10512,48.73945482
MO,Vernon ,2018,0,20492,10026,10466,48.92641031
MO,Vernon ,2019,0,20563,10067,10496,48.95686427
MO,Warren ,2015,0,33532,16776,16756,50.02982226
MO,Warren ,2016,0,33871,16960,16911,50.07233326
MO,Warren ,2017,0,34448,17227,17221,50.00870878
MO,Warren ,2018,0,34766,17356,17410,49.92233792
MO,Warren ,2019,0,35649,17800,17849,49.93127437
MO,Washington ,2015,0,24793,12714,12079,51.2806034
MO,Washington ,2016,0,24852,12732,12120,51.23128923
MO,Washington ,2017,0,24994,12849,12145,51.408338
MO,Washington ,2018,0,24933,12836,12097,51.48197168
MO,Washington ,2019,0,24730,12725,12005,51.4557218
MO,Wayne ,2015,0,13431,6630,6801,49.363413
MO,Wayne ,2016,0,13236,6525,6711,49.29737081
MO,Wayne ,2017,0,13303,6560,6743,49.31218522
MO,Wayne ,2018,0,13132,6460,6672,49.19281145
MO,Wayne ,2019,0,12873,6328,6545,49.15715063
MO,Webster ,2015,0,37604,19081,18523,50.74194235
MO,Webster ,2016,0,38154,19432,18722,50.9304398
MO,Webster ,2017,0,38745,19800,18945,51.10336818
MO,Webster ,2018,0,39179,20035,19144,51.13708875
MO,Webster ,2019,0,39592,20255,19337,51.15932512
MO,Worth ,2015,0,2042,1002,1040,49.06953967
MO,Worth ,2016,0,2015,981,1034,48.68486352
MO,Worth ,2017,0,2041,1007,1034,49.33855953
MO,Worth ,2018,0,2026,977,1049,48.2230997
MO,Worth ,2019,0,2013,971,1042,48.23646299
MO,Wright ,2015,0,18146,8924,9222,49.1788824
MO,Wright ,2016,0,18185,8952,9233,49.22738521
MO,Wright ,2017,0,18210,8984,9226,49.33552993
MO,Wright ,2018,0,18187,8926,9261,49.07901248
MO,Wright ,2019,0,18289,8970,9319,49.04587457
MO,St. Louis city,2015,0,316010,152730,163280,48.33074903
MO,St. Louis city,2016,0,312633,151061,161572,48.31895545
MO,St. Louis city,2017,0,308233,148973,159260,48.33129483
MO,St. Louis city,2018,0,303419,146769,156650,48.37172359
MO,St. Louis city,2019,0,300576,145418,155158,48.37977749
MT,Beaverhead ,2015,0,9295,4759,4536,51.19956966
MT,Beaverhead ,2016,0,9463,4850,4613,51.25224559
MT,Beaverhead ,2017,0,9450,4825,4625,51.05820106
MT,Beaverhead ,2018,0,9412,4826,4586,51.27496813
MT,Beaverhead ,2019,0,9453,4837,4616,51.16894108
MT,Big Horn ,2015,0,13312,6576,6736,49.39903846
MT,Big Horn ,2016,0,13458,6642,6816,49.35354436
MT,Big Horn ,2017,0,13483,6660,6823,49.39553512
MT,Big Horn ,2018,0,13365,6615,6750,49.49494949
MT,Big Horn ,2019,0,13319,6553,6766,49.20039042
MT,Blaine ,2015,0,6680,3347,3333,50.10479042
MT,Blaine ,2016,0,6716,3359,3357,50.01488982
MT,Blaine ,2017,0,6745,3389,3356,50.24462565
MT,Blaine ,2018,0,6774,3395,3379,50.11809861
MT,Blaine ,2019,0,6681,3336,3345,49.93264481
MT,Broadwater ,2015,0,5714,2938,2776,51.41757088
MT,Broadwater ,2016,0,5785,2967,2818,51.28781331
MT,Broadwater ,2017,0,5917,3064,2853,51.78299814
MT,Broadwater ,2018,0,6072,3123,2949,51.43280632
MT,Broadwater ,2019,0,6237,3210,3027,51.46705147
MT,Carbon ,2015,0,10403,5276,5127,50.71613958
MT,Carbon ,2016,0,10485,5317,5168,50.71053887
MT,Carbon ,2017,0,10680,5424,5256,50.78651685
MT,Carbon ,2018,0,10691,5409,5282,50.59395753
MT,Carbon ,2019,0,10725,5425,5300,50.58275058
MT,Carter ,2015,0,1147,568,579,49.52048823
MT,Carter ,2016,0,1175,586,589,49.87234043
MT,Carter ,2017,0,1223,609,614,49.79558463
MT,Carter ,2018,0,1230,613,617,49.83739837
MT,Carter ,2019,0,1252,625,627,49.9201278
MT,Cascade ,2015,0,81878,41276,40602,50.41158797
MT,Cascade ,2016,0,81562,41261,40301,50.58850935
MT,Cascade ,2017,0,81633,41343,40290,50.64495976
MT,Cascade ,2018,0,81688,41333,40355,50.59861914
MT,Cascade ,2019,0,81366,41120,40246,50.53707937
MT,Chouteau ,2015,0,5774,2882,2892,49.91340492
MT,Chouteau ,2016,0,5780,2876,2904,49.75778547
MT,Chouteau ,2017,0,5732,2851,2881,49.73831124
MT,Chouteau ,2018,0,5740,2865,2875,49.91289199
MT,Chouteau ,2019,0,5635,2831,2804,50.23957409
MT,Custer ,2015,0,12083,6070,6013,50.23586858
MT,Custer ,2016,0,11843,5955,5888,50.28286752
MT,Custer ,2017,0,11726,5866,5860,50.02558417
MT,Custer ,2018,0,11592,5807,5785,50.09489303
MT,Custer ,2019,0,11402,5687,5715,49.87721452
MT,Daniels ,2015,0,1750,894,856,51.08571429
MT,Daniels ,2016,0,1731,889,842,51.35759676
MT,Daniels ,2017,0,1722,886,836,51.45180023
MT,Daniels ,2018,0,1729,888,841,51.35916715
MT,Daniels ,2019,0,1690,869,821,51.42011834
MT,Dawson ,2015,0,9577,4997,4580,52.17709095
MT,Dawson ,2016,0,9263,4799,4464,51.80826946
MT,Dawson ,2017,0,8952,4616,4336,51.56389634
MT,Dawson ,2018,0,8680,4475,4205,51.55529954
MT,Dawson ,2019,0,8613,4458,4155,51.758969
MT,Deer Lodge ,2015,0,9102,4842,4260,53.19709954
MT,Deer Lodge ,2016,0,9057,4821,4236,53.22954621
MT,Deer Lodge ,2017,0,9100,4850,4250,53.2967033
MT,Deer Lodge ,2018,0,9129,4892,4237,53.58746851
MT,Deer Lodge ,2019,0,9140,4896,4244,53.56673961
MT,Fallon ,2015,0,3171,1626,1545,51.27719962
MT,Fallon ,2016,0,3086,1581,1505,51.23136747
MT,Fallon ,2017,0,3004,1537,1467,51.16511318
MT,Fallon ,2018,0,2912,1483,1429,50.9271978
MT,Fallon ,2019,0,2846,1451,1395,50.98383696
MT,Fergus ,2015,0,11307,5739,5568,50.75616875
MT,Fergus ,2016,0,11349,5773,5576,50.86791788
MT,Fergus ,2017,0,11281,5741,5540,50.89087847
MT,Fergus ,2018,0,11117,5700,5417,51.2728254
MT,Fergus ,2019,0,11050,5649,5401,51.12217195
MT,Flathead ,2015,0,95839,47732,48107,49.80435939
MT,Flathead ,2016,0,97742,48737,49005,49.86290438
MT,Flathead ,2017,0,100091,49837,50254,49.79168956
MT,Flathead ,2018,0,102017,50798,51219,49.79366184
MT,Flathead ,2019,0,103806,51744,52062,49.84682966
MT,Gallatin ,2015,0,100882,52092,48790,51.63656549
MT,Gallatin ,2016,0,104739,54261,50478,51.80591757
MT,Gallatin ,2017,0,108576,56251,52325,51.80795019
MT,Gallatin ,2018,0,111682,57871,53811,51.81766086
MT,Gallatin ,2019,0,114434,59434,55000,51.93736127
MT,Garfield ,2015,0,1284,659,625,51.32398754
MT,Garfield ,2016,0,1299,658,641,50.6543495
MT,Garfield ,2017,0,1281,641,640,50.03903201
MT,Garfield ,2018,0,1257,630,627,50.11933174
MT,Garfield ,2019,0,1258,631,627,50.15898251
MT,Glacier ,2015,0,13636,6664,6972,48.87063655
MT,Glacier ,2016,0,13711,6692,7019,48.8075268
MT,Glacier ,2017,0,13732,6685,7047,48.68191087
MT,Glacier ,2018,0,13828,6683,7145,48.32947642
MT,Glacier ,2019,0,13753,6671,7082,48.50578056
MT,Golden Valley ,2015,0,818,418,400,51.1002445
MT,Golden Valley ,2016,0,810,410,400,50.61728395
MT,Golden Valley ,2017,0,817,410,407,50.18359853
MT,Golden Valley ,2018,0,822,409,413,49.756691
MT,Golden Valley ,2019,0,821,417,404,50.79171742
MT,Granite ,2015,0,3163,1604,1559,50.71134998
MT,Granite ,2016,0,3286,1678,1608,51.06512477
MT,Granite ,2017,0,3356,1717,1639,51.16209774
MT,Granite ,2018,0,3371,1728,1643,51.26075349
MT,Granite ,2019,0,3379,1731,1648,51.22817402
MT,Hill ,2015,0,16438,8331,8107,50.6813481
MT,Hill ,2016,0,16448,8292,8156,50.41342412
MT,Hill ,2017,0,16469,8327,8142,50.5616613
MT,Hill ,2018,0,16342,8229,8113,50.35491372
MT,Hill ,2019,0,16484,8335,8149,50.56418345
MT,Jefferson ,2015,0,11572,5852,5720,50.57034221
MT,Jefferson ,2016,0,11779,5968,5811,50.66644028
MT,Jefferson ,2017,0,11921,6034,5887,50.61655901
MT,Jefferson ,2018,0,12094,6110,5984,50.52091946
MT,Jefferson ,2019,0,12221,6234,5987,51.0105556
MT,Judith Basin ,2015,0,1931,1010,921,52.30450544
MT,Judith Basin ,2016,0,1940,1013,927,52.21649485
MT,Judith Basin ,2017,0,1945,1005,940,51.67095116
MT,Judith Basin ,2018,0,1946,1004,942,51.59301131
MT,Judith Basin ,2019,0,2007,1022,985,50.92177379
MT,Lake ,2015,0,29457,14574,14883,49.47550667
MT,Lake ,2016,0,29709,14626,15083,49.2308728
MT,Lake ,2017,0,30221,14903,15318,49.31339135
MT,Lake ,2018,0,30220,14923,15297,49.3812045
MT,Lake ,2019,0,30458,15017,15441,49.30395955
MT,Lewis Clark ,2015,0,66225,32863,33362,49.62325406
MT,Lewis Clark ,2016,0,66894,33067,33827,49.43193709
MT,Lewis Clark ,2017,0,67850,33478,34372,49.34119381
MT,Lewis Clark ,2018,0,68622,33970,34652,49.50307482
MT,Lewis Clark ,2019,0,69432,34370,35062,49.5016707
MT,Liberty ,2015,0,2391,1147,1244,47.97156002
MT,Liberty ,2016,0,2409,1163,1246,48.27729348
MT,Liberty ,2017,0,2407,1167,1240,48.48358953
MT,Liberty ,2018,0,2416,1166,1250,48.2615894
MT,Liberty ,2019,0,2337,1132,1205,48.43816859
MT,Lincoln ,2015,0,19060,9632,9428,50.53515215
MT,Lincoln ,2016,0,19294,9711,9583,50.33170934
MT,Lincoln ,2017,0,19556,9863,9693,50.43464921
MT,Lincoln ,2018,0,19797,9965,9832,50.33590948
MT,Lincoln ,2019,0,19980,10008,9972,50.09009009
MT,McCone ,2015,0,1700,868,832,51.05882353
MT,McCone ,2016,0,1732,886,846,51.15473441
MT,McCone ,2017,0,1698,876,822,51.59010601
MT,McCone ,2018,0,1669,858,811,51.40802876
MT,McCone ,2019,0,1664,855,809,51.38221154
MT,Madison ,2015,0,8026,4209,3817,52.44206329
MT,Madison ,2016,0,8062,4222,3840,52.36913917
MT,Madison ,2017,0,8291,4365,3926,52.64744904
MT,Madison ,2018,0,8530,4473,4057,52.43845252
MT,Madison ,2019,0,8600,4522,4078,52.58139535
MT,Meagher ,2015,0,1821,923,898,50.68643602
MT,Meagher ,2016,0,1845,939,906,50.89430894
MT,Meagher ,2017,0,1852,939,913,50.70194384
MT,Meagher ,2018,0,1857,934,923,50.29617663
MT,Meagher ,2019,0,1862,954,908,51.23523093
MT,Mineral ,2015,0,4192,2150,2042,51.28816794
MT,Mineral ,2016,0,4124,2088,2036,50.63045587
MT,Mineral ,2017,0,4235,2159,2076,50.97992916
MT,Mineral ,2018,0,4307,2187,2120,50.77780358
MT,Mineral ,2019,0,4397,2253,2144,51.23948146
MT,Missoula ,2015,0,114122,57368,56754,50.26901036
MT,Missoula ,2016,0,116349,58404,57945,50.19725137
MT,Missoula ,2017,0,117834,59047,58787,50.11032469
MT,Missoula ,2018,0,118640,59404,59236,50.07080243
MT,Missoula ,2019,0,119600,59827,59773,50.02257525
MT,Musselshell ,2015,0,4628,2308,2320,49.87035436
MT,Musselshell ,2016,0,4646,2314,2332,49.80628498
MT,Musselshell ,2017,0,4632,2308,2324,49.82728843
MT,Musselshell ,2018,0,4632,2337,2295,50.45336788
MT,Musselshell ,2019,0,4633,2345,2288,50.61515217
MT,Park ,2015,0,16003,8023,7980,50.13434981
MT,Park ,2016,0,16115,8103,8012,50.28234564
MT,Park ,2017,0,16386,8267,8119,50.45160503
MT,Park ,2018,0,16648,8379,8269,50.33037001
MT,Park ,2019,0,16606,8353,8253,50.30109599
MT,Petroleum ,2015,0,474,262,212,55.2742616
MT,Petroleum ,2016,0,491,269,222,54.78615071
MT,Petroleum ,2017,0,512,277,235,54.1015625
MT,Petroleum ,2018,0,512,276,236,53.90625
MT,Petroleum ,2019,0,487,266,221,54.6201232
MT,Phillips ,2015,0,4146,2079,2067,50.1447178
MT,Phillips ,2016,0,4113,2082,2031,50.61998541
MT,Phillips ,2017,0,4113,2074,2039,50.42548018
MT,Phillips ,2018,0,4060,2044,2016,50.34482759
MT,Phillips ,2019,0,3954,1995,1959,50.4552352
MT,Pondera ,2015,0,6095,2985,3110,48.97456932
MT,Pondera ,2016,0,6035,2979,3056,49.36205468
MT,Pondera ,2017,0,5968,2965,3003,49.68163539
MT,Pondera ,2018,0,5960,2978,2982,49.96644295
MT,Pondera ,2019,0,5911,2912,2999,49.26408391
MT,Powder River ,2015,0,1768,891,877,50.3959276
MT,Powder River ,2016,0,1746,882,864,50.51546392
MT,Powder River ,2017,0,1750,892,858,50.97142857
MT,Powder River ,2018,0,1720,866,854,50.34883721
MT,Powder River ,2019,0,1682,839,843,49.88109394
MT,Powell ,2015,0,6799,4189,2610,61.61200176
MT,Powell ,2016,0,6841,4210,2631,61.54071042
MT,Powell ,2017,0,6789,4199,2590,61.85005155
MT,Powell ,2018,0,6953,4343,2610,62.46224651
MT,Powell ,2019,0,6890,4334,2556,62.90275762
MT,Prairie ,2015,0,1140,584,556,51.22807018
MT,Prairie ,2016,0,1159,588,571,50.73339085
MT,Prairie ,2017,0,1099,562,537,51.13739763
MT,Prairie ,2018,0,1070,549,521,51.30841121
MT,Prairie ,2019,0,1077,544,533,50.51067781
MT,Ravalli ,2015,0,41148,20411,20737,49.60386896
MT,Ravalli ,2016,0,41918,20689,21229,49.3558853
MT,Ravalli ,2017,0,42524,21016,21508,49.42150315
MT,Ravalli ,2018,0,43166,21375,21791,49.51813928
MT,Ravalli ,2019,0,43806,21724,22082,49.59138018
MT,Richland ,2015,0,11902,6218,5684,52.24332045
MT,Richland ,2016,0,11408,5938,5470,52.05119215
MT,Richland ,2017,0,11027,5727,5300,51.93615671
MT,Richland ,2018,0,10855,5654,5201,52.08659604
MT,Richland ,2019,0,10803,5630,5173,52.1151532
MT,Roosevelt ,2015,0,11417,5739,5678,50.26714548
MT,Roosevelt ,2016,0,11225,5632,5593,50.17371938
MT,Roosevelt ,2017,0,11160,5592,5568,50.10752688
MT,Roosevelt ,2018,0,11069,5529,5540,49.95031168
MT,Roosevelt ,2019,0,11004,5514,5490,50.10905125
MT,Rosebud ,2015,0,9347,4734,4613,50.6472665
MT,Rosebud ,2016,0,9232,4663,4569,50.50909879
MT,Rosebud ,2017,0,9205,4647,4558,50.48343292
MT,Rosebud ,2018,0,9040,4563,4477,50.47566372
MT,Rosebud ,2019,0,8937,4493,4444,50.27414121
MT,Sanders ,2015,0,11293,5785,5508,51.22642345
MT,Sanders ,2016,0,11465,5890,5575,51.37374618
MT,Sanders ,2017,0,11689,5992,5697,51.26187013
MT,Sanders ,2018,0,11847,6064,5783,51.18595425
MT,Sanders ,2019,0,12113,6189,5924,51.09386609
MT,Sheridan ,2015,0,3673,1861,1812,50.66702968
MT,Sheridan ,2016,0,3608,1846,1762,51.16407982
MT,Sheridan ,2017,0,3471,1780,1691,51.28205128
MT,Sheridan ,2018,0,3386,1740,1646,51.38806852
MT,Sheridan ,2019,0,3309,1702,1607,51.435479
MT,Silver Bow ,2015,0,34691,17511,17180,50.47706898
MT,Silver Bow ,2016,0,34696,17533,17163,50.53320267
MT,Silver Bow ,2017,0,34811,17602,17209,50.56447675
MT,Silver Bow ,2018,0,34739,17535,17204,50.4764098
MT,Silver Bow ,2019,0,34915,17569,17346,50.31934699
MT,Stillwater ,2015,0,9425,4800,4625,50.92838196
MT,Stillwater ,2016,0,9360,4797,4563,51.25
MT,Stillwater ,2017,0,9419,4827,4592,51.2474785
MT,Stillwater ,2018,0,9483,4841,4642,51.04924602
MT,Stillwater ,2019,0,9642,4903,4739,50.85044597
MT,Sweet Grass ,2015,0,3620,1847,1773,51.02209945
MT,Sweet Grass ,2016,0,3616,1854,1762,51.27212389
MT,Sweet Grass ,2017,0,3676,1880,1796,51.14254625
MT,Sweet Grass ,2018,0,3703,1889,1814,51.01269241
MT,Sweet Grass ,2019,0,3737,1899,1838,50.8161627
MT,Teton ,2015,0,6062,2989,3073,49.30715935
MT,Teton ,2016,0,6011,2957,3054,49.1931459
MT,Teton ,2017,0,6091,2989,3102,49.0724019
MT,Teton ,2018,0,6117,3004,3113,49.10904038
MT,Teton ,2019,0,6147,3018,3129,49.09712055
MT,Toole ,2015,0,5077,2888,2189,56.88398661
MT,Toole ,2016,0,4951,2814,2137,56.83700263
MT,Toole ,2017,0,4860,2744,2116,56.46090535
MT,Toole ,2018,0,4835,2702,2133,55.88417787
MT,Toole ,2019,0,4736,2662,2074,56.20777027
MT,Treasure ,2015,0,684,349,335,51.02339181
MT,Treasure ,2016,0,680,339,341,49.85294118
MT,Treasure ,2017,0,673,338,335,50.22288262
MT,Treasure ,2018,0,673,337,336,50.07429421
MT,Treasure ,2019,0,696,346,350,49.71264368
MT,Valley ,2015,0,7621,3829,3792,50.2427503
MT,Valley ,2016,0,7532,3771,3761,50.06638343
MT,Valley ,2017,0,7402,3735,3667,50.45933531
MT,Valley ,2018,0,7406,3739,3667,50.48609236
MT,Valley ,2019,0,7396,3729,3667,50.41914548
MT,Wheatland ,2015,0,2111,1078,1033,51.06584557
MT,Wheatland ,2016,0,2130,1088,1042,51.07981221
MT,Wheatland ,2017,0,2161,1103,1058,51.04118464
MT,Wheatland ,2018,0,2184,1117,1067,51.14468864
MT,Wheatland ,2019,0,2126,1101,1025,51.78739417
MT,Wibaux ,2015,0,1072,536,536,50
MT,Wibaux ,2016,0,1042,530,512,50.86372361
MT,Wibaux ,2017,0,1018,519,499,50.98231827
MT,Wibaux ,2018,0,1030,530,500,51.45631068
MT,Wibaux ,2019,0,969,493,476,50.87719298
MT,Yellowstone ,2015,0,156529,76884,79645,49.1180548
MT,Yellowstone ,2016,0,157914,77726,80188,49.22046177
MT,Yellowstone ,2017,0,159266,78357,80909,49.19882461
MT,Yellowstone ,2018,0,160029,78695,81334,49.17546195
MT,Yellowstone ,2019,0,161300,79402,81898,49.22628642
NE,Adams ,2015,0,31567,15802,15765,50.05860551
NE,Adams ,2016,0,31683,15880,15803,50.12151627
NE,Adams ,2017,0,31808,15887,15921,49.94655433
NE,Adams ,2018,0,31514,15730,15784,49.91432379
NE,Adams ,2019,0,31363,15614,15749,49.78477824
NE,Antelope ,2015,0,6415,3213,3202,50.08573655
NE,Antelope ,2016,0,6345,3189,3156,50.26004728
NE,Antelope ,2017,0,6341,3185,3156,50.22867056
NE,Antelope ,2018,0,6308,3173,3135,50.30120482
NE,Antelope ,2019,0,6298,3178,3120,50.46046364
NE,Arthur ,2015,0,451,212,239,47.00665188
NE,Arthur ,2016,0,466,229,237,49.1416309
NE,Arthur ,2017,0,455,225,230,49.45054945
NE,Arthur ,2018,0,462,230,232,49.78354978
NE,Arthur ,2019,0,463,227,236,49.02807775
NE,Banner ,2015,0,711,356,355,50.07032349
NE,Banner ,2016,0,716,353,363,49.30167598
NE,Banner ,2017,0,726,356,370,49.03581267
NE,Banner ,2018,0,725,353,372,48.68965517
NE,Banner ,2019,0,745,361,384,48.45637584
NE,Blaine ,2015,0,477,241,236,50.52410901
NE,Blaine ,2016,0,470,242,228,51.4893617
NE,Blaine ,2017,0,479,242,237,50.52192067
NE,Blaine ,2018,0,480,244,236,50.83333333
NE,Blaine ,2019,0,465,243,222,52.25806452
NE,Boone ,2015,0,5310,2656,2654,50.01883239
NE,Boone ,2016,0,5333,2663,2670,49.9343709
NE,Boone ,2017,0,5320,2649,2671,49.79323308
NE,Boone ,2018,0,5241,2607,2634,49.74241557
NE,Boone ,2019,0,5192,2576,2616,49.61479199
NE,Box Butte ,2015,0,11325,5653,5672,49.91611479
NE,Box Butte ,2016,0,11176,5555,5621,49.70472441
NE,Box Butte ,2017,0,10835,5375,5460,49.60775265
NE,Box Butte ,2018,0,10733,5341,5392,49.76241498
NE,Box Butte ,2019,0,10783,5365,5418,49.75424279
NE,Boyd ,2015,0,2002,994,1008,49.65034965
NE,Boyd ,2016,0,1980,978,1002,49.39393939
NE,Boyd ,2017,0,1955,980,975,50.12787724
NE,Boyd ,2018,0,1950,971,979,49.79487179
NE,Boyd ,2019,0,1919,955,964,49.76550287
NE,Brown ,2015,0,2982,1461,1521,48.99396378
NE,Brown ,2016,0,2980,1450,1530,48.65771812
NE,Brown ,2017,0,3000,1468,1532,48.93333333
NE,Brown ,2018,0,2967,1450,1517,48.87091338
NE,Brown ,2019,0,2955,1472,1483,49.81387479
NE,Buffalo ,2015,0,48578,24265,24313,49.95059492
NE,Buffalo ,2016,0,49104,24572,24532,50.04072988
NE,Buffalo ,2017,0,49350,24669,24681,49.98784195
NE,Buffalo ,2018,0,49352,24693,24659,50.03444643
NE,Buffalo ,2019,0,49659,24841,24818,50.02315794
NE,Burt ,2015,0,6538,3222,3316,49.28112573
NE,Burt ,2016,0,6537,3224,3313,49.3192596
NE,Burt ,2017,0,6531,3240,3291,49.60955443
NE,Burt ,2018,0,6486,3216,3270,49.58371878
NE,Burt ,2019,0,6459,3218,3241,49.82195386
NE,Butler ,2015,0,8058,4068,3990,50.48399106
NE,Butler ,2016,0,7996,4027,3969,50.36268134
NE,Butler ,2017,0,8032,4059,3973,50.53535857
NE,Butler ,2018,0,8043,4057,3986,50.4413776
NE,Butler ,2019,0,8016,4046,3970,50.4740519
NE,Cass ,2015,0,25421,12848,12573,50.54089139
NE,Cass ,2016,0,25647,12928,12719,50.40745506
NE,Cass ,2017,0,25935,13059,12876,50.35280509
NE,Cass ,2018,0,26189,13210,12979,50.44102486
NE,Cass ,2019,0,26248,13263,12985,50.52956416
NE,Cedar ,2015,0,8518,4309,4209,50.58699225
NE,Cedar ,2016,0,8604,4341,4263,50.45327755
NE,Cedar ,2017,0,8515,4299,4216,50.48737522
NE,Cedar ,2018,0,8453,4284,4169,50.68023187
NE,Cedar ,2019,0,8402,4276,4126,50.89264461
NE,Chase ,2015,0,3963,1952,2011,49.25561443
NE,Chase ,2016,0,3914,1937,1977,49.4890138
NE,Chase ,2017,0,3928,1932,1996,49.18533605
NE,Chase ,2018,0,3937,1943,1994,49.3522987
NE,Chase ,2019,0,3924,1926,1998,49.08256881
NE,Cherry ,2015,0,5824,2916,2908,50.06868132
NE,Cherry ,2016,0,5829,2956,2873,50.71195745
NE,Cherry ,2017,0,5790,2945,2845,50.86355786
NE,Cherry ,2018,0,5763,2921,2842,50.68540691
NE,Cherry ,2019,0,5689,2903,2786,51.02830023
NE,Cheyenne ,2015,0,10137,5090,5047,50.21209431
NE,Cheyenne ,2016,0,10047,5048,4999,50.24385389
NE,Cheyenne ,2017,0,9644,4866,4778,50.45624222
NE,Cheyenne ,2018,0,9282,4676,4606,50.37707391
NE,Cheyenne ,2019,0,8910,4472,4438,50.19079686
NE,Clay ,2015,0,6291,3233,3058,51.39087585
NE,Clay ,2016,0,6135,3136,2999,51.11654442
NE,Clay ,2017,0,6186,3153,3033,50.9699321
NE,Clay ,2018,0,6202,3173,3029,51.16091583
NE,Clay ,2019,0,6203,3158,3045,50.91084959
NE,Colfax ,2015,0,10717,5592,5125,52.17878138
NE,Colfax ,2016,0,10712,5655,5057,52.79126214
NE,Colfax ,2017,0,10700,5684,5016,53.12149533
NE,Colfax ,2018,0,10734,5713,5021,53.22340227
NE,Colfax ,2019,0,10709,5730,4979,53.50639649
NE,Cuming ,2015,0,9075,4549,4526,50.12672176
NE,Cuming ,2016,0,8957,4490,4467,50.1283912
NE,Cuming ,2017,0,8947,4488,4459,50.1620655
NE,Cuming ,2018,0,8935,4476,4459,50.09513151
NE,Cuming ,2019,0,8846,4435,4411,50.13565453
NE,Custer ,2015,0,10828,5364,5464,49.53823421
NE,Custer ,2016,0,10824,5367,5457,49.58425721
NE,Custer ,2017,0,10869,5386,5483,49.5537768
NE,Custer ,2018,0,10830,5387,5443,49.74145891
NE,Custer ,2019,0,10777,5372,5405,49.84689617
NE,Dakota ,2015,0,20550,10289,10261,50.06812652
NE,Dakota ,2016,0,20279,10174,10105,50.17012673
NE,Dakota ,2017,0,20010,10101,9909,50.47976012
NE,Dakota ,2018,0,20002,10122,9880,50.60493951
NE,Dakota ,2019,0,20026,10178,9848,50.82392889
NE,Dawes ,2015,0,8958,4428,4530,49.43067649
NE,Dawes ,2016,0,8911,4434,4477,49.75872517
NE,Dawes ,2017,0,8888,4434,4454,49.88748875
NE,Dawes ,2018,0,8705,4333,4372,49.77599081
NE,Dawes ,2019,0,8589,4257,4332,49.56339504
NE,Dawson ,2015,0,23892,12209,11683,51.10078687
NE,Dawson ,2016,0,23779,12219,11560,51.38567644
NE,Dawson ,2017,0,23657,12236,11421,51.72253456
NE,Dawson ,2018,0,23744,12328,11416,51.92048518
NE,Dawson ,2019,0,23595,12278,11317,52.0364484
NE,Deuel ,2015,0,1910,929,981,48.63874346
NE,Deuel ,2016,0,1861,908,953,48.7909726
NE,Deuel ,2017,0,1861,914,947,49.1133799
NE,Deuel ,2018,0,1821,902,919,49.5332235
NE,Deuel ,2019,0,1794,897,897,50
NE,Dixon ,2015,0,5769,2954,2815,51.20471486
NE,Dixon ,2016,0,5742,2947,2795,51.32358063
NE,Dixon ,2017,0,5746,2938,2808,51.13122172
NE,Dixon ,2018,0,5700,2904,2796,50.94736842
NE,Dixon ,2019,0,5636,2869,2767,50.90489709
NE,Dodge ,2015,0,36567,18086,18481,49.45989553
NE,Dodge ,2016,0,36677,18192,18485,49.60056711
NE,Dodge ,2017,0,36789,18210,18579,49.4984914
NE,Dodge ,2018,0,36725,18234,18491,49.65010211
NE,Dodge ,2019,0,36565,18196,18369,49.76343498
NE,Douglas ,2015,0,549029,270692,278337,49.30377084
NE,Douglas ,2016,0,555607,273986,281621,49.31291362
NE,Douglas ,2017,0,560733,276542,284191,49.31794633
NE,Douglas ,2018,0,566391,279315,287076,49.31487259
NE,Douglas ,2019,0,571327,281824,289503,49.32796805
NE,Dundy ,2015,0,1770,877,893,49.5480226
NE,Dundy ,2016,0,1806,904,902,50.05537099
NE,Dundy ,2017,0,1783,897,886,50.30846887
NE,Dundy ,2018,0,1764,878,886,49.77324263
NE,Dundy ,2019,0,1693,845,848,49.91139988
NE,Fillmore ,2015,0,5553,2770,2783,49.88294616
NE,Fillmore ,2016,0,5622,2795,2827,49.71540377
NE,Fillmore ,2017,0,5561,2777,2784,49.93706168
NE,Fillmore ,2018,0,5535,2767,2768,49.99096658
NE,Fillmore ,2019,0,5462,2741,2721,50.18308312
NE,Franklin ,2015,0,2977,1487,1490,49.94961371
NE,Franklin ,2016,0,2994,1468,1526,49.03139613
NE,Franklin ,2017,0,2974,1461,1513,49.12575656
NE,Franklin ,2018,0,3013,1483,1530,49.22004647
NE,Franklin ,2019,0,2979,1473,1506,49.44612286
NE,Frontier ,2015,0,2631,1344,1287,51.08323831
NE,Frontier ,2016,0,2645,1346,1299,50.88846881
NE,Frontier ,2017,0,2623,1337,1286,50.97216927
NE,Frontier ,2018,0,2600,1329,1271,51.11538462
NE,Frontier ,2019,0,2627,1325,1302,50.43776171
NE,Furnas ,2015,0,4831,2382,2449,49.30656179
NE,Furnas ,2016,0,4762,2345,2417,49.24401512
NE,Furnas ,2017,0,4763,2370,2393,49.75855553
NE,Furnas ,2018,0,4701,2342,2359,49.81918741
NE,Furnas ,2019,0,4676,2319,2357,49.5936698
NE,Gage ,2015,0,21715,10777,10938,49.62928851
NE,Gage ,2016,0,21625,10760,10865,49.75722543
NE,Gage ,2017,0,21621,10820,10801,50.04393876
NE,Gage ,2018,0,21495,10736,10759,49.94649919
NE,Gage ,2019,0,21513,10741,10772,49.92795054
NE,Garden ,2015,0,1916,979,937,51.0960334
NE,Garden ,2016,0,1907,997,910,52.28106974
NE,Garden ,2017,0,1890,993,897,52.53968254
NE,Garden ,2018,0,1890,989,901,52.32804233
NE,Garden ,2019,0,1837,960,877,52.25911813
NE,Garfield ,2015,0,2014,996,1018,49.45382324
NE,Garfield ,2016,0,1994,979,1015,49.09729188
NE,Garfield ,2017,0,1986,976,1010,49.14400806
NE,Garfield ,2018,0,1974,975,999,49.39209726
NE,Garfield ,2019,0,1969,985,984,50.0253936
NE,Gosper ,2015,0,2025,1039,986,51.30864198
NE,Gosper ,2016,0,2025,1054,971,52.04938272
NE,Gosper ,2017,0,2028,1034,994,50.98619329
NE,Gosper ,2018,0,1996,1016,980,50.90180361
NE,Gosper ,2019,0,1990,1011,979,50.8040201
NE,Grant ,2015,0,646,339,307,52.47678019
NE,Grant ,2016,0,665,344,321,51.72932331
NE,Grant ,2017,0,649,337,312,51.92604006
NE,Grant ,2018,0,657,345,312,52.51141553
NE,Grant ,2019,0,623,326,297,52.32744783
NE,Greeley ,2015,0,2435,1204,1231,49.44558522
NE,Greeley ,2016,0,2400,1183,1217,49.29166667
NE,Greeley ,2017,0,2363,1166,1197,49.34405417
NE,Greeley ,2018,0,2355,1150,1205,48.83227176
NE,Greeley ,2019,0,2356,1164,1192,49.4057725
NE,Hall ,2015,0,61132,30734,30398,50.27481515
NE,Hall ,2016,0,61353,30894,30459,50.35450589
NE,Hall ,2017,0,61201,30904,30297,50.49590693
NE,Hall ,2018,0,61286,30960,30326,50.51724701
NE,Hall ,2019,0,61353,31024,30329,50.56639447
NE,Hamilton ,2015,0,9141,4575,4566,50.04922875
NE,Hamilton ,2016,0,9158,4554,4604,49.72701463
NE,Hamilton ,2017,0,9194,4594,4600,49.96737002
NE,Hamilton ,2018,0,9260,4648,4612,50.19438445
NE,Hamilton ,2019,0,9324,4705,4619,50.46117546
NE,Harlan ,2015,0,3441,1770,1671,51.43853531
NE,Harlan ,2016,0,3451,1768,1683,51.23152709
NE,Harlan ,2017,0,3415,1763,1652,51.62518302
NE,Harlan ,2018,0,3386,1747,1639,51.59480213
NE,Harlan ,2019,0,3380,1746,1634,51.65680473
NE,Hayes ,2015,0,915,481,434,52.56830601
NE,Hayes ,2016,0,891,460,431,51.62738496
NE,Hayes ,2017,0,893,452,441,50.61590146
NE,Hayes ,2018,0,917,470,447,51.25408942
NE,Hayes ,2019,0,922,469,453,50.86767896
NE,Hitchcock ,2015,0,2879,1418,1461,49.25321292
NE,Hitchcock ,2016,0,2828,1405,1423,49.68175389
NE,Hitchcock ,2017,0,2806,1406,1400,50.10691376
NE,Hitchcock ,2018,0,2801,1399,1402,49.9464477
NE,Hitchcock ,2019,0,2762,1378,1384,49.89138306
NE,Holt ,2015,0,10263,5101,5162,49.70281594
NE,Holt ,2016,0,10223,5076,5147,49.65274381
NE,Holt ,2017,0,10182,5093,5089,50.01964251
NE,Holt ,2018,0,10148,5071,5077,49.97043752
NE,Holt ,2019,0,10067,5035,5032,50.01490017
NE,Hooker ,2015,0,714,343,371,48.03921569
NE,Hooker ,2016,0,683,330,353,48.31625183
NE,Hooker ,2017,0,666,318,348,47.74774775
NE,Hooker ,2018,0,676,325,351,48.07692308
NE,Hooker ,2019,0,682,328,354,48.09384164
NE,Howard ,2015,0,6382,3220,3162,50.45440301
NE,Howard ,2016,0,6407,3269,3138,51.02231934
NE,Howard ,2017,0,6396,3252,3144,50.84427767
NE,Howard ,2018,0,6457,3289,3168,50.93696763
NE,Howard ,2019,0,6445,3287,3158,51.0007758
NE,Jefferson ,2015,0,7221,3572,3649,49.46683285
NE,Jefferson ,2016,0,7181,3554,3627,49.49171425
NE,Jefferson ,2017,0,7176,3527,3649,49.14994426
NE,Jefferson ,2018,0,7098,3495,3603,49.23922232
NE,Jefferson ,2019,0,7046,3449,3597,48.94975873
NE,Johnson ,2015,0,5239,3075,2164,58.69440733
NE,Johnson ,2016,0,5213,3062,2151,58.73777096
NE,Johnson ,2017,0,5169,3053,2116,59.06364867
NE,Johnson ,2018,0,5115,3007,2108,58.78787879
NE,Johnson ,2019,0,5071,3001,2070,59.17964898
NE,Kearney ,2015,0,6558,3241,3317,49.42055505
NE,Kearney ,2016,0,6561,3265,3296,49.76375553
NE,Kearney ,2017,0,6492,3234,3258,49.81515712
NE,Kearney ,2018,0,6539,3259,3280,49.83942499
NE,Kearney ,2019,0,6495,3242,3253,49.91531948
NE,Keith ,2015,0,8136,4110,4026,50.51622419
NE,Keith ,2016,0,8096,4073,4023,50.30879447
NE,Keith ,2017,0,8070,4053,4017,50.22304833
NE,Keith ,2018,0,8003,4034,3969,50.40609771
NE,Keith ,2019,0,8034,4052,3982,50.43564849
NE,Keya Paha ,2015,0,797,392,405,49.18444166
NE,Keya Paha ,2016,0,792,385,407,48.61111111
NE,Keya Paha ,2017,0,790,384,406,48.60759494
NE,Keya Paha ,2018,0,806,393,413,48.75930521
NE,Keya Paha ,2019,0,806,397,409,49.25558313
NE,Kimball ,2015,0,3716,1895,1821,50.99569429
NE,Kimball ,2016,0,3669,1838,1831,50.09539384
NE,Kimball ,2017,0,3568,1785,1783,50.02802691
NE,Kimball ,2018,0,3578,1774,1804,49.58077138
NE,Kimball ,2019,0,3632,1801,1831,49.58700441
NE,Knox ,2015,0,8468,4170,4298,49.24421351
NE,Knox ,2016,0,8484,4180,4304,49.26921264
NE,Knox ,2017,0,8439,4163,4276,49.33048939
NE,Knox ,2018,0,8405,4166,4239,49.56573468
NE,Knox ,2019,0,8332,4124,4208,49.49591935
NE,Lancaster ,2015,0,306096,153564,152532,50.16857456
NE,Lancaster ,2016,0,310306,155768,154538,50.19819146
NE,Lancaster ,2017,0,313772,157613,156159,50.2316969
NE,Lancaster ,2018,0,316527,158864,157663,50.18971525
NE,Lancaster ,2019,0,319090,160211,158879,50.20871854
NE,Lincoln ,2015,0,35501,17537,17964,49.39860849
NE,Lincoln ,2016,0,35487,17510,17977,49.34201257
NE,Lincoln ,2017,0,35265,17419,17846,49.39458387
NE,Lincoln ,2018,0,35148,17379,17769,49.44520314
NE,Lincoln ,2019,0,34914,17303,17611,49.55891619
NE,Logan ,2015,0,791,409,382,51.70670038
NE,Logan ,2016,0,792,416,376,52.52525253
NE,Logan ,2017,0,765,397,368,51.89542484
NE,Logan ,2018,0,755,399,356,52.84768212
NE,Logan ,2019,0,748,396,352,52.94117647
NE,Loup ,2015,0,606,316,290,52.14521452
NE,Loup ,2016,0,616,320,296,51.94805195
NE,Loup ,2017,0,604,317,287,52.48344371
NE,Loup ,2018,0,617,317,300,51.37763371
NE,Loup ,2019,0,664,337,327,50.75301205
NE,McPherson ,2015,0,489,244,245,49.89775051
NE,McPherson ,2016,0,503,239,264,47.51491054
NE,McPherson ,2017,0,493,246,247,49.89858012
NE,McPherson ,2018,0,490,248,242,50.6122449
NE,McPherson ,2019,0,494,243,251,49.1902834
NE,Madison ,2015,0,34999,17394,17605,49.69856282
NE,Madison ,2016,0,34979,17355,17624,49.61548358
NE,Madison ,2017,0,35132,17450,17682,49.66981669
NE,Madison ,2018,0,35189,17490,17699,49.7030322
NE,Madison ,2019,0,35099,17439,17660,49.68517622
NE,Merrick ,2015,0,7805,3928,3877,50.32671365
NE,Merrick ,2016,0,7838,3916,3922,49.96172493
NE,Merrick ,2017,0,7859,3957,3902,50.34991729
NE,Merrick ,2018,0,7733,3873,3860,50.08405535
NE,Merrick ,2019,0,7755,3906,3849,50.36750484
NE,Morrill ,2015,0,4925,2458,2467,49.90862944
NE,Morrill ,2016,0,4867,2461,2406,50.56502979
NE,Morrill ,2017,0,4796,2437,2359,50.81317765
NE,Morrill ,2018,0,4674,2385,2289,51.02695764
NE,Morrill ,2019,0,4642,2371,2271,51.07712193
NE,Nance ,2015,0,3573,1787,1786,50.01399384
NE,Nance ,2016,0,3561,1768,1793,49.64897501
NE,Nance ,2017,0,3561,1772,1789,49.761303
NE,Nance ,2018,0,3506,1744,1762,49.7432972
NE,Nance ,2019,0,3519,1750,1769,49.73003694
NE,Nemaha ,2015,0,7005,3454,3551,49.3076374
NE,Nemaha ,2016,0,6973,3453,3520,49.51957551
NE,Nemaha ,2017,0,6957,3456,3501,49.67658473
NE,Nemaha ,2018,0,6957,3472,3485,49.90656892
NE,Nemaha ,2019,0,6972,3493,3479,50.10040161
NE,Nuckolls ,2015,0,4322,2135,2187,49.39842665
NE,Nuckolls ,2016,0,4274,2111,2163,49.39167057
NE,Nuckolls ,2017,0,4269,2104,2165,49.28554697
NE,Nuckolls ,2018,0,4207,2085,2122,49.56025671
NE,Nuckolls ,2019,0,4148,2059,2089,49.63837994
NE,Otoe ,2015,0,15842,7842,8000,49.50132559
NE,Otoe ,2016,0,15950,7930,8020,49.71786834
NE,Otoe ,2017,0,15956,7943,8013,49.78064678
NE,Otoe ,2018,0,15983,7953,8030,49.75911906
NE,Otoe ,2019,0,16012,7976,8036,49.81264052
NE,Pawnee ,2015,0,2691,1330,1361,49.42400595
NE,Pawnee ,2016,0,2699,1327,1372,49.16635791
NE,Pawnee ,2017,0,2621,1290,1331,49.21785578
NE,Pawnee ,2018,0,2623,1294,1329,49.33282501
NE,Pawnee ,2019,0,2613,1289,1324,49.33027172
NE,Perkins ,2015,0,2932,1496,1436,51.02319236
NE,Perkins ,2016,0,2892,1483,1409,51.27939142
NE,Perkins ,2017,0,2886,1484,1402,51.42065142
NE,Perkins ,2018,0,2902,1482,1420,51.06822881
NE,Perkins ,2019,0,2891,1479,1412,51.15876859
NE,Phelps ,2015,0,9217,4595,4622,49.85353152
NE,Phelps ,2016,0,9193,4604,4589,50.08158381
NE,Phelps ,2017,0,9050,4527,4523,50.02209945
NE,Phelps ,2018,0,9006,4502,4504,49.98889629
NE,Phelps ,2019,0,9034,4527,4507,50.11069294
NE,Pierce ,2015,0,7190,3589,3601,49.91655076
NE,Pierce ,2016,0,7144,3579,3565,50.09798432
NE,Pierce ,2017,0,7093,3568,3525,50.30311575
NE,Pierce ,2018,0,7145,3606,3539,50.46885934
NE,Pierce ,2019,0,7148,3619,3529,50.62954673
NE,Platte ,2015,0,32876,16567,16309,50.3923835
NE,Platte ,2016,0,33008,16714,16294,50.6362094
NE,Platte ,2017,0,33231,16874,16357,50.77788812
NE,Platte ,2018,0,33287,16923,16364,50.83966714
NE,Platte ,2019,0,33470,17009,16461,50.81864356
NE,Polk ,2015,0,5171,2560,2611,49.50686521
NE,Polk ,2016,0,5190,2585,2605,49.80732177
NE,Polk ,2017,0,5309,2639,2670,49.70804295
NE,Polk ,2018,0,5240,2599,2641,49.59923664
NE,Polk ,2019,0,5213,2602,2611,49.91367735
NE,Red Willow ,2015,0,10883,5443,5440,50.01378296
NE,Red Willow ,2016,0,10767,5378,5389,49.94891799
NE,Red Willow ,2017,0,10760,5331,5429,49.54460967
NE,Red Willow ,2018,0,10705,5322,5383,49.71508641
NE,Red Willow ,2019,0,10724,5349,5375,49.87877658
NE,Richardson ,2015,0,8025,3998,4027,49.81931464
NE,Richardson ,2016,0,8004,3985,4019,49.7876062
NE,Richardson ,2017,0,7971,3973,3998,49.84318153
NE,Richardson ,2018,0,7938,3975,3963,50.07558579
NE,Richardson ,2019,0,7865,3957,3908,50.31150668
NE,Rock ,2015,0,1417,707,710,49.89414255
NE,Rock ,2016,0,1404,702,702,50
NE,Rock ,2017,0,1420,713,707,50.21126761
NE,Rock ,2018,0,1351,677,674,50.11102887
NE,Rock ,2019,0,1357,676,681,49.81577008
NE,Saline ,2015,0,14196,7248,6948,51.05663567
NE,Saline ,2016,0,14228,7281,6947,51.17374192
NE,Saline ,2017,0,14365,7382,6983,51.3887922
NE,Saline ,2018,0,14336,7362,6974,51.35323661
NE,Saline ,2019,0,14224,7318,6906,51.44825647
NE,Sarpy ,2015,0,175173,87498,87675,49.94947852
NE,Sarpy ,2016,0,178355,89317,89038,50.0782148
NE,Sarpy ,2017,0,181376,90918,90458,50.1268084
NE,Sarpy ,2018,0,184062,92200,91862,50.09181689
NE,Sarpy ,2019,0,187196,93867,93329,50.14369965
NE,Saunders ,2015,0,20949,10599,10350,50.59430044
NE,Saunders ,2016,0,20992,10622,10370,50.60022866
NE,Saunders ,2017,0,21032,10640,10392,50.58957779
NE,Saunders ,2018,0,21274,10762,10512,50.58757168
NE,Saunders ,2019,0,21578,10950,10628,50.74613032
NE,Scotts Bluff ,2015,0,36245,17620,18625,48.61360188
NE,Scotts Bluff ,2016,0,36420,17691,18729,48.57495881
NE,Scotts Bluff ,2017,0,36160,17568,18592,48.5840708
NE,Scotts Bluff ,2018,0,35925,17453,18472,48.58176757
NE,Scotts Bluff ,2019,0,35618,17319,18299,48.62429109
NE,Seward ,2015,0,16994,8674,8320,51.04154407
NE,Seward ,2016,0,17103,8717,8386,50.96766649
NE,Seward ,2017,0,17203,8740,8463,50.80509214
NE,Seward ,2018,0,17273,8821,8452,51.06814103
NE,Seward ,2019,0,17284,8842,8442,51.15713955
NE,Sheridan ,2015,0,5216,2561,2655,49.09892638
NE,Sheridan ,2016,0,5235,2574,2661,49.16905444
NE,Sheridan ,2017,0,5268,2595,2673,49.25968109
NE,Sheridan ,2018,0,5189,2563,2626,49.39294662
NE,Sheridan ,2019,0,5246,2588,2658,49.33282501
NE,Sherman ,2015,0,3036,1519,1517,50.03293808
NE,Sherman ,2016,0,3012,1492,1520,49.53519256
NE,Sherman ,2017,0,3074,1529,1545,49.73975277
NE,Sherman ,2018,0,3044,1502,1542,49.34296978
NE,Sherman ,2019,0,3001,1473,1528,49.08363879
NE,Sioux ,2015,0,1276,662,614,51.88087774
NE,Sioux ,2016,0,1259,654,605,51.94598888
NE,Sioux ,2017,0,1195,615,580,51.46443515
NE,Sioux ,2018,0,1186,608,578,51.26475548
NE,Sioux ,2019,0,1166,603,563,51.71526587
NE,Stanton ,2015,0,5944,3014,2930,50.70659489
NE,Stanton ,2016,0,5975,3036,2939,50.81171548
NE,Stanton ,2017,0,5974,3026,2948,50.65282893
NE,Stanton ,2018,0,5970,3018,2952,50.55276382
NE,Stanton ,2019,0,5920,3004,2916,50.74324324
NE,Thayer ,2015,0,5129,2534,2595,49.40534217
NE,Thayer ,2016,0,5080,2527,2553,49.74409449
NE,Thayer ,2017,0,5034,2490,2544,49.4636472
NE,Thayer ,2018,0,5039,2501,2538,49.63286366
NE,Thayer ,2019,0,5003,2482,2521,49.61023386
NE,Thomas ,2015,0,693,357,336,51.51515152
NE,Thomas ,2016,0,722,374,348,51.80055402
NE,Thomas ,2017,0,722,373,349,51.66204986
NE,Thomas ,2018,0,714,365,349,51.12044818
NE,Thomas ,2019,0,722,365,357,50.55401662
NE,Thurston ,2015,0,7073,3472,3601,49.08808144
NE,Thurston ,2016,0,7139,3510,3629,49.16654994
NE,Thurston ,2017,0,7196,3528,3668,49.02723735
NE,Thurston ,2018,0,7274,3581,3693,49.23013473
NE,Thurston ,2019,0,7224,3573,3651,49.46013289
NE,Valley ,2015,0,4168,2072,2096,49.71209213
NE,Valley ,2016,0,4201,2096,2105,49.89288265
NE,Valley ,2017,0,4227,2099,2128,49.65696712
NE,Valley ,2018,0,4197,2074,2123,49.4162497
NE,Valley ,2019,0,4158,2073,2085,49.85569986
NE,Washington ,2015,0,19917,9949,9968,49.95230205
NE,Washington ,2016,0,20213,10056,10157,49.75016079
NE,Washington ,2017,0,20328,10149,10179,49.92621015
NE,Washington ,2018,0,20617,10343,10274,50.16733763
NE,Washington ,2019,0,20729,10397,10332,50.15678518
NE,Wayne ,2015,0,9366,4727,4639,50.46978433
NE,Wayne ,2016,0,9379,4733,4646,50.46380211
NE,Wayne ,2017,0,9213,4635,4578,50.30934549
NE,Wayne ,2018,0,9318,4690,4628,50.33268942
NE,Wayne ,2019,0,9385,4712,4673,50.20777837
NE,Webster ,2015,0,3592,1775,1817,49.41536748
NE,Webster ,2016,0,3566,1778,1788,49.85978688
NE,Webster ,2017,0,3505,1747,1758,49.84308131
NE,Webster ,2018,0,3534,1758,1776,49.74533107
NE,Webster ,2019,0,3487,1734,1753,49.72755951
NE,Wheeler ,2015,0,779,406,373,52.11810013
NE,Wheeler ,2016,0,804,406,398,50.49751244
NE,Wheeler ,2017,0,815,411,404,50.42944785
NE,Wheeler ,2018,0,802,411,391,51.24688279
NE,Wheeler ,2019,0,783,398,385,50.83014049
NE,York ,2015,0,13797,6746,7051,48.89468725
NE,York ,2016,0,13740,6722,7018,48.92285298
NE,York ,2017,0,13762,6739,7023,48.96817323
NE,York ,2018,0,13748,6740,7008,49.02531277
NE,York ,2019,0,13679,6702,6977,48.99480956
NV,Churchill ,2015,0,23957,12060,11897,50.34019285
NV,Churchill ,2016,0,23904,12099,11805,50.61495984
NV,Churchill ,2017,0,24021,12185,11836,50.72644769
NV,Churchill ,2018,0,24506,12447,12059,50.79164286
NV,Churchill ,2019,0,24909,12657,12252,50.81295917
NV,Clark ,2015,0,2096717,1048235,1048482,49.99410984
NV,Clark ,2016,0,2138836,1068322,1070514,49.94875717
NV,Clark ,2017,0,2181635,1088917,1092718,49.91288644
NV,Clark ,2018,0,2226115,1110429,1115686,49.88192434
NV,Clark ,2019,0,2266715,1130230,1136485,49.862025
NV,Douglas ,2015,0,47404,23880,23524,50.37549574
NV,Douglas ,2016,0,47834,24088,23746,50.35748631
NV,Douglas ,2017,0,48030,24174,23856,50.3310431
NV,Douglas ,2018,0,48489,24401,24088,50.32275361
NV,Douglas ,2019,0,48905,24552,24353,50.20345568
NV,Elko ,2015,0,51728,26975,24753,52.14777297
NV,Elko ,2016,0,52082,27092,24990,52.01797166
NV,Elko ,2017,0,52357,27215,25142,51.97967798
NV,Elko ,2018,0,52539,27300,25239,51.9614001
NV,Elko ,2019,0,52778,27428,25350,51.96862329
NV,Esmeralda ,2015,0,830,464,366,55.90361446
NV,Esmeralda ,2016,0,826,451,375,54.60048426
NV,Esmeralda ,2017,0,843,467,376,55.39739027
NV,Esmeralda ,2018,0,827,458,369,55.3808948
NV,Esmeralda ,2019,0,873,474,399,54.29553265
NV,Eureka ,2015,0,2029,1071,958,52.78462297
NV,Eureka ,2016,0,1936,1028,908,53.09917355
NV,Eureka ,2017,0,1946,1041,905,53.49434738
NV,Eureka ,2018,0,1998,1057,941,52.9029029
NV,Eureka ,2019,0,2029,1084,945,53.42533268
NV,Humboldt ,2015,0,17017,8913,8104,52.37703473
NV,Humboldt ,2016,0,16795,8777,8018,52.25960107
NV,Humboldt ,2017,0,16719,8722,7997,52.16819188
NV,Humboldt ,2018,0,16778,8728,8050,52.02050304
NV,Humboldt ,2019,0,16831,8748,8083,51.97552136
NV,Lander ,2015,0,5873,3003,2870,51.13230036
NV,Lander ,2016,0,5684,2889,2795,50.82688248
NV,Lander ,2017,0,5579,2847,2732,51.03065065
NV,Lander ,2018,0,5547,2852,2695,51.41517938
NV,Lander ,2019,0,5532,2846,2686,51.4461316
NV,Lincoln ,2015,0,5136,2737,2399,53.29049844
NV,Lincoln ,2016,0,5154,2777,2377,53.88048118
NV,Lincoln ,2017,0,5191,2796,2395,53.86245425
NV,Lincoln ,2018,0,5237,2804,2433,53.54210426
NV,Lincoln ,2019,0,5183,2770,2413,53.44395138
NV,Lyon ,2015,0,51974,26445,25529,50.88120984
NV,Lyon ,2016,0,52707,26854,25853,50.94958924
NV,Lyon ,2017,0,53895,27538,26357,51.09564895
NV,Lyon ,2018,0,55813,28574,27239,51.19595793
NV,Lyon ,2019,0,57510,29404,28106,51.12849939
NV,Mineral ,2015,0,4420,2173,2247,49.16289593
NV,Mineral ,2016,0,4376,2164,2212,49.45155393
NV,Mineral ,2017,0,4455,2220,2235,49.83164983
NV,Mineral ,2018,0,4544,2255,2289,49.62588028
NV,Mineral ,2019,0,4505,2232,2273,49.54495006
NV,Nye ,2015,0,42966,21984,20982,51.16603826
NV,Nye ,2016,0,43248,22122,21126,51.15149834
NV,Nye ,2017,0,43977,22537,21440,51.24724288
NV,Nye ,2018,0,45186,23126,22060,51.17956889
NV,Nye ,2019,0,46523,23788,22735,51.1316983
NV,Pershing ,2015,0,6618,4216,2402,63.70504684
NV,Pershing ,2016,0,6576,4216,2360,64.11192214
NV,Pershing ,2017,0,6469,4157,2312,64.26031844
NV,Pershing ,2018,0,6685,4305,2380,64.39790576
NV,Pershing ,2019,0,6725,4341,2384,64.55018587
NV,Storey ,2015,0,3876,1998,1878,51.54798762
NV,Storey ,2016,0,3986,2051,1935,51.45509282
NV,Storey ,2017,0,3976,2030,1946,51.05633803
NV,Storey ,2018,0,3981,2036,1945,51.14292891
NV,Storey ,2019,0,4123,2113,2010,51.24909047
NV,Washoe ,2015,0,442453,222804,219649,50.35653504
NV,Washoe ,2016,0,449723,226511,223212,50.36678133
NV,Washoe ,2017,0,456629,229770,226859,50.31874892
NV,Washoe ,2018,0,464354,233914,230440,50.37406806
NV,Washoe ,2019,0,471519,237894,233625,50.45268589
NV,White Pine ,2015,0,9873,5667,4206,57.39896688
NV,White Pine ,2016,0,9749,5626,4123,57.70848292
NV,White Pine ,2017,0,9651,5607,4044,58.09760647
NV,White Pine ,2018,0,9540,5529,4011,57.95597484
NV,White Pine ,2019,0,9580,5579,4001,58.23590814
NV,Carson City,2015,0,54068,27644,26424,51.12820892
NV,Carson City,2016,0,54147,27742,26405,51.2346021
NV,Carson City,2017,0,54532,28036,26496,51.41201496
NV,Carson City,2018,0,55202,28306,26896,51.27712764
NV,Carson City,2019,0,55916,28687,27229,51.30374133
NH,Belknap ,2015,0,60370,29721,30649,49.23140633
NH,Belknap ,2016,0,60747,29950,30797,49.30284623
NH,Belknap ,2017,0,60872,30026,30846,49.32645551
NH,Belknap ,2018,0,61145,30183,30962,49.36298961
NH,Belknap ,2019,0,61303,30277,31026,49.38910004
NH,Carroll ,2015,0,47399,23515,23884,49.61075128
NH,Carroll ,2016,0,47497,23649,23848,49.79051309
NH,Carroll ,2017,0,48132,23898,24234,49.65095986
NH,Carroll ,2018,0,48754,24180,24574,49.59593059
NH,Carroll ,2019,0,48910,24176,24734,49.42956451
NH,Cheshire ,2015,0,76288,37333,38955,48.93692324
NH,Cheshire ,2016,0,75975,37159,38816,48.90950971
NH,Cheshire ,2017,0,75963,37191,38772,48.95936179
NH,Cheshire ,2018,0,75901,37219,38682,49.03624458
NH,Cheshire ,2019,0,76085,37312,38773,49.0398896
NH,Coos ,2015,0,32343,17076,15267,52.79658659
NH,Coos ,2016,0,31916,16809,15107,52.66637423
NH,Coos ,2017,0,31396,16425,14971,52.3155816
NH,Coos ,2018,0,31486,16576,14910,52.64562028
NH,Coos ,2019,0,31563,16587,14976,52.55203878
NH,Grafton ,2015,0,89439,44088,45351,49.29393218
NH,Grafton ,2016,0,90004,44445,45559,49.38113862
NH,Grafton ,2017,0,89853,44319,45534,49.3238957
NH,Grafton ,2018,0,89701,44299,45402,49.38517965
NH,Grafton ,2019,0,89886,44388,45498,49.38255123
NH,Hillsborough ,2015,0,408985,203212,205773,49.68690783
NH,Hillsborough ,2016,0,411333,204484,206849,49.71252003
NH,Hillsborough ,2017,0,413204,205311,207893,49.68756353
NH,Hillsborough ,2018,0,414630,206232,208398,49.73880327
NH,Hillsborough ,2019,0,417025,207455,209570,49.74641808
NH,Merrimack ,2015,0,148649,73207,75442,49.24822905
NH,Merrimack ,2016,0,149063,73419,75644,49.25367127
NH,Merrimack ,2017,0,149830,73833,75997,49.27784823
NH,Merrimack ,2018,0,150650,74302,76348,49.32094258
NH,Merrimack ,2019,0,151391,74715,76676,49.35233931
NH,Rockingham ,2015,0,302691,149923,152768,49.5300488
NH,Rockingham ,2016,0,304377,150739,153638,49.52378136
NH,Rockingham ,2017,0,306669,151876,154793,49.52440579
NH,Rockingham ,2018,0,308287,152753,155534,49.54895925
NH,Rockingham ,2019,0,309769,153423,156346,49.52819682
NH,Strafford ,2015,0,127038,62107,64931,48.88852154
NH,Strafford ,2016,0,128311,62749,65562,48.90383521
NH,Strafford ,2017,0,129841,63635,66206,49.00994293
NH,Strafford ,2018,0,129797,63731,66066,49.1005185
NH,Strafford ,2019,0,130633,64092,66541,49.06264114
NH,Sullivan ,2015,0,43148,21273,21875,49.30240104
NH,Sullivan ,2016,0,43084,21247,21837,49.31529106
NH,Sullivan ,2017,0,43027,21267,21760,49.42710391
NH,Sullivan ,2018,0,43114,21298,21816,49.39926706
NH,Sullivan ,2019,0,43146,21368,21778,49.52486905
NJ,Atlantic ,2015,0,270153,130783,139370,48.41071541
NJ,Atlantic ,2016,0,267217,129302,137915,48.38838846
NJ,Atlantic ,2017,0,265498,128538,136960,48.41392402
NJ,Atlantic ,2018,0,263989,127784,136205,48.40504718
NJ,Atlantic ,2019,0,263670,127591,136079,48.39041226
NJ,Bergen ,2015,0,926391,448696,477695,48.43484015
NJ,Bergen ,2016,0,928120,449669,478451,48.44944619
NJ,Bergen ,2017,0,932420,452259,480161,48.50378585
NJ,Bergen ,2018,0,932816,452792,480024,48.54033379
NJ,Bergen ,2019,0,932202,452666,479536,48.55878876
NJ,Burlington ,2015,0,446832,219585,227247,49.14263079
NJ,Burlington ,2016,0,445972,219219,226753,49.15532814
NJ,Burlington ,2017,0,445610,219180,226430,49.18650838
NJ,Burlington ,2018,0,444745,218960,225785,49.23270638
NJ,Burlington ,2019,0,445349,219202,226147,49.22027444
NJ,Camden ,2015,0,507638,245065,262573,48.27554281
NJ,Camden ,2016,0,507002,244742,262260,48.2723934
NJ,Camden ,2017,0,506224,244284,261940,48.25610797
NJ,Camden ,2018,0,506353,244385,261968,48.26376066
NJ,Camden ,2019,0,506471,244430,262041,48.26140095
NJ,Cape May ,2015,0,94160,45983,48177,48.83496177
NJ,Cape May ,2016,0,93655,45759,47896,48.85911057
NJ,Cape May ,2017,0,93129,45468,47661,48.82260091
NJ,Cape May ,2018,0,92446,45130,47316,48.81768816
NJ,Cape May ,2019,0,92039,44868,47171,48.74889992
NJ,Cumberland ,2015,0,154712,79436,75276,51.34443353
NJ,Cumberland ,2016,0,153233,78529,74704,51.2480993
NJ,Cumberland ,2017,0,151423,77372,74051,51.09659695
NJ,Cumberland ,2018,0,150635,76736,73899,50.94168022
NJ,Cumberland ,2019,0,149527,76161,73366,50.93461382
NJ,Essex ,2015,0,790439,380010,410429,48.0758161
NJ,Essex ,2016,0,792689,381428,411261,48.11824057
NJ,Essex ,2017,0,796349,383287,413062,48.13053071
NJ,Essex ,2018,0,798570,384414,414156,48.13779631
NJ,Essex ,2019,0,798975,384574,414401,48.13342095
NJ,Gloucester ,2015,0,290943,141392,149551,48.59783531
NJ,Gloucester ,2016,0,290761,141215,149546,48.56738008
NJ,Gloucester ,2017,0,290961,141347,149614,48.57936287
NJ,Gloucester ,2018,0,291525,141843,149682,48.65551839
NJ,Gloucester ,2019,0,291636,141846,149790,48.63802823
NJ,Hudson ,2015,0,664492,329724,334768,49.62046195
NJ,Hudson ,2016,0,668588,332298,336290,49.70146039
NJ,Hudson ,2017,0,672826,334641,338185,49.73663325
NJ,Hudson ,2018,0,671931,334496,337435,49.78130195
NJ,Hudson ,2019,0,672391,334987,337404,49.82026827
NJ,Hunterdon ,2015,0,125452,62027,63425,49.44281478
NJ,Hunterdon ,2016,0,124775,61602,63173,49.37046684
NJ,Hunterdon ,2017,0,124712,61563,63149,49.36413497
NJ,Hunterdon ,2018,0,124807,61711,63096,49.4451433
NJ,Hunterdon ,2019,0,124371,61339,63032,49.3193751
NJ,Mercer ,2015,0,368124,179996,188128,48.89548087
NJ,Mercer ,2016,0,367699,179841,187858,48.90984202
NJ,Mercer ,2017,0,368168,179941,188227,48.87469851
NJ,Mercer ,2018,0,368188,180095,188093,48.91387009
NJ,Mercer ,2019,0,367430,179755,187675,48.92224369
NJ,Middlesex ,2015,0,825546,406767,418779,49.27248148
NJ,Middlesex ,2016,0,825457,406940,418517,49.29875209
NJ,Middlesex ,2017,0,827363,407879,419484,49.29867543
NJ,Middlesex ,2018,0,826172,407526,418646,49.32701665
NJ,Middlesex ,2019,0,825062,407262,417800,49.36138133
NJ,Monmouth ,2015,0,624079,303475,320604,48.62765772
NJ,Monmouth ,2016,0,622971,303077,319894,48.6502582
NJ,Monmouth ,2017,0,621990,302488,319502,48.63229312
NJ,Monmouth ,2018,0,620459,301795,318664,48.64060317
NJ,Monmouth ,2019,0,618795,301063,317732,48.65310806
NJ,Morris ,2015,0,494259,242289,251970,49.02065516
NJ,Morris ,2016,0,493801,242330,251471,49.07442472
NJ,Morris ,2017,0,493920,242546,251374,49.10633301
NJ,Morris ,2018,0,493070,242193,250877,49.11939481
NJ,Morris ,2019,0,491845,241921,249924,49.18643068
NJ,Ocean ,2015,0,587091,282846,304245,48.17753977
NJ,Ocean ,2016,0,590897,284892,306005,48.21347883
NJ,Ocean ,2017,0,595424,287267,308157,48.24578788
NJ,Ocean ,2018,0,601478,290383,311095,48.27824127
NJ,Ocean ,2019,0,607186,293290,313896,48.30315587
NJ,Passaic ,2015,0,504629,245494,259135,48.64841299
NJ,Passaic ,2016,0,504147,245405,258742,48.67727072
NJ,Passaic ,2017,0,504402,245563,258839,48.68398619
NJ,Passaic ,2018,0,503183,245236,257947,48.73694064
NJ,Passaic ,2019,0,501826,244877,256949,48.79719265
NJ,Salem ,2015,0,63732,31062,32670,48.73846733
NJ,Salem ,2016,0,63203,30866,32337,48.83628942
NJ,Salem ,2017,0,62883,30779,32104,48.94645612
NJ,Salem ,2018,0,62746,30706,32040,48.93698403
NJ,Salem ,2019,0,62385,30547,31838,48.96529614
NJ,Somerset ,2015,0,329626,160886,168740,48.8086498
NJ,Somerset ,2016,0,329875,161124,168751,48.84395604
NJ,Somerset ,2017,0,330573,161692,168881,48.91264562
NJ,Somerset ,2018,0,330181,161277,168904,48.84502742
NJ,Somerset ,2019,0,328934,160930,168004,48.9247083
NJ,Sussex ,2015,0,143004,71014,71990,49.6587508
NJ,Sussex ,2016,0,141925,70550,71375,49.70935353
NJ,Sussex ,2017,0,141197,70202,70995,49.71918667
NJ,Sussex ,2018,0,140801,69942,70859,49.67436311
NJ,Sussex ,2019,0,140488,69803,70685,49.68609419
NJ,Union ,2015,0,549905,267762,282143,48.69241051
NJ,Union ,2016,0,552781,269230,283551,48.70464072
NJ,Union ,2017,0,554738,270510,284228,48.76356046
NJ,Union ,2018,0,556402,271574,284828,48.80895468
NJ,Union ,2019,0,556341,271901,284440,48.87308323
NJ,Warren ,2015,0,106742,52090,54652,48.79991006
NJ,Warren ,2016,0,106059,51882,54177,48.91805504
NJ,Warren ,2017,0,105715,51768,53947,48.96939886
NJ,Warren ,2018,0,105528,51709,53819,49.00026533
NJ,Warren ,2019,0,105267,51574,53693,48.99351174
NM,Bernalillo ,2015,0,676248,331396,344852,49.00509872
NM,Bernalillo ,2016,0,677683,332236,345447,49.02528173
NM,Bernalillo ,2017,0,678203,332576,345627,49.03782496
NM,Bernalillo ,2018,0,678034,332402,345632,49.02438521
NM,Bernalillo ,2019,0,679121,332835,346286,49.00967574
NM,Catron ,2015,0,3476,1824,1652,52.47410817
NM,Catron ,2016,0,3518,1846,1672,52.47299602
NM,Catron ,2017,0,3553,1873,1680,52.71601464
NM,Catron ,2018,0,3554,1882,1672,52.95441756
NM,Catron ,2019,0,3527,1877,1650,53.21803232
NM,Chaves ,2015,0,65825,32699,33126,49.67565515
NM,Chaves ,2016,0,65646,32702,32944,49.81567803
NM,Chaves ,2017,0,65080,32295,32785,49.62354026
NM,Chaves ,2018,0,64554,32057,32497,49.65920005
NM,Chaves ,2019,0,64615,32108,32507,49.69124816
NM,Cibola ,2015,0,27044,13807,13237,51.05383819
NM,Cibola ,2016,0,27049,13820,13229,51.09246183
NM,Cibola ,2017,0,26921,13772,13149,51.15708926
NM,Cibola ,2018,0,26766,13684,13082,51.12456101
NM,Cibola ,2019,0,26675,13660,13015,51.20899719
NM,Colfax ,2015,0,12429,6277,6152,50.50285622
NM,Colfax ,2016,0,12250,6199,6051,50.60408163
NM,Colfax ,2017,0,12151,6173,5978,50.80240309
NM,Colfax ,2018,0,12071,6125,5946,50.74144644
NM,Colfax ,2019,0,11941,6070,5871,50.83326355
NM,Curry ,2015,0,50290,26071,24219,51.84132034
NM,Curry ,2016,0,50283,26063,24220,51.83262733
NM,Curry ,2017,0,49794,25808,23986,51.8295377
NM,Curry ,2018,0,49338,25578,23760,51.84239329
NM,Curry ,2019,0,48954,25370,23584,51.82416146
NM,De Baca ,2015,0,1873,921,952,49.17245061
NM,De Baca ,2016,0,1835,900,935,49.04632153
NM,De Baca ,2017,0,1805,890,915,49.30747922
NM,De Baca ,2018,0,1779,881,898,49.52220349
NM,De Baca ,2019,0,1748,867,881,49.59954233
NM,Do<U+663C><U+3E31>a Ana ,2015,0,214034,105085,108949,49.09733968
NM,Do<U+663C><U+3E31>a Ana ,2016,0,214663,105365,109298,49.08391292
NM,Do<U+663C><U+3E31>a Ana ,2017,0,216174,106015,110159,49.04151286
NM,Do<U+663C><U+3E31>a Ana ,2018,0,217278,106569,110709,49.04730345
NM,Do<U+663C><U+3E31>a Ana ,2019,0,218195,106877,111318,48.98233232
NM,Eddy ,2015,0,57715,29102,28613,50.42363337
NM,Eddy ,2016,0,57650,29113,28537,50.49956635
NM,Eddy ,2017,0,57108,28777,28331,50.3904882
NM,Eddy ,2018,0,57729,29109,28620,50.42353063
NM,Eddy ,2019,0,58460,29570,28890,50.58159425
NM,Grant ,2015,0,28364,13961,14403,49.22084332
NM,Grant ,2016,0,28040,13826,14214,49.30813124
NM,Grant ,2017,0,27642,13605,14037,49.21858042
NM,Grant ,2018,0,27303,13418,13885,49.14478262
NM,Grant ,2019,0,26998,13286,13712,49.21105267
NM,Guadalupe ,2015,0,4350,2458,1892,56.50574713
NM,Guadalupe ,2016,0,4369,2478,1891,56.71778439
NM,Guadalupe ,2017,0,4410,2502,1908,56.73469388
NM,Guadalupe ,2018,0,4334,2471,1863,57.01430549
NM,Guadalupe ,2019,0,4300,2445,1855,56.86046512
NM,Harding ,2015,0,719,373,346,51.87760779
NM,Harding ,2016,0,687,356,331,51.81950509
NM,Harding ,2017,0,684,352,332,51.4619883
NM,Harding ,2018,0,650,332,318,51.07692308
NM,Harding ,2019,0,625,319,306,51.04
NM,Hidalgo ,2015,0,4436,2228,2208,50.22542831
NM,Hidalgo ,2016,0,4324,2167,2157,50.11563367
NM,Hidalgo ,2017,0,4298,2144,2154,49.88366682
NM,Hidalgo ,2018,0,4231,2103,2128,49.70456157
NM,Hidalgo ,2019,0,4198,2086,2112,49.69032873
NM,Lea ,2015,0,71476,36816,34660,51.50819856
NM,Lea ,2016,0,70249,36123,34126,51.42137255
NM,Lea ,2017,0,69046,35456,33590,51.35127306
NM,Lea ,2018,0,69543,35746,33797,51.40129129
NM,Lea ,2019,0,71070,36550,34520,51.42816941
NM,Lincoln ,2015,0,19352,9542,9810,49.30756511
NM,Lincoln ,2016,0,19397,9512,9885,49.03851111
NM,Lincoln ,2017,0,19468,9503,9965,48.81343744
NM,Lincoln ,2018,0,19518,9519,9999,48.77036582
NM,Lincoln ,2019,0,19572,9536,10036,48.72266503
NM,Los Alamos ,2015,0,17817,9015,8802,50.59774373
NM,Los Alamos ,2016,0,18209,9224,8985,50.65626888
NM,Los Alamos ,2017,0,18742,9520,9222,50.79500587
NM,Los Alamos ,2018,0,18988,9669,9319,50.92163472
NM,Los Alamos ,2019,0,19369,9901,9468,51.1177655
NM,Luna ,2015,0,24367,12172,12195,49.95280502
NM,Luna ,2016,0,24362,12183,12179,50.00820951
NM,Luna ,2017,0,24100,12079,12021,50.12033195
NM,Luna ,2018,0,23877,11988,11889,50.20731248
NM,Luna ,2019,0,23709,11966,11743,50.47028555
NM,McKinley ,2015,0,73462,35583,37879,48.43728731
NM,McKinley ,2016,0,73028,35328,37700,48.37596538
NM,McKinley ,2017,0,72423,34958,37465,48.26919625
NM,McKinley ,2018,0,71911,34712,37199,48.27077916
NM,McKinley ,2019,0,71367,34392,36975,48.19034007
NM,Mora ,2015,0,4609,2366,2243,51.33434585
NM,Mora ,2016,0,4533,2284,2249,50.3860578
NM,Mora ,2017,0,4530,2284,2246,50.41942605
NM,Mora ,2018,0,4487,2288,2199,50.99175396
NM,Mora ,2019,0,4521,2316,2205,51.22760451
NM,Otero ,2015,0,64768,33406,31362,51.57793972
NM,Otero ,2016,0,65647,33994,31653,51.78302131
NM,Otero ,2017,0,66121,34250,31871,51.79897461
NM,Otero ,2018,0,66659,34486,32173,51.73494952
NM,Otero ,2019,0,67490,34971,32519,51.81656542
NM,Quay ,2015,0,8445,4123,4322,48.82178804
NM,Quay ,2016,0,8390,4082,4308,48.65315852
NM,Quay ,2017,0,8299,4044,4255,48.7287625
NM,Quay ,2018,0,8242,4003,4239,48.56830866
NM,Quay ,2019,0,8253,4017,4236,48.67320974
NM,Rio Arriba ,2015,0,39370,19341,20029,49.12623825
NM,Rio Arriba ,2016,0,39245,19208,20037,48.9438145
NM,Rio Arriba ,2017,0,39235,19225,20010,48.99961769
NM,Rio Arriba ,2018,0,39023,19099,19924,48.94293109
NM,Rio Arriba ,2019,0,38921,19049,19872,48.94273015
NM,Roosevelt ,2015,0,19137,9537,9600,49.8353974
NM,Roosevelt ,2016,0,19145,9574,9571,50.00783494
NM,Roosevelt ,2017,0,18900,9460,9440,50.05291005
NM,Roosevelt ,2018,0,18759,9383,9376,50.01865771
NM,Roosevelt ,2019,0,18500,9201,9299,49.73513514
NM,Sandoval ,2015,0,138521,67899,70622,49.01711654
NM,Sandoval ,2016,0,140464,68769,71695,48.95845199
NM,Sandoval ,2017,0,142689,69925,72764,49.0051791
NM,Sandoval ,2018,0,145096,71116,73980,49.01306721
NM,Sandoval ,2019,0,146748,72041,74707,49.09164009
NM,San Juan ,2015,0,128246,63407,64839,49.44169799
NM,San Juan ,2016,0,127954,63354,64600,49.51310627
NM,San Juan ,2017,0,126917,62917,64000,49.57334321
NM,San Juan ,2018,0,125499,62092,63407,49.47609144
NM,San Juan ,2019,0,123958,61301,62657,49.45304055
NM,San Miguel ,2015,0,28215,14002,14213,49.62608542
NM,San Miguel ,2016,0,28005,13903,14102,49.6447063
NM,San Miguel ,2017,0,27715,13734,13981,49.55439293
NM,San Miguel ,2018,0,27480,13629,13851,49.59606987
NM,San Miguel ,2019,0,27277,13519,13758,49.56190197
NM,Santa Fe ,2015,0,148098,71983,76115,48.60497778
NM,Santa Fe ,2016,0,148758,72178,76580,48.52041571
NM,Santa Fe ,2017,0,149491,72489,77002,48.49054458
NM,Santa Fe ,2018,0,149761,72479,77282,48.396445
NM,Santa Fe ,2019,0,150358,72731,77627,48.37188577
NM,Sierra ,2015,0,11236,5633,5603,50.13349947
NM,Sierra ,2016,0,11117,5579,5538,50.18440227
NM,Sierra ,2017,0,11064,5559,5505,50.24403471
NM,Sierra ,2018,0,10949,5486,5463,50.10503242
NM,Sierra ,2019,0,10791,5416,5375,50.18997313
NM,Socorro ,2015,0,17152,8657,8495,50.47224813
NM,Socorro ,2016,0,16964,8564,8400,50.48337656
NM,Socorro ,2017,0,16832,8501,8331,50.50499049
NM,Socorro ,2018,0,16704,8399,8305,50.28136973
NM,Socorro ,2019,0,16637,8310,8327,49.94890906
NM,Taos ,2015,0,32797,16088,16709,49.05326707
NM,Taos ,2016,0,32922,16182,16740,49.15254237
NM,Taos ,2017,0,32790,16089,16701,49.06678866
NM,Taos ,2018,0,32699,16055,16644,49.09936084
NM,Taos ,2019,0,32723,15996,16727,48.88304862
NM,Torrance ,2015,0,15596,8229,7367,52.76352911
NM,Torrance ,2016,0,15491,8169,7322,52.73384546
NM,Torrance ,2017,0,15535,8214,7321,52.87415513
NM,Torrance ,2018,0,15512,8222,7290,53.00412584
NM,Torrance ,2019,0,15461,8132,7329,52.59685661
NM,Union ,2015,0,4163,2387,1776,57.33845784
NM,Union ,2016,0,4154,2366,1788,56.95714974
NM,Union ,2017,0,4180,2364,1816,56.55502392
NM,Union ,2018,0,4108,2306,1802,56.13437196
NM,Union ,2019,0,4059,2280,1779,56.17147081
NM,Valencia ,2015,0,75661,38003,37658,50.22799064
NM,Valencia ,2016,0,75599,37968,37631,50.22288655
NM,Valencia ,2017,0,75884,38041,37843,50.13046228
NM,Valencia ,2018,0,76305,38252,38053,50.13039775
NM,Valencia ,2019,0,76688,38437,38251,50.1212706
NY,Albany ,2015,0,307433,148892,158541,48.43071499
NY,Albany ,2016,0,307597,148994,158603,48.43805369
NY,Albany ,2017,0,307717,149017,158700,48.42663876
NY,Albany ,2018,0,306585,148465,158120,48.42539589
NY,Albany ,2019,0,305506,147818,157688,48.38464711
NY,Allegany ,2015,0,47334,23976,23358,50.65280771
NY,Allegany ,2016,0,47044,23863,23181,50.72485333
NY,Allegany ,2017,0,46639,23683,22956,50.77939064
NY,Allegany ,2018,0,46332,23517,22815,50.75757576
NY,Allegany ,2019,0,46091,23418,22673,50.80818381
NY,Bronx ,2015,0,1440005,677937,762068,47.07879487
NY,Bronx ,2016,0,1444417,680715,763702,47.1273185
NY,Bronx ,2017,0,1440625,679406,761219,47.16050325
NY,Bronx ,2018,0,1432087,675622,756465,47.17744104
NY,Bronx ,2019,0,1418207,669548,748659,47.21087965
NY,Broome ,2015,0,195928,96338,99590,49.1701033
NY,Broome ,2016,0,194498,95699,98799,49.20307664
NY,Broome ,2017,0,193100,95026,98074,49.21077162
NY,Broome ,2018,0,191925,94351,97574,49.16034909
NY,Broome ,2019,0,190488,93845,96643,49.26557053
NY,Cattaraugus ,2015,0,77926,38678,39248,49.63426841
NY,Cattaraugus ,2016,0,77658,38527,39131,49.6111154
NY,Cattaraugus ,2017,0,77176,38313,38863,49.64367161
NY,Cattaraugus ,2018,0,76726,38119,38607,49.68198525
NY,Cattaraugus ,2019,0,76117,37853,38264,49.73002089
NY,Cayuga ,2015,0,78298,40133,38165,51.25673708
NY,Cayuga ,2016,0,77674,39774,37900,51.20632387
NY,Cayuga ,2017,0,77457,39731,37726,51.2942665
NY,Cayuga ,2018,0,77121,39579,37542,51.32065196
NY,Cayuga ,2019,0,76576,39286,37290,51.3032804
NY,Chautauqua ,2015,0,130529,64565,65964,49.46410376
NY,Chautauqua ,2016,0,129206,63864,65342,49.42804514
NY,Chautauqua ,2017,0,128372,63386,64986,49.37681114
NY,Chautauqua ,2018,0,127472,62941,64531,49.37633363
NY,Chautauqua ,2019,0,126903,62574,64329,49.30852699
NY,Chemung ,2015,0,86705,43098,43607,49.70647598
NY,Chemung ,2016,0,85644,42561,43083,49.69525011
NY,Chemung ,2017,0,84736,42068,42668,49.64595921
NY,Chemung ,2018,0,83935,41693,42242,49.67296122
NY,Chemung ,2019,0,83456,41328,42128,49.52070552
NY,Chenango ,2015,0,48772,24304,24468,49.83187075
NY,Chenango ,2016,0,48315,24114,24201,49.90996585
NY,Chenango ,2017,0,47805,23908,23897,50.01150507
NY,Chenango ,2018,0,47445,23774,23671,50.10854674
NY,Chenango ,2019,0,47207,23657,23550,50.11333065
NY,Clinton ,2015,0,80718,41396,39322,51.28471964
NY,Clinton ,2016,0,80500,41391,39109,51.4173913
NY,Clinton ,2017,0,80531,41446,39085,51.46589512
NY,Clinton ,2018,0,80679,41494,39185,51.43097956
NY,Clinton ,2019,0,80485,41357,39128,51.38473007
NY,Columbia ,2015,0,61434,30853,30581,50.22137579
NY,Columbia ,2016,0,60835,30466,30369,50.07972384
NY,Columbia ,2017,0,60338,30223,30115,50.08949584
NY,Columbia ,2018,0,59785,29921,29864,50.04767082
NY,Columbia ,2019,0,59461,29736,29725,50.00924976
NY,Cortland ,2015,0,48290,23489,24801,48.64154069
NY,Cortland ,2016,0,47915,23339,24576,48.70917249
NY,Cortland ,2017,0,47815,23303,24512,48.73575238
NY,Cortland ,2018,0,47722,23340,24382,48.90826034
NY,Cortland ,2019,0,47581,23288,24293,48.94390618
NY,Delaware ,2015,0,45891,23085,22806,50.30398117
NY,Delaware ,2016,0,45393,22894,22499,50.43508911
NY,Delaware ,2017,0,45028,22706,22322,50.42640135
NY,Delaware ,2018,0,44526,22505,22021,50.54350267
NY,Delaware ,2019,0,44135,22347,21788,50.63328424
NY,Dutchess ,2015,0,294039,146283,147756,49.74952302
NY,Dutchess ,2016,0,293029,145872,147157,49.78073843
NY,Dutchess ,2017,0,293545,145962,147583,49.72389242
NY,Dutchess ,2018,0,293939,146282,147657,49.76610793
NY,Dutchess ,2019,0,294218,146237,147981,49.70362112
NY,Erie ,2015,0,920644,445242,475402,48.36201615
NY,Erie ,2016,0,918678,444588,474090,48.39432315
NY,Erie ,2017,0,919034,444703,474331,48.3880901
NY,Erie ,2018,0,919717,445019,474698,48.38651455
NY,Erie ,2019,0,918702,444635,474067,48.39817482
NY,Essex ,2015,0,37965,19671,18294,51.81351245
NY,Essex ,2016,0,37671,19495,18176,51.75068355
NY,Essex ,2017,0,37487,19398,18089,51.74593859
NY,Essex ,2018,0,37288,19220,18068,51.54473289
NY,Essex ,2019,0,36885,19063,17822,51.68225566
NY,Franklin ,2015,0,50540,27663,22877,54.73486347
NY,Franklin ,2016,0,51081,28337,22744,55.47463832
NY,Franklin ,2017,0,50465,27734,22731,54.95690082
NY,Franklin ,2018,0,50279,27657,22622,55.0070606
NY,Franklin ,2019,0,50022,27540,22482,55.05577546
NY,Fulton ,2015,0,53801,26774,27027,49.76487426
NY,Fulton ,2016,0,53610,26705,26905,49.81346764
NY,Fulton ,2017,0,53802,26806,26996,49.82342664
NY,Fulton ,2018,0,53633,26656,26977,49.70074394
NY,Fulton ,2019,0,53383,26523,26860,49.68435644
NY,Genesee ,2015,0,58462,29064,29398,49.71434436
NY,Genesee ,2016,0,58013,28867,29146,49.75953666
NY,Genesee ,2017,0,57798,28753,29045,49.7473961
NY,Genesee ,2018,0,57487,28624,28863,49.79212692
NY,Genesee ,2019,0,57280,28538,28742,49.82192737
NY,Greene ,2015,0,47616,24804,22812,52.09173387
NY,Greene ,2016,0,47494,24825,22669,52.26976039
NY,Greene ,2017,0,47442,24833,22609,52.34391467
NY,Greene ,2018,0,47381,24798,22583,52.33743484
NY,Greene ,2019,0,47188,24580,22608,52.08951428
NY,Hamilton ,2015,0,4699,2371,2328,50.45754416
NY,Hamilton ,2016,0,4556,2296,2260,50.39508341
NY,Hamilton ,2017,0,4471,2252,2219,50.36904496
NY,Hamilton ,2018,0,4432,2221,2211,50.11281588
NY,Hamilton ,2019,0,4416,2208,2208,50
NY,Herkimer ,2015,0,62652,30895,31757,49.31207304
NY,Herkimer ,2016,0,62436,30822,31614,49.36575053
NY,Herkimer ,2017,0,62163,30718,31445,49.41524701
NY,Herkimer ,2018,0,61713,30560,31153,49.51955018
NY,Herkimer ,2019,0,61319,30392,30927,49.56375675
NY,Jefferson ,2015,0,116371,61348,55023,52.71760146
NY,Jefferson ,2016,0,112980,59465,53515,52.63320942
NY,Jefferson ,2017,0,113157,59538,53619,52.61539277
NY,Jefferson ,2018,0,111866,58799,53067,52.56199381
NY,Jefferson ,2019,0,109834,57648,52186,52.4864796
NY,Kings ,2015,0,2608794,1235217,1373577,47.34819997
NY,Kings ,2016,0,2608423,1236387,1372036,47.39978907
NY,Kings ,2017,0,2594676,1229956,1364720,47.4030669
NY,Kings ,2018,0,2578074,1221692,1356382,47.38777863
NY,Kings ,2019,0,2559903,1212194,1347709,47.35312236
NY,Lewis ,2015,0,26827,13595,13232,50.6765572
NY,Lewis ,2016,0,26647,13512,13135,50.70739671
NY,Lewis ,2017,0,26605,13503,13102,50.75361774
NY,Lewis ,2018,0,26486,13438,13048,50.73623801
NY,Lewis ,2019,0,26296,13338,12958,50.72254335
NY,Livingston ,2015,0,64344,32357,31987,50.2875171
NY,Livingston ,2016,0,64000,32173,31827,50.2703125
NY,Livingston ,2017,0,63483,31916,31567,50.27487674
NY,Livingston ,2018,0,63213,31776,31437,50.26814105
NY,Livingston ,2019,0,62914,31613,31301,50.24795753
NY,Madison ,2015,0,71636,35154,36482,49.07309174
NY,Madison ,2016,0,71387,35099,36288,49.16721532
NY,Madison ,2017,0,70942,34998,35944,49.33325815
NY,Madison ,2018,0,71117,35074,36043,49.31872829
NY,Madison ,2019,0,70941,35016,35925,49.35932676
NY,Monroe ,2015,0,745577,360001,385576,48.2848854
NY,Monroe ,2016,0,743770,359088,384682,48.27944123
NY,Monroe ,2017,0,742724,358391,384333,48.25359084
NY,Monroe ,2018,0,742864,358328,384536,48.23601628
NY,Monroe ,2019,0,741770,357579,384191,48.20618251
NY,Montgomery ,2015,0,49564,24401,25163,49.23129691
NY,Montgomery ,2016,0,49169,24194,24975,49.2058004
NY,Montgomery ,2017,0,49163,24220,24943,49.26469093
NY,Montgomery ,2018,0,49394,24362,25032,49.32177997
NY,Montgomery ,2019,0,49221,24277,24944,49.32244367
NY,Nassau ,2015,0,1354840,657830,697010,48.55407281
NY,Nassau ,2016,0,1355952,659073,696879,48.6059241
NY,Nassau ,2017,0,1357293,660672,696621,48.67570967
NY,Nassau ,2018,0,1357534,661241,696293,48.70898261
NY,Nassau ,2019,0,1356924,661741,695183,48.7677276
NY,New York ,2015,0,1636063,773478,862585,47.2767858
NY,New York ,2016,0,1635443,773832,861611,47.31635404
NY,New York ,2017,0,1630698,772221,858477,47.35524297
NY,New York ,2018,0,1629055,771374,857681,47.35101025
NY,New York ,2019,0,1628706,771478,857228,47.36754209
NY,Niagara ,2015,0,212358,103358,109000,48.67158289
NY,Niagara ,2016,0,211554,103075,108479,48.72278473
NY,Niagara ,2017,0,210848,102737,108111,48.72562225
NY,Niagara ,2018,0,210060,102382,107678,48.73940779
NY,Niagara ,2019,0,209281,102128,107153,48.79946101
NY,Oneida ,2015,0,231264,115302,115962,49.85730594
NY,Oneida ,2016,0,230375,114896,115479,49.87346717
NY,Oneida ,2017,0,230011,114681,115330,49.85891979
NY,Oneida ,2018,0,229474,114275,115199,49.79867
NY,Oneida ,2019,0,228671,113833,114838,49.78025198
NY,Onondaga ,2015,0,466277,225018,241259,48.25843865
NY,Onondaga ,2016,0,464109,223792,240317,48.21970701
NY,Onondaga ,2017,0,461795,222603,239192,48.20385669
NY,Onondaga ,2018,0,461649,222527,239122,48.2026388
NY,Onondaga ,2019,0,460528,222080,238448,48.22290936
NY,Ontario ,2015,0,109271,53541,55730,48.99836187
NY,Ontario ,2016,0,109229,53509,55720,48.98790614
NY,Ontario ,2017,0,109538,53628,55910,48.95835235
NY,Ontario ,2018,0,109738,53670,56068,48.90739762
NY,Ontario ,2019,0,109777,53664,56113,48.88455687
NY,Orange ,2015,0,375803,188060,187743,50.04217635
NY,Orange ,2016,0,377799,189222,188577,50.08536285
NY,Orange ,2017,0,379758,190410,189348,50.13982589
NY,Orange ,2018,0,382126,191504,190622,50.11540696
NY,Orange ,2019,0,384940,193030,191910,50.14547722
NY,Orleans ,2015,0,41481,20610,20871,49.68539813
NY,Orleans ,2016,0,41247,20605,20642,49.95514825
NY,Orleans ,2017,0,40786,20336,20450,49.86024616
NY,Orleans ,2018,0,40655,20296,20359,49.92251876
NY,Orleans ,2019,0,40352,20124,20228,49.87113402
NY,Oswego ,2015,0,119735,59943,59792,50.06305592
NY,Oswego ,2016,0,118895,59629,59266,50.1526557
NY,Oswego ,2017,0,118427,59421,59006,50.17521342
NY,Oswego ,2018,0,117515,58928,58587,50.14508786
NY,Oswego ,2019,0,117124,58699,58425,50.11697005
NY,Otsego ,2015,0,60504,29377,31127,48.55381462
NY,Otsego ,2016,0,60132,29194,30938,48.54985698
NY,Otsego ,2017,0,59920,29080,30840,48.53137517
NY,Otsego ,2018,0,59810,29032,30778,48.54037786
NY,Otsego ,2019,0,59493,28827,30666,48.45444002
NY,Putnam ,2015,0,99185,49476,49709,49.88254272
NY,Putnam ,2016,0,98761,49333,49428,49.95190409
NY,Putnam ,2017,0,98856,49396,49460,49.96762968
NY,Putnam ,2018,0,98814,49336,49478,49.92814783
NY,Putnam ,2019,0,98320,49061,49259,49.89930838
NY,Queens ,2015,0,2305838,1118131,1187707,48.49130772
NY,Queens ,2016,0,2306830,1118936,1187894,48.5053515
NY,Queens ,2017,0,2295808,1113524,1182284,48.50248801
NY,Queens ,2018,0,2274605,1103811,1170794,48.5275905
NY,Queens ,2019,0,2253858,1093889,1159969,48.53406914
NY,Rensselaer ,2015,0,159436,78556,80880,49.27118091
NY,Rensselaer ,2016,0,159294,78587,80707,49.33456376
NY,Rensselaer ,2017,0,159200,78595,80605,49.36871859
NY,Rensselaer ,2018,0,159283,78712,80571,49.41644746
NY,Rensselaer ,2019,0,158714,78378,80336,49.38316721
NY,Richmond ,2015,0,472349,228557,243792,48.38731531
NY,Richmond ,2016,0,474040,229501,244539,48.41384693
NY,Richmond ,2017,0,475671,230478,245193,48.45323764
NY,Richmond ,2018,0,476260,230944,245316,48.49116029
NY,Richmond ,2019,0,476143,231330,244813,48.58414384
NY,Rockland ,2015,0,322919,158083,164836,48.95438175
NY,Rockland ,2016,0,323258,158486,164772,49.02771161
NY,Rockland ,2017,0,324622,159274,165348,49.06445035
NY,Rockland ,2018,0,325522,159816,165706,49.09529924
NY,Rockland ,2019,0,325789,160031,165758,49.12105688
NY,St. Lawrence ,2015,0,110348,56350,53998,51.06571936
NY,St. Lawrence ,2016,0,109449,55836,53613,51.01554149
NY,St. Lawrence ,2017,0,108699,55471,53228,51.03174822
NY,St. Lawrence ,2018,0,108327,55279,53048,51.02975251
NY,St. Lawrence ,2019,0,107740,54947,52793,50.99962874
NY,Saratoga ,2015,0,226078,111814,114264,49.45815161
NY,Saratoga ,2016,0,227122,112363,114759,49.47253018
NY,Saratoga ,2017,0,229276,113550,115726,49.52546276
NY,Saratoga ,2018,0,230170,113929,116241,49.49776252
NY,Saratoga ,2019,0,229863,113494,116369,49.3746275
NY,Schenectady ,2015,0,154733,75349,79384,48.69614109
NY,Schenectady ,2016,0,154475,75260,79215,48.71985758
NY,Schenectady ,2017,0,154710,75448,79262,48.76737121
NY,Schenectady ,2018,0,155079,75666,79413,48.79190606
NY,Schenectady ,2019,0,155299,75768,79531,48.78846612
NY,Schoharie ,2015,0,31405,15706,15699,50.01114472
NY,Schoharie ,2016,0,31304,15694,15610,50.13416816
NY,Schoharie ,2017,0,31255,15678,15577,50.16157415
NY,Schoharie ,2018,0,31146,15614,15532,50.13163809
NY,Schoharie ,2019,0,30999,15524,15475,50.07903481
NY,Schuyler ,2015,0,18027,8984,9043,49.83635658
NY,Schuyler ,2016,0,17967,8980,8987,49.98051984
NY,Schuyler ,2017,0,17913,8939,8974,49.90230559
NY,Schuyler ,2018,0,17884,8912,8972,49.83225229
NY,Schuyler ,2019,0,17807,8872,8935,49.82310327
NY,Seneca ,2015,0,34801,18194,16607,52.28010689
NY,Seneca ,2016,0,34710,18182,16528,52.38259867
NY,Seneca ,2017,0,34246,17923,16323,52.33603925
NY,Seneca ,2018,0,34179,17935,16244,52.47374119
NY,Seneca ,2019,0,34016,17857,16159,52.49588429
NY,Steuben ,2015,0,97551,48492,49059,49.70938278
NY,Steuben ,2016,0,96958,48335,48623,49.85148209
NY,Steuben ,2017,0,96360,48046,48314,49.86093815
NY,Steuben ,2018,0,95860,47804,48056,49.86855831
NY,Steuben ,2019,0,95379,47526,47853,49.82857862
NY,Suffolk ,2015,0,1491967,734415,757552,49.22461422
NY,Suffolk ,2016,0,1486406,731562,754844,49.21683578
NY,Suffolk ,2017,0,1483358,730253,753105,49.22972067
NY,Suffolk ,2018,0,1480830,729041,751789,49.23191724
NY,Suffolk ,2019,0,1476601,726935,749666,49.23029309
NY,Sullivan ,2015,0,74832,38352,36480,51.2508018
NY,Sullivan ,2016,0,74922,38431,36491,51.2946798
NY,Sullivan ,2017,0,74994,38437,36557,51.25343361
NY,Sullivan ,2018,0,75399,38762,36637,51.40916988
NY,Sullivan ,2019,0,75432,38705,36727,51.31111465
NY,Tioga ,2015,0,49355,24476,24879,49.59173336
NY,Tioga ,2016,0,48824,24143,24681,49.44904146
NY,Tioga ,2017,0,48609,24092,24517,49.56283816
NY,Tioga ,2018,0,48441,24036,24405,49.6191243
NY,Tioga ,2019,0,48203,23939,24264,49.66288405
NY,Tompkins ,2015,0,103006,50685,52321,49.2058715
NY,Tompkins ,2016,0,102942,50617,52325,49.17040664
NY,Tompkins ,2017,0,102664,50445,52219,49.13601652
NY,Tompkins ,2018,0,102419,50312,52107,49.12369775
NY,Tompkins ,2019,0,102180,50162,52018,49.09179879
NY,Ulster ,2015,0,179658,89082,90576,49.58421
NY,Ulster ,2016,0,179042,88788,90254,49.59059885
NY,Ulster ,2017,0,178635,88567,90068,49.57986957
NY,Ulster ,2018,0,178418,88506,89912,49.60598146
NY,Ulster ,2019,0,177573,88057,89516,49.58918304
NY,Warren ,2015,0,64420,31543,32877,48.96460726
NY,Warren ,2016,0,64438,31511,32927,48.90126944
NY,Warren ,2017,0,64365,31542,32823,49.00489396
NY,Warren ,2018,0,64215,31540,32675,49.1162501
NY,Warren ,2019,0,63944,31409,32535,49.1195421
NY,Washington ,2015,0,62246,32217,30029,51.75754265
NY,Washington ,2016,0,61795,31995,29800,51.77603366
NY,Washington ,2017,0,61559,31826,29733,51.69999513
NY,Washington ,2018,0,61274,31694,29580,51.72503835
NY,Washington ,2019,0,61204,31633,29571,51.68453042
NY,Wayne ,2015,0,91291,45169,46122,49.47804274
NY,Wayne ,2016,0,90758,44961,45797,49.53943454
NY,Wayne ,2017,0,90429,44836,45593,49.58143958
NY,Wayne ,2018,0,90200,44753,45447,49.61529933
NY,Wayne ,2019,0,89918,44693,45225,49.70417491
NY,Westchester ,2015,0,968773,468751,500022,48.38605122
NY,Westchester ,2016,0,970267,469707,500560,48.41007681
NY,Westchester ,2017,0,969689,469595,500094,48.42738239
NY,Westchester ,2018,0,968213,468927,499286,48.43221481
NY,Westchester ,2019,0,967506,468854,498652,48.46006123
NY,Wyoming ,2015,0,40930,22277,18653,54.42707061
NY,Wyoming ,2016,0,40432,21943,18489,54.27136921
NY,Wyoming ,2017,0,40282,21781,18501,54.07129735
NY,Wyoming ,2018,0,40023,21709,18314,54.24131125
NY,Wyoming ,2019,0,39859,21610,18249,54.21611179
NY,Yates ,2015,0,25128,12194,12934,48.527539
NY,Yates ,2016,0,25059,12158,12901,48.5174987
NY,Yates ,2017,0,25002,12162,12840,48.64410847
NY,Yates ,2018,0,24951,12124,12827,48.59123883
NY,Yates ,2019,0,24913,12132,12781,48.69746719
NC,Alamance ,2015,0,157037,74635,82402,47.52701593
NC,Alamance ,2016,0,160283,76141,84142,47.50410212
NC,Alamance ,2017,0,163276,77641,85635,47.55199784
NC,Alamance ,2018,0,166514,79050,87464,47.47348571
NC,Alamance ,2019,0,169509,80533,88976,47.50957176
NC,Alexander ,2015,0,36960,18822,18138,50.92532468
NC,Alexander ,2016,0,37133,18905,18228,50.91158808
NC,Alexander ,2017,0,37143,18932,18211,50.97057319
NC,Alexander ,2018,0,37331,19007,18324,50.91478932
NC,Alexander ,2019,0,37497,19109,18388,50.96141025
NC,Alleghany ,2015,0,10856,5376,5480,49.52100221
NC,Alleghany ,2016,0,10919,5421,5498,49.64740361
NC,Alleghany ,2017,0,10988,5469,5519,49.77247907
NC,Alleghany ,2018,0,11138,5519,5619,49.55108637
NC,Alleghany ,2019,0,11137,5519,5618,49.5555356
NC,Anson ,2015,0,25602,13494,12108,52.70681978
NC,Anson ,2016,0,25165,13169,11996,52.33061792
NC,Anson ,2017,0,24829,12931,11898,52.08022876
NC,Anson ,2018,0,24470,12575,11895,51.38945648
NC,Anson ,2019,0,24446,12532,11914,51.26401047
NC,Ashe ,2015,0,26628,13142,13486,49.35406339
NC,Ashe ,2016,0,26600,13092,13508,49.21804511
NC,Ashe ,2017,0,26787,13175,13612,49.18430582
NC,Ashe ,2018,0,27099,13304,13795,49.09406251
NC,Ashe ,2019,0,27203,13331,13872,49.00562438
NC,Avery ,2015,0,17486,9513,7973,54.40352282
NC,Avery ,2016,0,17442,9513,7929,54.54076367
NC,Avery ,2017,0,17517,9529,7988,54.39858423
NC,Avery ,2018,0,17528,9523,8005,54.33021451
NC,Avery ,2019,0,17557,9513,8044,54.18351655
NC,Beaufort ,2015,0,47389,22638,24751,47.77057967
NC,Beaufort ,2016,0,47369,22586,24783,47.68097279
NC,Beaufort ,2017,0,47033,22400,24633,47.62613484
NC,Beaufort ,2018,0,47056,22456,24600,47.72186331
NC,Beaufort ,2019,0,46994,22322,24672,47.49968081
NC,Bertie ,2015,0,20162,10283,9879,51.00188473
NC,Bertie ,2016,0,19423,9707,9716,49.97683159
NC,Bertie ,2017,0,19263,9702,9561,50.36598661
NC,Bertie ,2018,0,19106,9685,9421,50.69088245
NC,Bertie ,2019,0,18947,9614,9333,50.7415422
NC,Bladen ,2015,0,34083,16310,17773,47.85376874
NC,Bladen ,2016,0,33638,16099,17539,47.85956359
NC,Bladen ,2017,0,33443,15919,17524,47.6003947
NC,Bladen ,2018,0,33151,15810,17341,47.69086905
NC,Bladen ,2019,0,32722,15533,17189,47.46959232
NC,Brunswick ,2015,0,122211,59119,63092,48.37453257
NC,Brunswick ,2016,0,126304,60853,65451,48.17978845
NC,Brunswick ,2017,0,130859,62752,68107,47.95390458
NC,Brunswick ,2018,0,136880,65451,71429,47.81633548
NC,Brunswick ,2019,0,142820,68165,74655,47.72790926
NC,Buncombe ,2015,0,251954,120795,131159,47.94327536
NC,Buncombe ,2016,0,254955,122370,132585,47.9967053
NC,Buncombe ,2017,0,257071,123214,133857,47.92994931
NC,Buncombe ,2018,0,259259,124268,134991,47.93199079
NC,Buncombe ,2019,0,261191,125220,135971,47.94192755
NC,Burke ,2015,0,89341,44549,44792,49.86400421
NC,Burke ,2016,0,89451,44602,44849,49.86193558
NC,Burke ,2017,0,90157,45086,45071,50.00831882
NC,Burke ,2018,0,90405,45244,45161,50.04590454
NC,Burke ,2019,0,90485,45277,45208,50.03812787
NC,Cabarrus ,2015,0,196396,95665,100731,48.71025886
NC,Cabarrus ,2016,0,201639,98225,103414,48.71329455
NC,Cabarrus ,2017,0,206988,100900,106088,48.74678725
NC,Cabarrus ,2018,0,211597,103245,108352,48.79322486
NC,Cabarrus ,2019,0,216453,105581,110872,48.77779472
NC,Caldwell ,2015,0,81518,40311,41207,49.45042813
NC,Caldwell ,2016,0,81766,40524,41242,49.5609422
NC,Caldwell ,2017,0,81933,40523,41410,49.45870406
NC,Caldwell ,2018,0,82026,40580,41446,49.4721186
NC,Caldwell ,2019,0,82178,40644,41534,49.45849254
NC,Camden ,2015,0,10282,5069,5213,49.29974713
NC,Camden ,2016,0,10397,5188,5209,49.89900933
NC,Camden ,2017,0,10532,5254,5278,49.88606153
NC,Camden ,2018,0,10676,5304,5372,49.68152866
NC,Camden ,2019,0,10867,5426,5441,49.93098371
NC,Carteret ,2015,0,68712,33774,34938,49.15298638
NC,Carteret ,2016,0,68808,33818,34990,49.14835484
NC,Carteret ,2017,0,68921,33819,35102,49.06922418
NC,Carteret ,2018,0,69438,34020,35418,48.99334658
NC,Carteret ,2019,0,69473,34024,35449,48.97442172
NC,Caswell ,2015,0,22813,11542,11271,50.59395958
NC,Caswell ,2016,0,22755,11572,11183,50.8547572
NC,Caswell ,2017,0,22616,11508,11108,50.88432968
NC,Caswell ,2018,0,22634,11492,11142,50.7731731
NC,Caswell ,2019,0,22604,11487,11117,50.81843921
NC,Catawba ,2015,0,155527,76062,79465,48.90597774
NC,Catawba ,2016,0,156448,76407,80041,48.83859174
NC,Catawba ,2017,0,157852,77090,80762,48.83688518
NC,Catawba ,2018,0,158687,77529,81158,48.8565541
NC,Catawba ,2019,0,159551,77988,81563,48.87966857
NC,Chatham ,2015,0,68263,32753,35510,47.98060443
NC,Chatham ,2016,0,69642,33350,36292,47.88776888
NC,Chatham ,2017,0,71189,34133,37056,47.94701429
NC,Chatham ,2018,0,73127,34966,38161,47.81544436
NC,Chatham ,2019,0,74470,35617,38853,47.82731301
NC,Cherokee ,2015,0,27102,13133,13969,48.4576784
NC,Cherokee ,2016,0,27809,13512,14297,48.58858643
NC,Cherokee ,2017,0,27954,13617,14337,48.71216999
NC,Cherokee ,2018,0,28369,13831,14538,48.75392153
NC,Cherokee ,2019,0,28612,13944,14668,48.73479659
NC,Chowan ,2015,0,14248,6747,7501,47.3540146
NC,Chowan ,2016,0,14201,6722,7479,47.33469474
NC,Chowan ,2017,0,14029,6657,7372,47.45170718
NC,Chowan ,2018,0,14065,6701,7364,47.64308567
NC,Chowan ,2019,0,13943,6632,7311,47.56508642
NC,Clay ,2015,0,10623,5193,5430,48.88449591
NC,Clay ,2016,0,10749,5273,5476,49.05572611
NC,Clay ,2017,0,11004,5360,5644,48.70956016
NC,Clay ,2018,0,11124,5429,5695,48.80438691
NC,Clay ,2019,0,11231,5459,5772,48.60653548
NC,Cleveland ,2015,0,96850,46568,50282,48.08260196
NC,Cleveland ,2016,0,96960,46698,50262,48.16212871
NC,Cleveland ,2017,0,97134,46618,50516,47.99349352
NC,Cleveland ,2018,0,97519,46892,50627,48.08498857
NC,Cleveland ,2019,0,97947,47093,50854,48.08008413
NC,Columbus ,2015,0,56675,27956,28719,49.3268637
NC,Columbus ,2016,0,56292,27785,28507,49.35870106
NC,Columbus ,2017,0,56047,27715,28332,49.44956911
NC,Columbus ,2018,0,55819,27622,28197,49.4849424
NC,Columbus ,2019,0,55508,27548,27960,49.62888232
NC,Craven ,2015,0,102853,52187,50666,50.73940478
NC,Craven ,2016,0,102632,51993,50639,50.65963832
NC,Craven ,2017,0,102492,51982,50510,50.71810483
NC,Craven ,2018,0,102338,51663,50675,50.48271414
NC,Craven ,2019,0,102139,51569,50570,50.48903945
NC,Cumberland ,2015,0,331203,165152,166051,49.86428263
NC,Cumberland ,2016,0,333167,166228,166939,49.89329676
NC,Cumberland ,2017,0,330994,164392,166602,49.66615709
NC,Cumberland ,2018,0,333430,165722,167708,49.70218637
NC,Cumberland ,2019,0,335509,166439,169070,49.60790918
NC,Currituck ,2015,0,25106,12438,12668,49.54194217
NC,Currituck ,2016,0,25640,12678,12962,49.44617785
NC,Currituck ,2017,0,26290,13017,13273,49.51312286
NC,Currituck ,2018,0,27016,13397,13619,49.58913237
NC,Currituck ,2019,0,27763,13837,13926,49.83971473
NC,Dare ,2015,0,35468,17565,17903,49.52351415
NC,Dare ,2016,0,35829,17707,18122,49.4208602
NC,Dare ,2017,0,36199,17865,18334,49.35219205
NC,Dare ,2018,0,36607,18037,18570,49.27199716
NC,Dare ,2019,0,37009,18153,18856,49.05023102
NC,Davidson ,2015,0,163486,79854,83632,48.84454938
NC,Davidson ,2016,0,164270,80248,84022,48.85128143
NC,Davidson ,2017,0,165180,80780,84400,48.90422569
NC,Davidson ,2018,0,166358,81363,84995,48.90837832
NC,Davidson ,2019,0,167609,81991,85618,48.91801753
NC,Davie ,2015,0,41648,20299,21349,48.73943527
NC,Davie ,2016,0,41921,20429,21492,48.73213902
NC,Davie ,2017,0,42308,20615,21693,48.72600927
NC,Davie ,2018,0,42563,20767,21796,48.79120363
NC,Davie ,2019,0,42846,20922,21924,48.83069598
NC,Duplin ,2015,0,58883,28649,30234,48.65411069
NC,Duplin ,2016,0,59275,28837,30438,48.64951497
NC,Duplin ,2017,0,58943,28700,30243,48.69110836
NC,Duplin ,2018,0,58991,28750,30241,48.7362479
NC,Duplin ,2019,0,58741,28691,30050,48.84322705
NC,Durham ,2015,0,300793,143971,156822,47.86381332
NC,Durham ,2016,0,307826,147128,160698,47.79583271
NC,Durham ,2017,0,312153,149183,162970,47.79162782
NC,Durham ,2018,0,316979,151416,165563,47.76846416
NC,Durham ,2019,0,321488,153424,168064,47.72308764
NC,Edgecombe ,2015,0,53743,24881,28862,46.29626184
NC,Edgecombe ,2016,0,53283,24662,28621,46.2849314
NC,Edgecombe ,2017,0,52756,24403,28353,46.25634999
NC,Edgecombe ,2018,0,51984,24054,27930,46.27192982
NC,Edgecombe ,2019,0,51472,23757,27715,46.15519117
NC,Forsyth ,2015,0,367365,174219,193146,47.42395166
NC,Forsyth ,2016,0,371260,176178,195082,47.45407531
NC,Forsyth ,2017,0,375840,178347,197493,47.45290549
NC,Forsyth ,2018,0,379216,179662,199554,47.37722037
NC,Forsyth ,2019,0,382295,180833,201462,47.30195268
NC,Franklin ,2015,0,63668,31627,32041,49.67487592
NC,Franklin ,2016,0,64676,32169,32507,49.73869751
NC,Franklin ,2017,0,66155,32792,33363,49.56843776
NC,Franklin ,2018,0,67625,33467,34158,49.48909427
NC,Franklin ,2019,0,69685,34516,35169,49.53146301
NC,Gaston ,2015,0,212919,102657,110262,48.21410959
NC,Gaston ,2016,0,216622,104554,112068,48.26564246
NC,Gaston ,2017,0,219656,106116,113540,48.31008486
NC,Gaston ,2018,0,222630,107472,115158,48.27381754
NC,Gaston ,2019,0,224529,108372,116157,48.26637094
NC,Gates ,2015,0,11531,5645,5886,48.95499089
NC,Gates ,2016,0,11569,5686,5883,49.14858674
NC,Gates ,2017,0,11514,5655,5859,49.11412194
NC,Gates ,2018,0,11563,5717,5846,49.44218628
NC,Gates ,2019,0,11562,5725,5837,49.51565473
NC,Graham ,2015,0,8588,4244,4344,49.41779227
NC,Graham ,2016,0,8531,4246,4285,49.77142187
NC,Graham ,2017,0,8524,4240,4284,49.74190521
NC,Graham ,2018,0,8461,4215,4246,49.81680652
NC,Graham ,2019,0,8441,4220,4221,49.99407653
NC,Granville ,2015,0,58162,29690,28472,51.04707541
NC,Granville ,2016,0,58684,29998,28686,51.11785154
NC,Granville ,2017,0,59372,30342,29030,51.10489793
NC,Granville ,2018,0,59979,30483,29496,50.82278798
NC,Granville ,2019,0,60443,30692,29751,50.77841934
NC,Greene ,2015,0,20950,11385,9565,54.34367542
NC,Greene ,2016,0,21078,11526,9552,54.68260746
NC,Greene ,2017,0,20963,11439,9524,54.56757144
NC,Greene ,2018,0,21106,11558,9548,54.76167914
NC,Greene ,2019,0,21069,11540,9529,54.77241445
NC,Guilford ,2015,0,517053,245166,271887,47.41602892
NC,Guilford ,2016,0,524265,248431,275834,47.38653162
NC,Guilford ,2017,0,528243,250063,278180,47.33863014
NC,Guilford ,2018,0,532607,252212,280395,47.35424056
NC,Guilford ,2019,0,537174,254212,282962,47.32395834
NC,Halifax ,2015,0,52182,24907,27275,47.73101836
NC,Halifax ,2016,0,51815,24823,26992,47.90697674
NC,Halifax ,2017,0,51311,24693,26618,48.1241839
NC,Halifax ,2018,0,50634,24349,26285,48.0882411
NC,Halifax ,2019,0,50010,24099,25911,48.18836233
NC,Harnett ,2015,0,128034,63368,64666,49.49310339
NC,Harnett ,2016,0,130674,64882,65792,49.65180526
NC,Harnett ,2017,0,132395,65787,66608,49.68994297
NC,Harnett ,2018,0,134336,66635,67701,49.60323368
NC,Harnett ,2019,0,135976,67259,68717,49.46387598
NC,Haywood ,2015,0,59646,28732,30914,48.17087483
NC,Haywood ,2016,0,60405,29057,31348,48.10363381
NC,Haywood ,2017,0,61005,29417,31588,48.22063765
NC,Haywood ,2018,0,61890,29932,31958,48.36322508
NC,Haywood ,2019,0,62317,30101,32216,48.30303128
NC,Henderson ,2015,0,111847,53775,58072,48.0790723
NC,Henderson ,2016,0,113583,54646,58937,48.11107296
NC,Henderson ,2017,0,115216,55323,59893,48.0167685
NC,Henderson ,2018,0,116500,55939,60561,48.01630901
NC,Henderson ,2019,0,117417,56399,61018,48.03307869
NC,Hertford ,2015,0,24373,12088,12285,49.59586428
NC,Hertford ,2016,0,24209,11883,12326,49.08505101
NC,Hertford ,2017,0,23923,11705,12218,48.92781006
NC,Hertford ,2018,0,23878,11843,12035,49.59795628
NC,Hertford ,2019,0,23677,11781,11896,49.75714829
NC,Hoke ,2015,0,52739,26159,26580,49.60086464
NC,Hoke ,2016,0,52981,26198,26783,49.44791529
NC,Hoke ,2017,0,54138,26731,27407,49.37566959
NC,Hoke ,2018,0,54695,27020,27675,49.40122497
NC,Hoke ,2019,0,55234,27240,27994,49.3174494
NC,Hyde ,2015,0,5426,3034,2392,55.91596019
NC,Hyde ,2016,0,5434,3010,2424,55.39197644
NC,Hyde ,2017,0,5240,2870,2370,54.77099237
NC,Hyde ,2018,0,5026,2672,2354,53.16354954
NC,Hyde ,2019,0,4937,2638,2299,53.43325906
NC,Iredell ,2015,0,169453,83387,86066,49.20951532
NC,Iredell ,2016,0,172466,85027,87439,49.30073174
NC,Iredell ,2017,0,175634,86536,89098,49.27064236
NC,Iredell ,2018,0,178332,87827,90505,49.24915326
NC,Iredell ,2019,0,181806,89488,92318,49.22169785
NC,Jackson ,2015,0,41305,20296,21009,49.13690836
NC,Jackson ,2016,0,42622,20957,21665,49.16944301
NC,Jackson ,2017,0,43224,21218,22006,49.08846937
NC,Jackson ,2018,0,43600,21387,22213,49.05275229
NC,Jackson ,2019,0,43938,21617,22321,49.19887114
NC,Johnston ,2015,0,185104,90779,94325,49.04216008
NC,Johnston ,2016,0,190843,93532,97311,49.00991915
NC,Johnston ,2017,0,196374,96256,100118,49.01667227
NC,Johnston ,2018,0,202692,99385,103307,49.03252225
NC,Johnston ,2019,0,209339,102577,106762,49.00042515
NC,Jones ,2015,0,9777,4734,5043,48.41976066
NC,Jones ,2016,0,9588,4661,4927,48.6128494
NC,Jones ,2017,0,9573,4673,4900,48.81437376
NC,Jones ,2018,0,9613,4700,4913,48.89212525
NC,Jones ,2019,0,9419,4574,4845,48.56141841
NC,Lee ,2015,0,59371,29000,30371,48.8453959
NC,Lee ,2016,0,59646,29116,30530,48.81467324
NC,Lee ,2017,0,60403,29452,30951,48.75916759
NC,Lee ,2018,0,61208,29896,31312,48.84328846
NC,Lee ,2019,0,61779,30141,31638,48.78842325
NC,Lenoir ,2015,0,57981,27786,30195,47.92259533
NC,Lenoir ,2016,0,57240,27411,29829,47.88784067
NC,Lenoir ,2017,0,56622,27109,29513,47.87715022
NC,Lenoir ,2018,0,55990,26666,29324,47.62636185
NC,Lenoir ,2019,0,55949,26737,29212,47.78816422
NC,Lincoln ,2015,0,80607,40031,40576,49.66194003
NC,Lincoln ,2016,0,81229,40334,40895,49.65467998
NC,Lincoln ,2017,0,82557,41010,41547,49.67477016
NC,Lincoln ,2018,0,84092,41775,42317,49.67773391
NC,Lincoln ,2019,0,86111,42751,43360,49.64638664
NC,McDowell ,2015,0,44967,22475,22492,49.98109725
NC,McDowell ,2016,0,44866,22369,22497,49.85735301
NC,McDowell ,2017,0,45083,22557,22526,50.03438103
NC,McDowell ,2018,0,45465,22729,22736,49.99230177
NC,McDowell ,2019,0,45756,22798,22958,49.82515954
NC,Macon ,2015,0,34090,16533,17557,48.49809328
NC,Macon ,2016,0,34262,16617,17645,48.49979569
NC,Macon ,2017,0,34581,16806,17775,48.59894162
NC,Macon ,2018,0,35274,17133,18141,48.57118558
NC,Macon ,2019,0,35858,17398,18460,48.5191589
NC,Madison ,2015,0,21146,10406,10740,49.21025253
NC,Madison ,2016,0,21367,10535,10832,49.30500304
NC,Madison ,2017,0,21563,10602,10961,49.16755553
NC,Madison ,2018,0,21665,10676,10989,49.27763674
NC,Madison ,2019,0,21755,10722,11033,49.28522179
NC,Martin ,2015,0,23262,10881,12381,46.77585762
NC,Martin ,2016,0,23122,10854,12268,46.94230603
NC,Martin ,2017,0,22763,10686,12077,46.94460308
NC,Martin ,2018,0,22660,10655,12005,47.0211827
NC,Martin ,2019,0,22440,10544,11896,46.98752228
NC,Mecklenburg ,2015,0,1033238,496248,536990,48.02843101
NC,Mecklenburg ,2016,0,1056901,507925,548976,48.05795434
NC,Mecklenburg ,2017,0,1078128,518115,560013,48.05690975
NC,Mecklenburg ,2018,0,1093750,525933,567817,48.08530286
NC,Mecklenburg ,2019,0,1110356,533670,576686,48.06296359
NC,Mitchell ,2015,0,15071,7439,7632,49.35969743
NC,Mitchell ,2016,0,14996,7388,7608,49.26647106
NC,Mitchell ,2017,0,14992,7404,7588,49.38633938
NC,Mitchell ,2018,0,14996,7410,7586,49.41317685
NC,Mitchell ,2019,0,14964,7392,7572,49.39855654
NC,Montgomery ,2015,0,27438,13342,14096,48.62599315
NC,Montgomery ,2016,0,27301,13271,14030,48.60994103
NC,Montgomery ,2017,0,27269,13290,13979,48.73666068
NC,Montgomery ,2018,0,27077,13231,13846,48.86434982
NC,Montgomery ,2019,0,27173,13297,13876,48.9346042
NC,Moore ,2015,0,94013,45014,48999,47.88061226
NC,Moore ,2016,0,95405,45807,49598,48.01320685
NC,Moore ,2017,0,97368,46780,50588,48.04453208
NC,Moore ,2018,0,98805,47609,51196,48.18480846
NC,Moore ,2019,0,100880,48765,52115,48.33961142
NC,Nash ,2015,0,93786,45048,48738,48.03275542
NC,Nash ,2016,0,93953,45145,48808,48.05062106
NC,Nash ,2017,0,94019,45047,48972,47.91265595
NC,Nash ,2018,0,94094,45123,48971,47.95523625
NC,Nash ,2019,0,94298,45143,49155,47.87270144
NC,New Hanover ,2015,0,219422,105142,114280,47.91771108
NC,New Hanover ,2016,0,224809,107287,117522,47.72362316
NC,New Hanover ,2017,0,228728,109220,119508,47.75104054
NC,New Hanover ,2018,0,232256,110831,121425,47.71932695
NC,New Hanover ,2019,0,234473,111563,122910,47.58031842
NC,Northampton ,2015,0,20533,9940,10593,48.40987678
NC,Northampton ,2016,0,20127,9792,10335,48.65106573
NC,Northampton ,2017,0,19890,9714,10176,48.83861237
NC,Northampton ,2018,0,19698,9644,10054,48.95928521
NC,Northampton ,2019,0,19483,9537,9946,48.95036699
NC,Onslow ,2015,0,193114,107896,85218,55.8716613
NC,Onslow ,2016,0,192314,106811,85503,55.53989829
NC,Onslow ,2017,0,195066,108091,86975,55.41252704
NC,Onslow ,2018,0,196915,108205,88710,54.95010538
NC,Onslow ,2019,0,197938,108732,89206,54.93235255
NC,Orange ,2015,0,141298,67543,73755,47.80180894
NC,Orange ,2016,0,142800,68128,74672,47.70868347
NC,Orange ,2017,0,143626,68591,75035,47.75667358
NC,Orange ,2018,0,147980,70632,77348,47.73077443
NC,Orange ,2019,0,148476,70859,77617,47.72421132
NC,Pamlico ,2015,0,12741,6518,6223,51.15767993
NC,Pamlico ,2016,0,12765,6536,6229,51.20250685
NC,Pamlico ,2017,0,12638,6446,6192,51.00490584
NC,Pamlico ,2018,0,12633,6412,6221,50.75595662
NC,Pamlico ,2019,0,12726,6479,6247,50.91151972
NC,Pasquotank ,2015,0,39384,19297,20087,48.99705464
NC,Pasquotank ,2016,0,39392,19270,20122,48.91856214
NC,Pasquotank ,2017,0,39386,19247,20139,48.86761794
NC,Pasquotank ,2018,0,39583,19289,20294,48.73051563
NC,Pasquotank ,2019,0,39824,19487,20337,48.93280434
NC,Pender ,2015,0,57426,28631,28795,49.85720754
NC,Pender ,2016,0,58771,29276,29495,49.81368362
NC,Pender ,2017,0,60719,30216,30503,49.76366541
NC,Pender ,2018,0,62017,30876,31141,49.7863489
NC,Pender ,2019,0,63060,31400,31660,49.79384713
NC,Perquimans ,2015,0,13463,6476,6987,48.10220605
NC,Perquimans ,2016,0,13402,6464,6938,48.23160722
NC,Perquimans ,2017,0,13439,6474,6965,48.17322717
NC,Perquimans ,2018,0,13381,6450,6931,48.20267544
NC,Perquimans ,2019,0,13463,6445,7018,47.87194533
NC,Person ,2015,0,39190,19044,20146,48.59402909
NC,Person ,2016,0,39270,19052,20218,48.51540616
NC,Person ,2017,0,39338,19034,20304,48.38578474
NC,Person ,2018,0,39436,19104,20332,48.44304696
NC,Person ,2019,0,39490,19093,20397,48.3489491
NC,Pitt ,2015,0,176071,82913,93158,47.09066229
NC,Pitt ,2016,0,177171,83432,93739,47.09122825
NC,Pitt ,2017,0,178607,84041,94566,47.05358693
NC,Pitt ,2018,0,179575,84332,95243,46.9619936
NC,Pitt ,2019,0,180742,84780,95962,46.9066404
NC,Polk ,2015,0,20414,9771,10643,47.86421084
NC,Polk ,2016,0,20414,9805,10609,48.0307632
NC,Polk ,2017,0,20564,9902,10662,48.15211048
NC,Polk ,2018,0,20668,9914,10754,47.96787304
NC,Polk ,2019,0,20724,9923,10801,47.88168307
NC,Randolph ,2015,0,142575,70318,72257,49.32000701
NC,Randolph ,2016,0,143062,70539,72523,49.30659434
NC,Randolph ,2017,0,143037,70473,72564,49.26907024
NC,Randolph ,2018,0,143249,70615,72634,49.29528304
NC,Randolph ,2019,0,143667,70855,72812,49.31891109
NC,Richmond ,2015,0,45429,22223,23206,48.91809197
NC,Richmond ,2016,0,45012,21998,23014,48.87141207
NC,Richmond ,2017,0,44827,21899,22928,48.85225422
NC,Richmond ,2018,0,44888,21982,22906,48.9707717
NC,Richmond ,2019,0,44829,21970,22859,49.00845435
NC,Robeson ,2015,0,134460,64757,69703,48.16079131
NC,Robeson ,2016,0,133383,64287,69096,48.19729651
NC,Robeson ,2017,0,132626,64074,68552,48.31179407
NC,Robeson ,2018,0,131884,63590,68294,48.2166146
NC,Robeson ,2019,0,130625,62923,67702,48.1707177
NC,Rockingham ,2015,0,91657,44198,47459,48.22108513
NC,Rockingham ,2016,0,91308,44049,47259,48.24221317
NC,Rockingham ,2017,0,90791,43791,47000,48.23275435
NC,Rockingham ,2018,0,90617,43704,46913,48.22936094
NC,Rockingham ,2019,0,91010,43925,47085,48.26392704
NC,Rowan ,2015,0,138497,68393,70104,49.38229709
NC,Rowan ,2016,0,139410,68883,70527,49.41037228
NC,Rowan ,2017,0,140356,69388,70968,49.43714554
NC,Rowan ,2018,0,141128,69692,71436,49.38212119
NC,Rowan ,2019,0,142088,70163,71925,49.37996171
NC,Rutherford ,2015,0,66375,32154,34221,48.44293785
NC,Rutherford ,2016,0,66286,32062,34224,48.36918806
NC,Rutherford ,2017,0,66529,32101,34428,48.2511386
NC,Rutherford ,2018,0,66775,32238,34537,48.27854736
NC,Rutherford ,2019,0,67029,32353,34676,48.26716794
NC,Sampson ,2015,0,63559,31141,32418,48.99542158
NC,Sampson ,2016,0,63225,31064,32161,49.13246342
NC,Sampson ,2017,0,63263,31141,32122,49.22466529
NC,Sampson ,2018,0,63345,31202,32143,49.25724209
NC,Sampson ,2019,0,63531,31245,32286,49.18071493
NC,Scotland ,2015,0,35321,17521,17800,49.60505082
NC,Scotland ,2016,0,35309,17571,17738,49.76351638
NC,Scotland ,2017,0,35174,17436,17738,49.57070563
NC,Scotland ,2018,0,34751,17235,17516,49.59569509
NC,Scotland ,2019,0,34823,17261,17562,49.56781438
NC,Stanly ,2015,0,60622,30097,30525,49.64699284
NC,Stanly ,2016,0,60826,30246,30580,49.72544636
NC,Stanly ,2017,0,61505,30686,30819,49.89187871
NC,Stanly ,2018,0,62180,31029,31151,49.90189772
NC,Stanly ,2019,0,62806,31355,31451,49.92357418
NC,Stokes ,2015,0,46159,22631,23528,49.0283585
NC,Stokes ,2016,0,45920,22496,23424,48.98954704
NC,Stokes ,2017,0,45724,22352,23372,48.88461202
NC,Stokes ,2018,0,45511,22306,23205,49.01232669
NC,Stokes ,2019,0,45591,22321,23270,48.95922441
NC,Surry ,2015,0,71998,35067,36931,48.7055196
NC,Surry ,2016,0,72008,35056,36952,48.68347961
NC,Surry ,2017,0,72107,35037,37070,48.59028943
NC,Surry ,2018,0,71959,35007,36952,48.64853597
NC,Surry ,2019,0,71783,34955,36828,48.69537356
NC,Swain ,2015,0,14326,6964,7362,48.61091721
NC,Swain ,2016,0,14190,6887,7303,48.534179
NC,Swain ,2017,0,14263,6906,7357,48.41898619
NC,Swain ,2018,0,14249,6864,7385,48.17180153
NC,Swain ,2019,0,14271,6841,7430,47.93637447
NC,Transylvania ,2015,0,33157,16016,17141,48.30352565
NC,Transylvania ,2016,0,33393,16164,17229,48.40535442
NC,Transylvania ,2017,0,33767,16307,17460,48.29271182
NC,Transylvania ,2018,0,34173,16517,17656,48.33347965
NC,Transylvania ,2019,0,34385,16563,17822,48.16925985
NC,Tyrrell ,2015,0,4139,2268,1871,54.79584441
NC,Tyrrell ,2016,0,4024,2169,1855,53.90159046
NC,Tyrrell ,2017,0,4180,2332,1848,55.78947368
NC,Tyrrell ,2018,0,4115,2289,1826,55.62575942
NC,Tyrrell ,2019,0,4016,2267,1749,56.44920319
NC,Union ,2015,0,221949,109280,112669,49.23653632
NC,Union ,2016,0,226279,111461,114818,49.25821663
NC,Union ,2017,0,231350,114017,117333,49.28333694
NC,Union ,2018,0,235830,116056,119774,49.21172031
NC,Union ,2019,0,239859,118155,121704,49.26019036
NC,Vance ,2015,0,44459,20809,23650,46.80492139
NC,Vance ,2016,0,44485,20822,23663,46.80678881
NC,Vance ,2017,0,44281,20663,23618,46.66335449
NC,Vance ,2018,0,44635,20883,23752,46.78615436
NC,Vance ,2019,0,44535,20780,23755,46.65993039
NC,Wake ,2015,0,1022319,496552,525767,48.57114071
NC,Wake ,2016,0,1048335,509405,538930,48.59181464
NC,Wake ,2017,0,1071706,521218,550488,48.63442026
NC,Wake ,2018,0,1091273,530593,560680,48.62147235
NC,Wake ,2019,0,1111761,540765,570996,48.64040023
NC,Warren ,2015,0,20207,10090,10117,49.93319147
NC,Warren ,2016,0,19884,9876,10008,49.66807483
NC,Warren ,2017,0,19849,9817,10032,49.458411
NC,Warren ,2018,0,19819,9822,9997,49.55850447
NC,Warren ,2019,0,19731,9763,9968,49.4805129
NC,Washington ,2015,0,12247,5734,6513,46.8196293
NC,Washington ,2016,0,12070,5676,6394,47.02568351
NC,Washington ,2017,0,11944,5644,6300,47.25385131
NC,Washington ,2018,0,11769,5535,6234,47.03033393
NC,Washington ,2019,0,11580,5468,6112,47.2193437
NC,Watauga ,2015,0,53093,26535,26558,49.97833989
NC,Watauga ,2016,0,54140,27124,27016,50.09974141
NC,Watauga ,2017,0,55181,27542,27639,49.91210743
NC,Watauga ,2018,0,56034,27964,28070,49.90541457
NC,Watauga ,2019,0,56177,27992,28185,49.82822151
NC,Wayne ,2015,0,124342,60863,63479,48.9480626
NC,Wayne ,2016,0,124269,60809,63460,48.9333623
NC,Wayne ,2017,0,123034,59913,63121,48.69629533
NC,Wayne ,2018,0,123237,60032,63205,48.71264312
NC,Wayne ,2019,0,123131,59972,63159,48.70584987
NC,Wilkes ,2015,0,68298,33689,34609,49.32648101
NC,Wilkes ,2016,0,68581,33789,34792,49.2687479
NC,Wilkes ,2017,0,68489,33751,34738,49.27944633
NC,Wilkes ,2018,0,68563,33703,34860,49.15625046
NC,Wilkes ,2019,0,68412,33612,34800,49.13173128
NC,Wilson ,2015,0,81240,38397,42843,47.26366322
NC,Wilson ,2016,0,81307,38503,42804,47.35508628
NC,Wilson ,2017,0,81436,38562,42874,47.35252223
NC,Wilson ,2018,0,81392,38535,42857,47.34494791
NC,Wilson ,2019,0,81801,38783,43018,47.41140084
NC,Yadkin ,2015,0,37619,18573,19046,49.37132832
NC,Yadkin ,2016,0,37653,18598,19055,49.39314264
NC,Yadkin ,2017,0,37588,18525,19063,49.28434607
NC,Yadkin ,2018,0,37481,18467,19014,49.27029695
NC,Yadkin ,2019,0,37667,18654,19013,49.52345554
NC,Yancey ,2015,0,17550,8643,8907,49.24786325
NC,Yancey ,2016,0,17610,8647,8963,49.10278251
NC,Yancey ,2017,0,17697,8709,8988,49.2117308
NC,Yancey ,2018,0,17873,8795,9078,49.20830303
NC,Yancey ,2019,0,18069,8890,9179,49.20028779
ND,Adams ,2015,0,2397,1186,1211,49.47851481
ND,Adams ,2016,0,2344,1160,1184,49.48805461
ND,Adams ,2017,0,2324,1143,1181,49.18244406
ND,Adams ,2018,0,2276,1122,1154,49.2970123
ND,Adams ,2019,0,2216,1098,1118,49.54873646
ND,Barnes ,2015,0,11008,5542,5466,50.34520349
ND,Barnes ,2016,0,10899,5518,5381,50.62849803
ND,Barnes ,2017,0,10679,5374,5305,50.32306396
ND,Barnes ,2018,0,10527,5306,5221,50.40372376
ND,Barnes ,2019,0,10415,5250,5165,50.40806529
ND,Benson ,2015,0,6820,3508,3312,51.43695015
ND,Benson ,2016,0,6840,3530,3310,51.60818713
ND,Benson ,2017,0,6916,3540,3376,51.18565645
ND,Benson ,2018,0,6958,3565,3393,51.23598735
ND,Benson ,2019,0,6832,3478,3354,50.90749415
ND,Billings ,2015,0,948,527,421,55.5907173
ND,Billings ,2016,0,948,520,428,54.85232068
ND,Billings ,2017,0,922,505,417,54.77223427
ND,Billings ,2018,0,918,501,417,54.5751634
ND,Billings ,2019,0,928,503,425,54.20258621
ND,Bottineau ,2015,0,6734,3507,3227,52.07900208
ND,Bottineau ,2016,0,6573,3408,3165,51.84847102
ND,Bottineau ,2017,0,6522,3365,3157,51.59460288
ND,Bottineau ,2018,0,6398,3302,3096,51.60987809
ND,Bottineau ,2019,0,6282,3239,3043,51.56001273
ND,Bowman ,2015,0,3277,1675,1602,51.11382362
ND,Bowman ,2016,0,3222,1637,1585,50.8069522
ND,Bowman ,2017,0,3150,1593,1557,50.57142857
ND,Bowman ,2018,0,3067,1538,1529,50.14672318
ND,Bowman ,2019,0,3024,1519,1505,50.23148148
ND,Burke ,2015,0,2344,1211,1133,51.66382253
ND,Burke ,2016,0,2227,1161,1066,52.13291423
ND,Burke ,2017,0,2128,1104,1024,51.87969925
ND,Burke ,2018,0,2094,1092,1002,52.14899713
ND,Burke ,2019,0,2115,1105,1010,52.24586288
ND,Burleigh ,2015,0,93211,46603,46608,49.99731791
ND,Burleigh ,2016,0,94606,47478,47128,50.1849777
ND,Burleigh ,2017,0,95247,47734,47513,50.11601415
ND,Burleigh ,2018,0,95276,47729,47547,50.09551199
ND,Burleigh ,2019,0,95626,47883,47743,50.07320185
ND,Cass ,2015,0,170722,86587,84135,50.71812654
ND,Cass ,2016,0,174189,88341,85848,50.71560202
ND,Cass ,2017,0,177745,89983,87762,50.62477144
ND,Cass ,2018,0,180294,91085,89209,50.52026135
ND,Cass ,2019,0,181923,91821,90102,50.47245263
ND,Cavalier ,2015,0,3827,1966,1861,51.37183172
ND,Cavalier ,2016,0,3824,1952,1872,51.0460251
ND,Cavalier ,2017,0,3793,1950,1843,51.41049301
ND,Cavalier ,2018,0,3811,1957,1854,51.35135135
ND,Cavalier ,2019,0,3762,1935,1827,51.4354067
ND,Dickey ,2015,0,5054,2519,2535,49.84170954
ND,Dickey ,2016,0,4987,2491,2496,49.94986966
ND,Dickey ,2017,0,4848,2407,2441,49.64933993
ND,Dickey ,2018,0,4931,2462,2469,49.92902048
ND,Dickey ,2019,0,4872,2452,2420,50.32840722
ND,Divide ,2015,0,2459,1273,1186,51.76901179
ND,Divide ,2016,0,2391,1241,1150,51.90296947
ND,Divide ,2017,0,2295,1200,1095,52.2875817
ND,Divide ,2018,0,2264,1188,1076,52.47349823
ND,Divide ,2019,0,2264,1183,1081,52.25265018
ND,Dunn ,2015,0,4578,2423,2155,52.92704238
ND,Dunn ,2016,0,4372,2318,2054,53.01921317
ND,Dunn ,2017,0,4274,2283,1991,53.41600374
ND,Dunn ,2018,0,4328,2302,2026,53.18853974
ND,Dunn ,2019,0,4424,2372,2052,53.61663653
ND,Eddy ,2015,0,2305,1160,1145,50.32537961
ND,Eddy ,2016,0,2288,1159,1129,50.65559441
ND,Eddy ,2017,0,2315,1154,1161,49.8488121
ND,Eddy ,2018,0,2309,1148,1161,49.71849285
ND,Eddy ,2019,0,2287,1126,1161,49.23480542
ND,Emmons ,2015,0,3397,1728,1669,50.86841331
ND,Emmons ,2016,0,3338,1693,1645,50.71899341
ND,Emmons ,2017,0,3298,1673,1625,50.72771377
ND,Emmons ,2018,0,3278,1661,1617,50.67114094
ND,Emmons ,2019,0,3241,1644,1597,50.72508485
ND,Foster ,2015,0,3325,1659,1666,49.89473684
ND,Foster ,2016,0,3309,1639,1670,49.53158054
ND,Foster ,2017,0,3249,1611,1638,49.58448753
ND,Foster ,2018,0,3207,1596,1611,49.76613658
ND,Foster ,2019,0,3210,1608,1602,50.09345794
ND,Golden Valley ,2015,0,1879,934,945,49.70729111
ND,Golden Valley ,2016,0,1857,926,931,49.86537426
ND,Golden Valley ,2017,0,1779,890,889,50.02810568
ND,Golden Valley ,2018,0,1763,880,883,49.91491775
ND,Golden Valley ,2019,0,1761,875,886,49.68767746
ND,Grand Forks ,2015,0,70352,36241,34111,51.51381624
ND,Grand Forks ,2016,0,70473,36304,34169,51.51476452
ND,Grand Forks ,2017,0,70489,36423,34066,51.67189207
ND,Grand Forks ,2018,0,70355,36265,34090,51.54573236
ND,Grand Forks ,2019,0,69451,35652,33799,51.33403407
ND,Grant ,2015,0,2396,1189,1207,49.62437396
ND,Grant ,2016,0,2379,1184,1195,49.76881042
ND,Grant ,2017,0,2363,1176,1187,49.76724503
ND,Grant ,2018,0,2354,1175,1179,49.91503823
ND,Grant ,2019,0,2274,1147,1127,50.43975374
ND,Griggs ,2015,0,2288,1177,1111,51.44230769
ND,Griggs ,2016,0,2258,1165,1093,51.59433127
ND,Griggs ,2017,0,2244,1155,1089,51.47058824
ND,Griggs ,2018,0,2228,1144,1084,51.3464991
ND,Griggs ,2019,0,2231,1139,1092,51.05333931
ND,Hettinger ,2015,0,2657,1263,1394,47.5348137
ND,Hettinger ,2016,0,2597,1243,1354,47.86291875
ND,Hettinger ,2017,0,2479,1197,1282,48.28559903
ND,Hettinger ,2018,0,2503,1208,1295,48.2620855
ND,Hettinger ,2019,0,2499,1205,1294,48.21928772
ND,Kidder ,2015,0,2449,1269,1180,51.81706819
ND,Kidder ,2016,0,2475,1291,1184,52.16161616
ND,Kidder ,2017,0,2471,1290,1181,52.20558478
ND,Kidder ,2018,0,2453,1277,1176,52.05870363
ND,Kidder ,2019,0,2480,1306,1174,52.66129032
ND,LaMoure ,2015,0,4136,2138,1998,51.69245648
ND,LaMoure ,2016,0,4113,2132,1981,51.83564308
ND,LaMoure ,2017,0,4101,2132,1969,51.98732017
ND,LaMoure ,2018,0,4075,2102,1973,51.58282209
ND,LaMoure ,2019,0,4046,2088,1958,51.60652496
ND,Logan ,2015,0,1927,986,941,51.16761806
ND,Logan ,2016,0,1930,995,935,51.55440415
ND,Logan ,2017,0,1919,991,928,51.64147994
ND,Logan ,2018,0,1887,974,913,51.6163222
ND,Logan ,2019,0,1850,958,892,51.78378378
ND,McHenry ,2015,0,5975,3093,2882,51.76569038
ND,McHenry ,2016,0,5970,3077,2893,51.54103853
ND,McHenry ,2017,0,5890,3044,2846,51.68081494
ND,McHenry ,2018,0,5808,3009,2799,51.80785124
ND,McHenry ,2019,0,5745,2973,2772,51.74934726
ND,McIntosh ,2015,0,2717,1338,1379,49.24549135
ND,McIntosh ,2016,0,2599,1283,1316,49.36514044
ND,McIntosh ,2017,0,2608,1277,1331,48.96472393
ND,McIntosh ,2018,0,2566,1255,1311,48.90880748
ND,McIntosh ,2019,0,2497,1227,1270,49.13896676
ND,McKenzie ,2015,0,12794,6862,5932,53.63451618
ND,McKenzie ,2016,0,12572,6718,5854,53.43620745
ND,McKenzie ,2017,0,12688,6712,5976,52.90037831
ND,McKenzie ,2018,0,13594,7263,6331,53.42798293
ND,McKenzie ,2019,0,15024,8049,6975,53.57428115
ND,McLean ,2015,0,9664,4965,4699,51.37624172
ND,McLean ,2016,0,9643,4941,4702,51.2392409
ND,McLean ,2017,0,9636,4916,4720,51.01701951
ND,McLean ,2018,0,9529,4847,4682,50.86577815
ND,McLean ,2019,0,9450,4795,4655,50.74074074
ND,Mercer ,2015,0,8786,4564,4222,51.94627817
ND,Mercer ,2016,0,8616,4491,4125,52.12395543
ND,Mercer ,2017,0,8457,4397,4060,51.9924323
ND,Mercer ,2018,0,8266,4273,3993,51.69368497
ND,Mercer ,2019,0,8187,4212,3975,51.44741664
ND,Morton ,2015,0,30249,15365,14884,50.79506761
ND,Morton ,2016,0,30732,15574,15158,50.67681895
ND,Morton ,2017,0,30938,15694,15244,50.72726097
ND,Morton ,2018,0,31058,15706,15352,50.56990147
ND,Morton ,2019,0,31364,15852,15512,50.5420227
ND,Mountrail ,2015,0,10311,5667,4644,54.96072156
ND,Mountrail ,2016,0,10234,5553,4681,54.26030877
ND,Mountrail ,2017,0,10276,5529,4747,53.80498248
ND,Mountrail ,2018,0,10239,5518,4721,53.89198164
ND,Mountrail ,2019,0,10545,5677,4868,53.8359412
ND,Nelson ,2015,0,2914,1496,1418,51.33836651
ND,Nelson ,2016,0,2889,1485,1404,51.40186916
ND,Nelson ,2017,0,2902,1491,1411,51.37835975
ND,Nelson ,2018,0,2885,1472,1413,51.02253033
ND,Nelson ,2019,0,2879,1467,1412,50.95519278
ND,Oliver ,2015,0,1865,941,924,50.45576408
ND,Oliver ,2016,0,1895,970,925,51.18733509
ND,Oliver ,2017,0,1930,992,938,51.39896373
ND,Oliver ,2018,0,1945,1019,926,52.3907455
ND,Oliver ,2019,0,1959,1017,942,51.91424196
ND,Pembina ,2015,0,7031,3662,3369,52.08362964
ND,Pembina ,2016,0,7046,3688,3358,52.34175419
ND,Pembina ,2017,0,6962,3658,3304,52.54237288
ND,Pembina ,2018,0,6895,3638,3257,52.76287165
ND,Pembina ,2019,0,6801,3622,3179,53.25687399
ND,Pierce ,2015,0,4273,2166,2107,50.69038147
ND,Pierce ,2016,0,4216,2128,2088,50.4743833
ND,Pierce ,2017,0,4096,2076,2020,50.68359375
ND,Pierce ,2018,0,4070,2076,1994,51.00737101
ND,Pierce ,2019,0,3975,2021,1954,50.8427673
ND,Ramsey ,2015,0,11664,5841,5823,50.07716049
ND,Ramsey ,2016,0,11557,5801,5756,50.1946872
ND,Ramsey ,2017,0,11596,5841,5755,50.37081752
ND,Ramsey ,2018,0,11580,5883,5697,50.80310881
ND,Ramsey ,2019,0,11519,5879,5640,51.03741644
ND,Ransom ,2015,0,5451,2789,2662,51.16492387
ND,Ransom ,2016,0,5375,2776,2599,51.64651163
ND,Ransom ,2017,0,5303,2756,2547,51.97058269
ND,Ransom ,2018,0,5224,2716,2508,51.99081164
ND,Ransom ,2019,0,5218,2707,2511,51.87811422
ND,Renville ,2015,0,2551,1322,1229,51.82281458
ND,Renville ,2016,0,2517,1313,1204,52.16527612
ND,Renville ,2017,0,2455,1278,1177,52.05702648
ND,Renville ,2018,0,2358,1229,1129,52.12044105
ND,Renville ,2019,0,2327,1221,1106,52.47099269
ND,Richland ,2015,0,16286,8375,7911,51.42453641
ND,Richland ,2016,0,16289,8367,7922,51.36595248
ND,Richland ,2017,0,16287,8395,7892,51.54417634
ND,Richland ,2018,0,16229,8374,7855,51.59898946
ND,Richland ,2019,0,16177,8349,7828,51.61031094
ND,Rolette ,2015,0,14698,7259,7439,49.38767179
ND,Rolette ,2016,0,14716,7300,7416,49.60587116
ND,Rolette ,2017,0,14614,7245,7369,49.57574928
ND,Rolette ,2018,0,14349,7133,7216,49.71078124
ND,Rolette ,2019,0,14176,7073,7103,49.89418736
ND,Sargent ,2015,0,3866,2047,1819,52.94878427
ND,Sargent ,2016,0,3883,2071,1812,53.33505022
ND,Sargent ,2017,0,3862,2059,1803,53.3143449
ND,Sargent ,2018,0,3851,2057,1794,53.41469748
ND,Sargent ,2019,0,3898,2078,1820,53.30938943
ND,Sheridan ,2015,0,1311,658,653,50.19069413
ND,Sheridan ,2016,0,1342,682,660,50.81967213
ND,Sheridan ,2017,0,1351,692,659,51.22131754
ND,Sheridan ,2018,0,1342,675,667,50.29806259
ND,Sheridan ,2019,0,1315,663,652,50.41825095
ND,Sioux ,2015,0,4377,2185,2192,49.92003655
ND,Sioux ,2016,0,4457,2235,2222,50.14583801
ND,Sioux ,2017,0,4425,2204,2221,49.8079096
ND,Sioux ,2018,0,4377,2189,2188,50.01142335
ND,Sioux ,2019,0,4230,2118,2112,50.07092199
ND,Slope ,2015,0,781,413,368,52.8809219
ND,Slope ,2016,0,781,414,367,53.00896287
ND,Slope ,2017,0,767,405,362,52.80312907
ND,Slope ,2018,0,761,396,365,52.03679369
ND,Slope ,2019,0,750,390,360,52
ND,Stark ,2015,0,31861,16819,15042,52.78867581
ND,Stark ,2016,0,30869,16106,14763,52.17532152
ND,Stark ,2017,0,30291,15636,14655,51.61929286
ND,Stark ,2018,0,30893,15961,14932,51.66542582
ND,Stark ,2019,0,31489,16274,15215,51.68153959
ND,Steele ,2015,0,1915,985,930,51.43603133
ND,Steele ,2016,0,1912,986,926,51.56903766
ND,Steele ,2017,0,1906,982,924,51.52151102
ND,Steele ,2018,0,1892,982,910,51.90274841
ND,Steele ,2019,0,1890,976,914,51.64021164
ND,Stutsman ,2015,0,21047,10751,10296,51.08091414
ND,Stutsman ,2016,0,21068,10798,10270,51.25308525
ND,Stutsman ,2017,0,21132,10870,10262,51.43857657
ND,Stutsman ,2018,0,20875,10731,10144,51.40598802
ND,Stutsman ,2019,0,20704,10599,10105,51.19300618
ND,Towner ,2015,0,2251,1140,1111,50.64415815
ND,Towner ,2016,0,2249,1141,1108,50.7336594
ND,Towner ,2017,0,2244,1135,1109,50.57932264
ND,Towner ,2018,0,2185,1101,1084,50.38901602
ND,Towner ,2019,0,2189,1114,1075,50.89081772
ND,Traill ,2015,0,7987,4046,3941,50.65731814
ND,Traill ,2016,0,8001,4041,3960,50.50618673
ND,Traill ,2017,0,7998,4046,3952,50.58764691
ND,Traill ,2018,0,8020,4078,3942,50.8478803
ND,Traill ,2019,0,8036,4095,3941,50.95818815
ND,Walsh ,2015,0,10852,5499,5353,50.67268706
ND,Walsh ,2016,0,10816,5500,5316,50.85059172
ND,Walsh ,2017,0,10801,5530,5271,51.19896306
ND,Walsh ,2018,0,10645,5435,5210,51.05683419
ND,Walsh ,2019,0,10641,5433,5208,51.05723146
ND,Ward ,2015,0,70703,37322,33381,52.78701045
ND,Ward ,2016,0,69489,36627,32862,52.70906187
ND,Ward ,2017,0,68516,36012,32504,52.55998599
ND,Ward ,2018,0,67713,35440,32273,52.33854651
ND,Ward ,2019,0,67641,35381,32260,52.30703272
ND,Wells ,2015,0,4095,2059,2036,50.28083028
ND,Wells ,2016,0,4049,2041,2008,50.40750803
ND,Wells ,2017,0,3994,2026,1968,50.72608913
ND,Wells ,2018,0,3908,1970,1938,50.40941658
ND,Wells ,2019,0,3834,1923,1911,50.15649452
ND,Williams ,2015,0,35301,19301,16000,54.67550494
ND,Williams ,2016,0,34213,18418,15795,53.8333382
ND,Williams ,2017,0,33467,17919,15548,53.5422954
ND,Williams ,2018,0,35469,19029,16440,53.64966591
ND,Williams ,2019,0,37589,20261,17328,53.90140733
OH,Adams ,2015,0,27926,13822,14104,49.49509418
OH,Adams ,2016,0,27807,13799,14008,49.62419535
OH,Adams ,2017,0,27753,13789,13964,49.68471877
OH,Adams ,2018,0,27694,13736,13958,49.59919116
OH,Adams ,2019,0,27698,13727,13971,49.55953498
OH,Allen ,2015,0,104095,52529,51566,50.46255824
OH,Allen ,2016,0,103613,52351,51262,50.52551321
OH,Allen ,2017,0,103093,52104,50989,50.54077386
OH,Allen ,2018,0,102725,51851,50874,50.47554149
OH,Allen ,2019,0,102351,51652,50699,50.46555481
OH,Ashland ,2015,0,53310,26143,27167,49.03957982
OH,Ashland ,2016,0,53520,26309,27211,49.15732436
OH,Ashland ,2017,0,53662,26307,27355,49.02351757
OH,Ashland ,2018,0,53706,26415,27291,49.18444866
OH,Ashland ,2019,0,53484,26288,27196,49.15114801
OH,Ashtabula ,2015,0,98404,49476,48928,50.27844397
OH,Ashtabula ,2016,0,98171,49459,48712,50.38045859
OH,Ashtabula ,2017,0,97748,49256,48492,50.39080083
OH,Ashtabula ,2018,0,97587,49205,48382,50.42167502
OH,Ashtabula ,2019,0,97241,49072,48169,50.46431032
OH,Athens ,2015,0,65886,32907,32979,49.94536017
OH,Athens ,2016,0,66352,33066,33286,49.83421751
OH,Athens ,2017,0,66503,33088,33415,49.75414643
OH,Athens ,2018,0,65519,32605,32914,49.76419054
OH,Athens ,2019,0,65327,32422,32905,49.63032131
OH,Auglaize ,2015,0,45734,22766,22968,49.77915774
OH,Auglaize ,2016,0,45766,22782,22984,49.77931215
OH,Auglaize ,2017,0,45753,22814,22939,49.86339694
OH,Auglaize ,2018,0,45736,22856,22880,49.97376246
OH,Auglaize ,2019,0,45656,22833,22823,50.01095146
OH,Belmont ,2015,0,68973,35205,33768,51.04171197
OH,Belmont ,2016,0,68606,35045,33561,51.08153806
OH,Belmont ,2017,0,68002,34766,33236,51.12496691
OH,Belmont ,2018,0,67533,34494,33039,51.07725112
OH,Belmont ,2019,0,67006,34220,32786,51.07005343
OH,Brown ,2015,0,43697,21741,21956,49.75398769
OH,Brown ,2016,0,43638,21657,21981,49.62876392
OH,Brown ,2017,0,43523,21640,21883,49.72083726
OH,Brown ,2018,0,43570,21590,21980,49.55244434
OH,Brown ,2019,0,43432,21558,21874,49.63621293
OH,Butler ,2015,0,375998,184232,191766,48.99813297
OH,Butler ,2016,0,378354,185276,193078,48.968955
OH,Butler ,2017,0,380607,186486,194121,48.9969969
OH,Butler ,2018,0,382000,187182,194818,49.00052356
OH,Butler ,2019,0,383134,187806,195328,49.01835911
OH,Carroll ,2015,0,27718,13870,13848,50.0396854
OH,Carroll ,2016,0,27621,13815,13806,50.01629195
OH,Carroll ,2017,0,27324,13652,13672,49.96340214
OH,Carroll ,2018,0,27082,13559,13523,50.06646481
OH,Carroll ,2019,0,26914,13460,13454,50.01114662
OH,Champaign ,2015,0,38963,19473,19490,49.97818443
OH,Champaign ,2016,0,38741,19347,19394,49.93934075
OH,Champaign ,2017,0,38851,19365,19486,49.84427685
OH,Champaign ,2018,0,38785,19327,19458,49.83112028
OH,Champaign ,2019,0,38885,19409,19476,49.91384853
OH,Clark ,2015,0,135746,65786,69960,48.4625698
OH,Clark ,2016,0,134723,65282,69441,48.45646252
OH,Clark ,2017,0,134549,65139,69410,48.41284588
OH,Clark ,2018,0,134528,65125,69403,48.40999643
OH,Clark ,2019,0,134083,65007,69076,48.48265627
OH,Clermont ,2015,0,201995,99571,102424,49.2937944
OH,Clermont ,2016,0,203165,100047,103118,49.24421037
OH,Clermont ,2017,0,204260,100578,103682,49.24018408
OH,Clermont ,2018,0,205526,101392,104134,49.33293111
OH,Clermont ,2019,0,206428,101882,104546,49.3547387
OH,Clinton ,2015,0,41839,20576,21263,49.17899567
OH,Clinton ,2016,0,41887,20678,21209,49.36615179
OH,Clinton ,2017,0,42004,20748,21256,49.39529569
OH,Clinton ,2018,0,42085,20786,21299,49.39051919
OH,Clinton ,2019,0,41968,20722,21246,49.37571483
OH,Columbiana ,2015,0,104714,52861,51853,50.481311
OH,Columbiana ,2016,0,103817,52410,51407,50.48306154
OH,Columbiana ,2017,0,103062,51996,51066,50.45118472
OH,Columbiana ,2018,0,102473,51840,50633,50.58893562
OH,Columbiana ,2019,0,101883,51648,50235,50.69344248
OH,Coshocton ,2015,0,36577,18087,18490,49.44910736
OH,Coshocton ,2016,0,36617,18134,18483,49.52344539
OH,Coshocton ,2017,0,36536,18096,18440,49.52923144
OH,Coshocton ,2018,0,36596,18138,18458,49.56279375
OH,Coshocton ,2019,0,36600,18144,18456,49.57377049
OH,Crawford ,2015,0,42324,20717,21607,48.94858709
OH,Crawford ,2016,0,42095,20611,21484,48.96305975
OH,Crawford ,2017,0,41710,20423,21287,48.96427715
OH,Crawford ,2018,0,41484,20311,21173,48.96104522
OH,Crawford ,2019,0,41494,20264,21230,48.83597629
OH,Cuyahoga ,2015,0,1258739,599429,659310,47.62138934
OH,Cuyahoga ,2016,0,1254144,597469,656675,47.63958525
OH,Cuyahoga ,2017,0,1247581,595000,652581,47.69229413
OH,Cuyahoga ,2018,0,1241718,592094,649624,47.68345148
OH,Cuyahoga ,2019,0,1235072,588936,646136,47.68434553
OH,Darke ,2015,0,51981,25618,26363,49.28339201
OH,Darke ,2016,0,51624,25517,26107,49.42856036
OH,Darke ,2017,0,51549,25526,26023,49.51793439
OH,Darke ,2018,0,51299,25458,25841,49.62669838
OH,Darke ,2019,0,51113,25423,25690,49.738814
OH,Defiance ,2015,0,38326,19028,19298,49.6477587
OH,Defiance ,2016,0,38140,18891,19249,49.53067646
OH,Defiance ,2017,0,38156,18942,19214,49.64356851
OH,Defiance ,2018,0,38089,18913,19176,49.65475597
OH,Defiance ,2019,0,38087,18898,19189,49.61797989
OH,Delaware ,2015,0,193391,95660,97731,49.46455626
OH,Delaware ,2016,0,197144,97599,99545,49.50645214
OH,Delaware ,2017,0,200870,99464,101406,49.51660278
OH,Delaware ,2018,0,205091,101720,103371,49.59749575
OH,Delaware ,2019,0,209177,103968,105209,49.70336127
OH,Erie ,2015,0,75360,36852,38508,48.90127389
OH,Erie ,2016,0,74999,36623,38376,48.83131775
OH,Erie ,2017,0,74760,36549,38211,48.88844302
OH,Erie ,2018,0,74513,36381,38132,48.82503724
OH,Erie ,2019,0,74266,36302,37964,48.8810492
OH,Fairfield ,2015,0,151254,75332,75922,49.80496384
OH,Fairfield ,2016,0,152789,76030,76759,49.76143571
OH,Fairfield ,2017,0,154686,77102,77584,49.84420051
OH,Fairfield ,2018,0,155982,77562,78420,49.72496827
OH,Fairfield ,2019,0,157574,78359,79215,49.72838159
OH,Fayette ,2015,0,28611,14109,14502,49.31320122
OH,Fayette ,2016,0,28670,14109,14561,49.21171957
OH,Fayette ,2017,0,28639,14134,14505,49.35228185
OH,Fayette ,2018,0,28653,14092,14561,49.18158657
OH,Fayette ,2019,0,28525,14035,14490,49.20245399
OH,Franklin ,2015,0,1257386,612997,644389,48.75169598
OH,Franklin ,2016,0,1274450,621780,652670,48.78810467
OH,Franklin ,2017,0,1295510,632372,663138,48.81259118
OH,Franklin ,2018,0,1307698,638382,669316,48.81723456
OH,Franklin ,2019,0,1316756,642836,673920,48.81967502
OH,Fulton ,2015,0,42301,20923,21378,49.46218766
OH,Fulton ,2016,0,42306,20921,21385,49.45161443
OH,Fulton ,2017,0,42265,20963,21302,49.59895895
OH,Fulton ,2018,0,42267,20951,21316,49.56822107
OH,Fulton ,2019,0,42126,20931,21195,49.68665432
OH,Gallia ,2015,0,30249,14916,15333,49.31072102
OH,Gallia ,2016,0,30186,14948,15238,49.51964487
OH,Gallia ,2017,0,30162,14895,15267,49.38333002
OH,Gallia ,2018,0,29945,14775,15170,49.34045751
OH,Gallia ,2019,0,29898,14771,15127,49.40464245
OH,Geauga ,2015,0,93894,46334,47560,49.34713613
OH,Geauga ,2016,0,93845,46400,47445,49.44323086
OH,Geauga ,2017,0,93881,46489,47392,49.51907202
OH,Geauga ,2018,0,93945,46617,47328,49.6215871
OH,Geauga ,2019,0,93649,46533,47116,49.68873133
OH,Greene ,2015,0,164272,80830,83442,49.20497711
OH,Greene ,2016,0,165290,81460,83830,49.28307823
OH,Greene ,2017,0,166566,82013,84553,49.23753947
OH,Greene ,2018,0,167446,82438,85008,49.23258842
OH,Greene ,2019,0,168937,83171,85766,49.23196221
OH,Guernsey ,2015,0,39392,19557,19835,49.64713647
OH,Guernsey ,2016,0,39211,19512,19699,49.7615465
OH,Guernsey ,2017,0,39066,19465,19601,49.8259356
OH,Guernsey ,2018,0,39011,19446,19565,49.84747892
OH,Guernsey ,2019,0,38875,19428,19447,49.9755627
OH,Hamilton ,2015,0,809527,389901,419626,48.16405135
OH,Hamilton ,2016,0,811332,391422,419910,48.24436852
OH,Hamilton ,2017,0,814170,393289,420881,48.30551359
OH,Hamilton ,2018,0,815445,394053,421392,48.32367603
OH,Hamilton ,2019,0,817473,395072,422401,48.32844632
OH,Hancock ,2015,0,75678,37263,38415,49.23888052
OH,Hancock ,2016,0,75831,37351,38480,49.25558149
OH,Hancock ,2017,0,75973,37526,38447,49.39386361
OH,Hancock ,2018,0,75920,37561,38359,49.47444679
OH,Hancock ,2019,0,75783,37523,38260,49.51374319
OH,Hardin ,2015,0,31616,15691,15925,49.62993421
OH,Hardin ,2016,0,31398,15594,15804,49.6655838
OH,Hardin ,2017,0,31329,15576,15753,49.71751412
OH,Hardin ,2018,0,31418,15623,15795,49.72627156
OH,Hardin ,2019,0,31365,15636,15729,49.85174558
OH,Harrison ,2015,0,15395,7602,7793,49.37966872
OH,Harrison ,2016,0,15252,7535,7717,49.40335694
OH,Harrison ,2017,0,15202,7524,7678,49.4934877
OH,Harrison ,2018,0,15167,7533,7634,49.66704028
OH,Harrison ,2019,0,15040,7455,7585,49.56781915
OH,Henry ,2015,0,27481,13527,13954,49.2230996
OH,Henry ,2016,0,27282,13477,13805,49.39887105
OH,Henry ,2017,0,27179,13447,13732,49.47569815
OH,Henry ,2018,0,27091,13389,13702,49.42231737
OH,Henry ,2019,0,27006,13376,13630,49.52973413
OH,Highland ,2015,0,42960,21058,21902,49.01769088
OH,Highland ,2016,0,43006,21053,21953,48.95363438
OH,Highland ,2017,0,42903,21008,21895,48.96627275
OH,Highland ,2018,0,43052,21116,21936,49.04766329
OH,Highland ,2019,0,43161,21253,21908,49.24121313
OH,Hocking ,2015,0,28500,14080,14420,49.40350877
OH,Hocking ,2016,0,28393,14018,14375,49.37132392
OH,Hocking ,2017,0,28436,14046,14390,49.39513293
OH,Hocking ,2018,0,28357,14046,14311,49.53274324
OH,Hocking ,2019,0,28264,14032,14232,49.64619304
OH,Holmes ,2015,0,43882,21987,21895,50.10482658
OH,Holmes ,2016,0,43847,21986,21861,50.14254111
OH,Holmes ,2017,0,43895,21973,21922,50.05809318
OH,Holmes ,2018,0,43919,22004,21915,50.10132289
OH,Holmes ,2019,0,43960,21999,21961,50.04322111
OH,Huron ,2015,0,58307,28810,29497,49.41087691
OH,Huron ,2016,0,58367,28836,29531,49.40462933
OH,Huron ,2017,0,58393,28839,29554,49.38776908
OH,Huron ,2018,0,58364,28854,29510,49.43800973
OH,Huron ,2019,0,58266,28814,29452,49.4525109
OH,Jackson ,2015,0,32559,15993,16566,49.12005897
OH,Jackson ,2016,0,32528,15910,16618,48.91170684
OH,Jackson ,2017,0,32386,15854,16532,48.9532514
OH,Jackson ,2018,0,32366,15863,16503,49.01130816
OH,Jackson ,2019,0,32413,15911,16502,49.08832876
OH,Jefferson ,2015,0,67495,32794,34701,48.58730276
OH,Jefferson ,2016,0,66944,32484,34460,48.52413958
OH,Jefferson ,2017,0,66318,32172,34146,48.51171628
OH,Jefferson ,2018,0,65774,31920,33854,48.52981421
OH,Jefferson ,2019,0,65325,31766,33559,48.62763108
OH,Knox ,2015,0,61001,29869,31132,48.96477107
OH,Knox ,2016,0,60909,29820,31089,48.95828203
OH,Knox ,2017,0,61271,30018,31253,48.99218227
OH,Knox ,2018,0,61900,30314,31586,48.97253635
OH,Knox ,2019,0,62322,30483,31839,48.91210167
OH,Lake ,2015,0,229836,112251,117585,48.83960737
OH,Lake ,2016,0,229525,112141,117384,48.85785862
OH,Lake ,2017,0,230159,112390,117769,48.83145999
OH,Lake ,2018,0,230102,112349,117753,48.82573815
OH,Lake ,2019,0,230149,112300,117849,48.79447662
OH,Lawrence ,2015,0,60923,29682,31241,48.72051606
OH,Lawrence ,2016,0,60691,29575,31116,48.73045427
OH,Lawrence ,2017,0,60075,29310,30765,48.78901373
OH,Lawrence ,2018,0,59767,29077,30690,48.65059314
OH,Lawrence ,2019,0,59463,28986,30477,48.7462792
OH,Licking ,2015,0,170611,83786,86825,49.10937747
OH,Licking ,2016,0,171993,84447,87546,49.09909124
OH,Licking ,2017,0,173617,85258,88359,49.10694229
OH,Licking ,2018,0,175666,86255,89411,49.10170437
OH,Licking ,2019,0,176862,86816,90046,49.08685868
OH,Logan ,2015,0,45250,22325,22925,49.33701657
OH,Logan ,2016,0,45128,22312,22816,49.44158837
OH,Logan ,2017,0,45198,22409,22789,49.57962742
OH,Logan ,2018,0,45332,22468,22864,49.56322245
OH,Logan ,2019,0,45672,22666,23006,49.6277807
OH,Lorain ,2015,0,305417,150433,154984,49.25495306
OH,Lorain ,2016,0,306607,151083,155524,49.27578301
OH,Lorain ,2017,0,307441,151354,156087,49.23025881
OH,Lorain ,2018,0,309052,151999,157053,49.18233825
OH,Lorain ,2019,0,309833,152425,157408,49.19585712
OH,Lucas ,2015,0,433633,210108,223525,48.45295446
OH,Lucas ,2016,0,432879,210052,222827,48.52441444
OH,Lucas ,2017,0,431039,208630,222409,48.40165275
OH,Lucas ,2018,0,429612,208187,221425,48.45930747
OH,Lucas ,2019,0,428348,207181,221167,48.3674489
OH,Madison ,2015,0,44139,24092,20047,54.58211559
OH,Madison ,2016,0,43377,23371,20006,53.87878369
OH,Madison ,2017,0,44041,23922,20119,54.31756772
OH,Madison ,2018,0,44389,24073,20316,54.2319043
OH,Madison ,2019,0,44731,24312,20419,54.35156826
OH,Mahoning ,2015,0,231846,112903,118943,48.69741121
OH,Mahoning ,2016,0,230269,112289,117980,48.76427135
OH,Mahoning ,2017,0,229791,112167,117624,48.81261668
OH,Mahoning ,2018,0,229216,112146,117070,48.92590395
OH,Mahoning ,2019,0,228683,111963,116720,48.95991394
OH,Marion ,2015,0,65431,34619,30812,52.90917149
OH,Marion ,2016,0,65467,34811,30656,53.17335451
OH,Marion ,2017,0,65076,34518,30558,53.04259635
OH,Marion ,2018,0,65427,34729,30698,53.0805325
OH,Marion ,2019,0,65093,34481,30612,52.97190174
OH,Medina ,2015,0,176126,87016,89110,49.40553922
OH,Medina ,2016,0,176876,87392,89484,49.40862525
OH,Medina ,2017,0,178176,88086,90090,49.4376347
OH,Medina ,2018,0,178978,88606,90372,49.50664327
OH,Medina ,2019,0,179746,89015,90731,49.52265975
OH,Meigs ,2015,0,23180,11441,11739,49.35720449
OH,Meigs ,2016,0,23166,11433,11733,49.35249935
OH,Meigs ,2017,0,23071,11420,11651,49.49937151
OH,Meigs ,2018,0,23064,11404,11660,49.44502255
OH,Meigs ,2019,0,22907,11321,11586,49.42157419
OH,Mercer ,2015,0,40723,20470,20253,50.2664342
OH,Mercer ,2016,0,40715,20498,20217,50.34508167
OH,Mercer ,2017,0,40858,20640,20218,50.51642273
OH,Mercer ,2018,0,40952,20658,20294,50.44442274
OH,Mercer ,2019,0,41172,20778,20394,50.46633635
OH,Miami ,2015,0,104075,51269,52806,49.2615902
OH,Miami ,2016,0,104553,51475,53078,49.23340315
OH,Miami ,2017,0,105200,51718,53482,49.16159696
OH,Miami ,2018,0,106042,52196,53846,49.22200637
OH,Miami ,2019,0,106987,52705,54282,49.26299457
OH,Monroe ,2015,0,14253,7164,7089,50.2631025
OH,Monroe ,2016,0,14083,7050,7033,50.06035646
OH,Monroe ,2017,0,13931,7007,6924,50.29789678
OH,Monroe ,2018,0,13787,6947,6840,50.38804671
OH,Monroe ,2019,0,13654,6868,6786,50.30027831
OH,Montgomery ,2015,0,531777,256030,275747,48.1461214
OH,Montgomery ,2016,0,531818,255974,275844,48.1318797
OH,Montgomery ,2017,0,531467,255718,275749,48.11549917
OH,Montgomery ,2018,0,531600,255822,275778,48.12302483
OH,Montgomery ,2019,0,531687,255809,275878,48.11270541
OH,Morgan ,2015,0,14735,7359,7376,49.94231422
OH,Morgan ,2016,0,14733,7388,7345,50.1459309
OH,Morgan ,2017,0,14644,7313,7331,49.93854138
OH,Morgan ,2018,0,14581,7273,7308,49.8799808
OH,Morgan ,2019,0,14508,7234,7274,49.86214502
OH,Morrow ,2015,0,34943,17507,17436,50.10159402
OH,Morrow ,2016,0,34922,17485,17437,50.06872459
OH,Morrow ,2017,0,34911,17487,17424,50.09022944
OH,Morrow ,2018,0,35113,17511,17602,49.87041836
OH,Morrow ,2019,0,35328,17663,17665,49.99716938
OH,Muskingum ,2015,0,86194,41773,44421,48.4639302
OH,Muskingum ,2016,0,85993,41666,44327,48.45278104
OH,Muskingum ,2017,0,86123,41768,44355,48.49807833
OH,Muskingum ,2018,0,86131,41790,44341,48.51911623
OH,Muskingum ,2019,0,86215,41904,44311,48.60407122
OH,Noble ,2015,0,14467,8401,6066,58.07009055
OH,Noble ,2016,0,14441,8414,6027,58.26466311
OH,Noble ,2017,0,14400,8394,6006,58.29166667
OH,Noble ,2018,0,14347,8391,5956,58.48609465
OH,Noble ,2019,0,14424,8448,5976,58.56905158
OH,Ottawa ,2015,0,40754,20187,20567,49.53378809
OH,Ottawa ,2016,0,40488,20050,20438,49.52084568
OH,Ottawa ,2017,0,40623,20171,20452,49.65413682
OH,Ottawa ,2018,0,40769,20231,20538,49.62348843
OH,Ottawa ,2019,0,40525,20148,20377,49.71745836
OH,Paulding ,2015,0,18959,9443,9516,49.8074793
OH,Paulding ,2016,0,18839,9424,9415,50.02388662
OH,Paulding ,2017,0,18831,9401,9430,49.92299931
OH,Paulding ,2018,0,18742,9331,9411,49.78657561
OH,Paulding ,2019,0,18672,9260,9412,49.59297344
OH,Perry ,2015,0,35967,18002,17965,50.05143604
OH,Perry ,2016,0,35998,18041,17957,50.11667315
OH,Perry ,2017,0,35972,18007,17965,50.05837874
OH,Perry ,2018,0,36039,18051,17988,50.08740531
OH,Perry ,2019,0,36134,18087,18047,50.05534953
OH,Pickaway ,2015,0,56989,29941,27048,52.53820913
OH,Pickaway ,2016,0,57545,30297,27248,52.64923104
OH,Pickaway ,2017,0,57740,30300,27440,52.47661933
OH,Pickaway ,2018,0,58077,30473,27604,52.46999673
OH,Pickaway ,2019,0,58457,30677,27780,52.47788973
OH,Pike ,2015,0,28117,14024,14093,49.87729843
OH,Pike ,2016,0,28093,14003,14090,49.84515716
OH,Pike ,2017,0,28088,13972,14116,49.74366277
OH,Pike ,2018,0,27932,13850,14082,49.58470571
OH,Pike ,2019,0,27772,13724,14048,49.41667867
OH,Portage ,2015,0,162594,79666,82928,48.99688795
OH,Portage ,2016,0,162521,79728,82793,49.05704494
OH,Portage ,2017,0,162473,79605,82868,48.99583315
OH,Portage ,2018,0,162502,79663,82839,49.02278126
OH,Portage ,2019,0,162466,79587,82879,48.98686494
OH,Preble ,2015,0,41297,20473,20824,49.57502966
OH,Preble ,2016,0,41157,20386,20771,49.53227883
OH,Preble ,2017,0,41116,20360,20756,49.51843565
OH,Preble ,2018,0,41011,20322,20689,49.55255907
OH,Preble ,2019,0,40882,20263,20619,49.56460056
OH,Putnam ,2015,0,34026,16981,17045,49.90595427
OH,Putnam ,2016,0,34007,16989,17018,49.95736172
OH,Putnam ,2017,0,33860,16976,16884,50.13585351
OH,Putnam ,2018,0,33802,16873,16929,49.91716466
OH,Putnam ,2019,0,33861,16936,16925,50.01624288
OH,Richland ,2015,0,121688,61829,59859,50.80944711
OH,Richland ,2016,0,121242,61625,59617,50.82809587
OH,Richland ,2017,0,120430,60924,59506,50.58872374
OH,Richland ,2018,0,120987,61436,59551,50.77900932
OH,Richland ,2019,0,121154,61548,59606,50.8014593
OH,Ross ,2015,0,77049,40328,36721,52.34071824
OH,Ross ,2016,0,76848,40280,36568,52.41515719
OH,Ross ,2017,0,77295,40716,36579,52.676111
OH,Ross ,2018,0,76884,40245,36639,52.34509131
OH,Ross ,2019,0,76666,40012,36654,52.19001904
OH,Sandusky ,2015,0,59475,29397,30078,49.42749054
OH,Sandusky ,2016,0,59317,29337,29980,49.45799686
OH,Sandusky ,2017,0,59093,29194,29899,49.40348265
OH,Sandusky ,2018,0,58740,29081,29659,49.50800136
OH,Sandusky ,2019,0,58518,28982,29536,49.52664138
OH,Scioto ,2015,0,76992,37916,39076,49.24667498
OH,Scioto ,2016,0,76436,37709,38727,49.33408342
OH,Scioto ,2017,0,75976,37535,38441,49.40375908
OH,Scioto ,2018,0,75480,37226,38254,49.31902491
OH,Scioto ,2019,0,75314,37261,38053,49.47420134
OH,Seneca ,2015,0,55650,27791,27859,49.93890386
OH,Seneca ,2016,0,55467,27708,27759,49.95402672
OH,Seneca ,2017,0,55267,27618,27649,49.97195433
OH,Seneca ,2018,0,55194,27574,27620,49.9583288
OH,Seneca ,2019,0,55178,27578,27600,49.98006452
OH,Shelby ,2015,0,49030,24648,24382,50.27126249
OH,Shelby ,2016,0,48765,24511,24254,50.26350866
OH,Shelby ,2017,0,48738,24458,24280,50.18260905
OH,Shelby ,2018,0,48622,24430,24192,50.24474518
OH,Shelby ,2019,0,48590,24405,24185,50.22638403
OH,Stark ,2015,0,374715,181991,192724,48.5678449
OH,Stark ,2016,0,373447,181343,192104,48.5592333
OH,Stark ,2017,0,372003,180855,191148,48.61654341
OH,Stark ,2018,0,371248,180362,190886,48.58261863
OH,Stark ,2019,0,370606,180118,190488,48.60094008
OH,Summit ,2015,0,541788,262831,278957,48.51177952
OH,Summit ,2016,0,541003,262556,278447,48.53133901
OH,Summit ,2017,0,541514,262611,278903,48.4956991
OH,Summit ,2018,0,541353,262441,278912,48.47871906
OH,Summit ,2019,0,541013,262367,278646,48.4955075
OH,Trumbull ,2015,0,203328,99139,104189,48.75816415
OH,Trumbull ,2016,0,201715,98365,103350,48.76434574
OH,Trumbull ,2017,0,200281,97642,102639,48.75250273
OH,Trumbull ,2018,0,198539,96579,101960,48.64485063
OH,Trumbull ,2019,0,197974,96558,101416,48.77307121
OH,Tuscarawas ,2015,0,92739,45790,46949,49.37512805
OH,Tuscarawas ,2016,0,92560,45690,46870,49.36257563
OH,Tuscarawas ,2017,0,92308,45590,46718,49.38900204
OH,Tuscarawas ,2018,0,92079,45445,46634,49.35435876
OH,Tuscarawas ,2019,0,91987,45378,46609,49.33088371
OH,Union ,2015,0,54388,25965,28423,47.74031036
OH,Union ,2016,0,55581,26519,29062,47.71234774
OH,Union ,2017,0,56798,27162,29636,47.82210641
OH,Union ,2018,0,57782,27704,30078,47.94572704
OH,Union ,2019,0,58988,28315,30673,48.0012884
OH,Van Wert ,2015,0,28319,13890,14429,49.0483421
OH,Van Wert ,2016,0,28177,13876,14301,49.2458388
OH,Van Wert ,2017,0,28283,13933,14350,49.26280805
OH,Van Wert ,2018,0,28253,13972,14281,49.45315542
OH,Van Wert ,2019,0,28275,13948,14327,49.32979664
OH,Vinton ,2015,0,13082,6566,6516,50.19110228
OH,Vinton ,2016,0,13022,6534,6488,50.17662417
OH,Vinton ,2017,0,13082,6573,6509,50.24461092
OH,Vinton ,2018,0,13145,6594,6551,50.16356029
OH,Vinton ,2019,0,13085,6581,6504,50.29423003
OH,Warren ,2015,0,223864,112551,111313,50.27650717
OH,Warren ,2016,0,226539,113970,112569,50.30921828
OH,Warren ,2017,0,228709,115014,113695,50.28835769
OH,Warren ,2018,0,231945,116671,115274,50.30114898
OH,Warren ,2019,0,234602,118330,116272,50.43861519
OH,Washington ,2015,0,61020,30030,30990,49.21337266
OH,Washington ,2016,0,60598,29854,30744,49.26565233
OH,Washington ,2017,0,60491,29742,30749,49.16764477
OH,Washington ,2018,0,60111,29506,30605,49.08585783
OH,Washington ,2019,0,59911,29473,30438,49.19463871
OH,Wayne ,2015,0,116214,57760,58454,49.70141291
OH,Wayne ,2016,0,116613,57919,58694,49.66770429
OH,Wayne ,2017,0,116168,57717,58451,49.68407823
OH,Wayne ,2018,0,115790,57546,58244,49.69859228
OH,Wayne ,2019,0,115710,57501,58209,49.69406274
OH,Williams ,2015,0,37007,18336,18671,49.54738293
OH,Williams ,2016,0,36937,18278,18659,49.48425698
OH,Williams ,2017,0,36707,18269,18438,49.76979868
OH,Williams ,2018,0,36739,18284,18455,49.76727728
OH,Williams ,2019,0,36692,18287,18405,49.83920201
OH,Wood ,2015,0,129285,63751,65534,49.31043818
OH,Wood ,2016,0,129768,64004,65764,49.32186672
OH,Wood ,2017,0,130437,64265,66172,49.26899576
OH,Wood ,2018,0,130441,64258,66183,49.26211851
OH,Wood ,2019,0,130817,64504,66313,49.3085761
OH,Wyandot ,2015,0,22176,11009,11167,49.64375902
OH,Wyandot ,2016,0,22071,10973,11098,49.71682298
OH,Wyandot ,2017,0,22063,10968,11095,49.71218783
OH,Wyandot ,2018,0,21918,10891,11027,49.68975271
OH,Wyandot ,2019,0,21772,10834,10938,49.76116112
OK,Adair ,2015,0,22259,11124,11135,49.97529089
OK,Adair ,2016,0,22305,11109,11196,49.80497646
OK,Adair ,2017,0,22119,11056,11063,49.9841765
OK,Adair ,2018,0,22224,11093,11131,49.91450684
OK,Adair ,2019,0,22194,11106,11088,50.0405515
OK,Alfalfa ,2015,0,5917,3512,2405,59.35440257
OK,Alfalfa ,2016,0,5936,3528,2408,59.43396226
OK,Alfalfa ,2017,0,5913,3520,2393,59.52984948
OK,Alfalfa ,2018,0,5765,3444,2321,59.73980919
OK,Alfalfa ,2019,0,5702,3403,2299,59.68081375
OK,Atoka ,2015,0,13889,7257,6632,52.249982
OK,Atoka ,2016,0,13894,7259,6635,52.24557363
OK,Atoka ,2017,0,13779,7173,6606,52.05747877
OK,Atoka ,2018,0,13795,7178,6617,52.03334542
OK,Atoka ,2019,0,13758,7173,6585,52.13693851
OK,Beaver ,2015,0,5455,2738,2717,50.19248396
OK,Beaver ,2016,0,5435,2715,2720,49.95400184
OK,Beaver ,2017,0,5364,2694,2670,50.22371365
OK,Beaver ,2018,0,5318,2690,2628,50.58292591
OK,Beaver ,2019,0,5311,2684,2627,50.53662211
OK,Beckham ,2015,0,23554,12654,10900,53.72335909
OK,Beckham ,2016,0,22427,12089,10338,53.9037767
OK,Beckham ,2017,0,21779,11721,10058,53.81789798
OK,Beckham ,2018,0,21720,11667,10053,53.71546961
OK,Beckham ,2019,0,21859,11696,10163,53.5065648
OK,Blaine ,2015,0,9762,4821,4941,49.38537185
OK,Blaine ,2016,0,9625,4745,4880,49.2987013
OK,Blaine ,2017,0,9512,4695,4817,49.35870479
OK,Blaine ,2018,0,9454,4702,4752,49.73556167
OK,Blaine ,2019,0,9429,4692,4737,49.76137448
OK,Bryan ,2015,0,45021,22028,22993,48.92827791
OK,Bryan ,2016,0,45599,22280,23319,48.86072063
OK,Bryan ,2017,0,46481,22710,23771,48.85867344
OK,Bryan ,2018,0,47191,23055,24136,48.85465449
OK,Bryan ,2019,0,47995,23414,24581,48.78424836
OK,Caddo ,2015,0,29433,15368,14065,52.21350185
OK,Caddo ,2016,0,29630,15522,14108,52.38609517
OK,Caddo ,2017,0,29356,15438,13918,52.58890857
OK,Caddo ,2018,0,29028,15261,13767,52.57337743
OK,Caddo ,2019,0,28762,15176,13586,52.7640637
OK,Canadian ,2015,0,133158,66156,67002,49.68233227
OK,Canadian ,2016,0,136386,67773,68613,49.6920505
OK,Canadian ,2017,0,140001,69448,70553,49.60535996
OK,Canadian ,2018,0,144426,71658,72768,49.61572016
OK,Canadian ,2019,0,148306,73640,74666,49.65409356
OK,Carter ,2015,0,48568,23645,24923,48.68431889
OK,Carter ,2016,0,48431,23501,24930,48.52470525
OK,Carter ,2017,0,48273,23481,24792,48.64209807
OK,Carter ,2018,0,48213,23464,24749,48.66737187
OK,Carter ,2019,0,48111,23480,24631,48.80380786
OK,Cherokee ,2015,0,48376,23771,24605,49.13800232
OK,Cherokee ,2016,0,48791,24069,24722,49.33081921
OK,Cherokee ,2017,0,48891,23997,24894,49.08265325
OK,Cherokee ,2018,0,48607,23753,24854,48.86744708
OK,Cherokee ,2019,0,48657,23725,24932,48.75968514
OK,Choctaw ,2015,0,14984,7204,7780,48.07794981
OK,Choctaw ,2016,0,14877,7166,7711,48.1683135
OK,Choctaw ,2017,0,14804,7126,7678,48.13563902
OK,Choctaw ,2018,0,14698,7049,7649,47.95890597
OK,Choctaw ,2019,0,14672,7040,7632,47.9825518
OK,Cimarron ,2015,0,2225,1117,1108,50.20224719
OK,Cimarron ,2016,0,2189,1108,1081,50.61671996
OK,Cimarron ,2017,0,2152,1082,1070,50.27881041
OK,Cimarron ,2018,0,2165,1095,1070,50.57736721
OK,Cimarron ,2019,0,2137,1088,1049,50.91249415
OK,Cleveland ,2015,0,273841,136668,137173,49.90779321
OK,Cleveland ,2016,0,277809,138625,139184,49.89939131
OK,Cleveland ,2017,0,279542,139649,139893,49.95635718
OK,Cleveland ,2018,0,281166,140293,140873,49.89685808
OK,Cleveland ,2019,0,284014,141670,142344,49.88134388
OK,Coal ,2015,0,5608,2746,2862,48.9657632
OK,Coal ,2016,0,5652,2786,2866,49.29228592
OK,Coal ,2017,0,5630,2799,2831,49.71580817
OK,Coal ,2018,0,5520,2763,2757,50.05434783
OK,Coal ,2019,0,5495,2743,2752,49.91810737
OK,Comanche ,2015,0,124005,64392,59613,51.92693843
OK,Comanche ,2016,0,121743,63115,58628,51.84281642
OK,Comanche ,2017,0,121786,63232,58554,51.920582
OK,Comanche ,2018,0,120528,62442,58086,51.80704898
OK,Comanche ,2019,0,120749,62682,58067,51.91098891
OK,Cotton ,2015,0,6006,2968,3038,49.41724942
OK,Cotton ,2016,0,5933,2940,2993,49.55334569
OK,Cotton ,2017,0,5863,2897,2966,49.41156405
OK,Cotton ,2018,0,5820,2859,2961,49.12371134
OK,Cotton ,2019,0,5666,2788,2878,49.20578892
OK,Craig ,2015,0,14709,7511,7198,51.06397444
OK,Craig ,2016,0,14465,7383,7082,51.04044245
OK,Craig ,2017,0,14332,7351,6981,51.29081775
OK,Craig ,2018,0,14300,7336,6964,51.3006993
OK,Craig ,2019,0,14142,7247,6895,51.24451987
OK,Creek ,2015,0,70801,35097,35704,49.57133374
OK,Creek ,2016,0,71191,35276,35915,49.55120732
OK,Creek ,2017,0,71890,35632,36258,49.5646126
OK,Creek ,2018,0,71730,35523,36207,49.52321205
OK,Creek ,2019,0,71522,35398,36124,49.49246386
OK,Custer ,2015,0,29565,14810,14755,50.09301539
OK,Custer ,2016,0,29222,14564,14658,49.83916227
OK,Custer ,2017,0,28974,14434,14540,49.81707738
OK,Custer ,2018,0,28995,14449,14546,49.83272978
OK,Custer ,2019,0,29003,14426,14577,49.7396821
OK,Delaware ,2015,0,41704,20557,21147,49.2926338
OK,Delaware ,2016,0,41965,20662,21303,49.23626832
OK,Delaware ,2017,0,42672,21015,21657,49.24775028
OK,Delaware ,2018,0,42814,21109,21705,49.30396599
OK,Delaware ,2019,0,43009,21226,21783,49.35246111
OK,Dewey ,2015,0,4984,2467,2517,49.49839486
OK,Dewey ,2016,0,4905,2424,2481,49.41896024
OK,Dewey ,2017,0,4899,2430,2469,49.60195958
OK,Dewey ,2018,0,4931,2432,2499,49.32062462
OK,Dewey ,2019,0,4891,2399,2492,49.04927418
OK,Ellis ,2015,0,4223,2069,2154,48.99360644
OK,Ellis ,2016,0,4085,2000,2085,48.95960832
OK,Ellis ,2017,0,3970,1949,2021,49.09319899
OK,Ellis ,2018,0,3939,1933,2006,49.07336888
OK,Ellis ,2019,0,3859,1892,1967,49.02824566
OK,Garfield ,2015,0,63248,31556,31692,49.89248672
OK,Garfield ,2016,0,62493,31232,31261,49.9767974
OK,Garfield ,2017,0,61600,30691,30909,49.82305195
OK,Garfield ,2018,0,61095,30524,30571,49.96153531
OK,Garfield ,2019,0,61056,30623,30433,50.15559486
OK,Garvin ,2015,0,27920,13781,14139,49.35888252
OK,Garvin ,2016,0,27940,13825,14115,49.48103078
OK,Garvin ,2017,0,27857,13745,14112,49.34127867
OK,Garvin ,2018,0,27746,13691,14055,49.34404959
OK,Garvin ,2019,0,27711,13684,14027,49.38111219
OK,Grady ,2015,0,54559,27263,27296,49.96975751
OK,Grady ,2016,0,54683,27322,27361,49.96433992
OK,Grady ,2017,0,54829,27419,27410,50.00820734
OK,Grady ,2018,0,55448,27735,27713,50.01983841
OK,Grady ,2019,0,55834,27930,27904,50.0232833
OK,Grant ,2015,0,4500,2261,2239,50.24444444
OK,Grant ,2016,0,4454,2226,2228,49.97754827
OK,Grant ,2017,0,4379,2173,2206,49.62320164
OK,Grant ,2018,0,4321,2147,2174,49.68757232
OK,Grant ,2019,0,4333,2148,2185,49.57304408
OK,Greer ,2015,0,6031,3445,2586,57.12153872
OK,Greer ,2016,0,5954,3410,2544,57.2724219
OK,Greer ,2017,0,5793,3317,2476,57.25876057
OK,Greer ,2018,0,5814,3349,2465,57.60233918
OK,Greer ,2019,0,5712,3297,2415,57.72058824
OK,Harmon ,2015,0,2782,1343,1439,48.27462257
OK,Harmon ,2016,0,2712,1307,1405,48.19321534
OK,Harmon ,2017,0,2710,1297,1413,47.8597786
OK,Harmon ,2018,0,2691,1289,1402,47.90040877
OK,Harmon ,2019,0,2653,1287,1366,48.51111949
OK,Harper ,2015,0,3826,1900,1926,49.66021955
OK,Harper ,2016,0,3776,1896,1880,50.21186441
OK,Harper ,2017,0,3784,1916,1868,50.63424947
OK,Harper ,2018,0,3727,1887,1840,50.63053394
OK,Harper ,2019,0,3688,1865,1823,50.56941432
OK,Haskell ,2015,0,12750,6362,6388,49.89803922
OK,Haskell ,2016,0,12695,6333,6362,49.8857818
OK,Haskell ,2017,0,12726,6366,6360,50.02357379
OK,Haskell ,2018,0,12636,6315,6321,49.97625831
OK,Haskell ,2019,0,12627,6307,6320,49.94852301
OK,Hughes ,2015,0,13592,7285,6307,53.59770453
OK,Hughes ,2016,0,13417,7229,6188,53.87940672
OK,Hughes ,2017,0,13265,7183,6082,54.15001885
OK,Hughes ,2018,0,13305,7200,6105,54.11499436
OK,Hughes ,2019,0,13279,7187,6092,54.12305143
OK,Jackson ,2015,0,25459,12686,12773,49.82913704
OK,Jackson ,2016,0,25440,12681,12759,49.84669811
OK,Jackson ,2017,0,25112,12536,12576,49.9203568
OK,Jackson ,2018,0,24775,12325,12450,49.74772957
OK,Jackson ,2019,0,24530,12195,12335,49.71463514
OK,Jefferson ,2015,0,6266,3140,3126,50.11171401
OK,Jefferson ,2016,0,6250,3142,3108,50.272
OK,Jefferson ,2017,0,6164,3091,3073,50.14600909
OK,Jefferson ,2018,0,6106,3053,3053,50
OK,Jefferson ,2019,0,6002,2998,3004,49.95001666
OK,Johnston ,2015,0,10967,5443,5524,49.63071031
OK,Johnston ,2016,0,11126,5503,5623,49.46072263
OK,Johnston ,2017,0,11121,5490,5631,49.3660642
OK,Johnston ,2018,0,11020,5449,5571,49.44646098
OK,Johnston ,2019,0,11085,5487,5598,49.49932341
OK,Kay ,2015,0,45226,22428,22798,49.59094326
OK,Kay ,2016,0,44901,22308,22593,49.68263513
OK,Kay ,2017,0,44403,22007,22396,49.56196653
OK,Kay ,2018,0,43944,21798,22146,49.60404151
OK,Kay ,2019,0,43538,21625,21913,49.66925444
OK,Kingfisher ,2015,0,15588,7771,7817,49.8524506
OK,Kingfisher ,2016,0,15613,7813,7800,50.04163197
OK,Kingfisher ,2017,0,15688,7823,7865,49.86613972
OK,Kingfisher ,2018,0,15814,7869,7945,49.75970659
OK,Kingfisher ,2019,0,15765,7855,7910,49.82556296
OK,Kiowa ,2015,0,9116,4529,4587,49.68187802
OK,Kiowa ,2016,0,9025,4483,4542,49.67313019
OK,Kiowa ,2017,0,8849,4399,4450,49.71183185
OK,Kiowa ,2018,0,8732,4362,4370,49.95419148
OK,Kiowa ,2019,0,8708,4343,4365,49.87367938
OK,Latimer ,2015,0,10624,5389,5235,50.7247741
OK,Latimer ,2016,0,10550,5355,5195,50.75829384
OK,Latimer ,2017,0,10318,5240,5078,50.78503586
OK,Latimer ,2018,0,10175,5144,5031,50.55528256
OK,Latimer ,2019,0,10073,5090,4983,50.5311228
OK,Le Flore ,2015,0,50018,25035,24983,50.05198129
OK,Le Flore ,2016,0,50144,25153,24991,50.16153478
OK,Le Flore ,2017,0,50020,25112,24908,50.20391843
OK,Le Flore ,2018,0,50093,25138,24955,50.18266025
OK,Le Flore ,2019,0,49853,25003,24850,50.15345115
OK,Lincoln ,2015,0,34928,17423,17505,49.88261567
OK,Lincoln ,2016,0,34872,17291,17581,49.58419362
OK,Lincoln ,2017,0,34961,17408,17553,49.79262607
OK,Lincoln ,2018,0,34837,17338,17499,49.76892385
OK,Lincoln ,2019,0,34877,17375,17502,49.81793159
OK,Logan ,2015,0,45346,22480,22866,49.57438363
OK,Logan ,2016,0,46027,22764,23263,49.45792687
OK,Logan ,2017,0,46785,23142,23643,49.46457198
OK,Logan ,2018,0,47248,23419,23829,49.5661192
OK,Logan ,2019,0,48011,23829,24182,49.63237591
OK,Love ,2015,0,9815,4895,4920,49.87264391
OK,Love ,2016,0,10016,4988,5028,49.80031949
OK,Love ,2017,0,10076,5033,5043,49.95037713
OK,Love ,2018,0,10156,5088,5068,50.09846396
OK,Love ,2019,0,10253,5139,5114,50.12191554
OK,McClain ,2015,0,37973,18820,19153,49.56153056
OK,McClain ,2016,0,38597,19136,19461,49.57898282
OK,McClain ,2017,0,39306,19437,19869,49.45046558
OK,McClain ,2018,0,39887,19750,20137,49.51487953
OK,McClain ,2019,0,40474,20046,20428,49.52809211
OK,McCurtain ,2015,0,33173,16283,16890,49.08509933
OK,McCurtain ,2016,0,33078,16246,16832,49.11421489
OK,McCurtain ,2017,0,33031,16237,16794,49.15685265
OK,McCurtain ,2018,0,32967,16192,16775,49.11578245
OK,McCurtain ,2019,0,32832,16159,16673,49.2172271
OK,McIntosh ,2015,0,19817,9786,10031,49.38184387
OK,McIntosh ,2016,0,19766,9784,9982,49.49913994
OK,McIntosh ,2017,0,19701,9790,9911,49.69290899
OK,McIntosh ,2018,0,19745,9754,9991,49.39984806
OK,McIntosh ,2019,0,19596,9678,9918,49.38763013
OK,Major ,2015,0,7771,3829,3942,49.27293785
OK,Major ,2016,0,7751,3815,3936,49.21945555
OK,Major ,2017,0,7684,3751,3933,48.81572098
OK,Major ,2018,0,7627,3742,3885,49.06254097
OK,Major ,2019,0,7629,3725,3904,48.82684493
OK,Marshall ,2015,0,16266,8092,8174,49.74794049
OK,Marshall ,2016,0,16237,8039,8198,49.51037753
OK,Marshall ,2017,0,16364,8037,8327,49.11390858
OK,Marshall ,2018,0,16727,8192,8535,48.97471154
OK,Marshall ,2019,0,16931,8266,8665,48.82168803
OK,Mayes ,2015,0,40889,20365,20524,49.80557118
OK,Mayes ,2016,0,41035,20441,20594,49.81357378
OK,Mayes ,2017,0,40988,20419,20569,49.81701962
OK,Mayes ,2018,0,41210,20592,20618,49.96845426
OK,Mayes ,2019,0,41100,20523,20577,49.93430657
OK,Murray ,2015,0,13860,6960,6900,50.21645022
OK,Murray ,2016,0,13909,6977,6932,50.16176576
OK,Murray ,2017,0,13918,6998,6920,50.28021267
OK,Murray ,2018,0,13968,7040,6928,50.40091638
OK,Murray ,2019,0,14073,7083,6990,50.33041995
OK,Muskogee ,2015,0,69319,33833,35486,48.8076862
OK,Muskogee ,2016,0,69012,33615,35397,48.70892019
OK,Muskogee ,2017,0,69027,33627,35400,48.71571994
OK,Muskogee ,2018,0,68324,33234,35090,48.6417657
OK,Muskogee ,2019,0,67997,33122,34875,48.71097254
OK,Noble ,2015,0,11550,5714,5836,49.47186147
OK,Noble ,2016,0,11410,5666,5744,49.65819457
OK,Noble ,2017,0,11303,5594,5709,49.4912855
OK,Noble ,2018,0,11279,5606,5673,49.70298785
OK,Noble ,2019,0,11131,5483,5648,49.2588267
OK,Nowata ,2015,0,10519,5244,5275,49.85264759
OK,Nowata ,2016,0,10415,5188,5227,49.81277004
OK,Nowata ,2017,0,10322,5149,5173,49.88374346
OK,Nowata ,2018,0,10278,5128,5150,49.89297529
OK,Nowata ,2019,0,10076,5052,5024,50.13894403
OK,Okfuskee ,2015,0,12107,6488,5619,53.58883291
OK,Okfuskee ,2016,0,12079,6508,5571,53.87863234
OK,Okfuskee ,2017,0,12076,6494,5582,53.7760848
OK,Okfuskee ,2018,0,12081,6533,5548,54.07664928
OK,Okfuskee ,2019,0,11993,6532,5461,54.46510464
OK,Oklahoma ,2015,0,777373,380391,396982,48.93288035
OK,Oklahoma ,2016,0,784611,384114,400497,48.95597946
OK,Oklahoma ,2017,0,786068,384854,401214,48.95937756
OK,Oklahoma ,2018,0,790593,387206,403387,48.97665423
OK,Oklahoma ,2019,0,797434,390407,407027,48.95790749
OK,Okmulgee ,2015,0,39065,19229,19836,49.22308972
OK,Okmulgee ,2016,0,39075,19276,19799,49.33077415
OK,Okmulgee ,2017,0,38819,19136,19683,49.29544811
OK,Okmulgee ,2018,0,38321,18939,19382,49.42198794
OK,Okmulgee ,2019,0,38465,18968,19497,49.31236189
OK,Osage ,2015,0,47338,23812,23526,50.30208289
OK,Osage ,2016,0,47364,23739,23625,50.12034457
OK,Osage ,2017,0,47346,23698,23648,50.05280277
OK,Osage ,2018,0,47121,23640,23481,50.16871459
OK,Osage ,2019,0,46963,23573,23390,50.19483423
OK,Ottawa ,2015,0,31862,15632,16230,49.06157806
OK,Ottawa ,2016,0,31592,15505,16087,49.07888073
OK,Ottawa ,2017,0,31368,15418,15950,49.15200204
OK,Ottawa ,2018,0,31319,15392,15927,49.14588588
OK,Ottawa ,2019,0,31127,15283,15844,49.09885309
OK,Pawnee ,2015,0,16439,8190,8249,49.8205487
OK,Pawnee ,2016,0,16471,8217,8254,49.88768138
OK,Pawnee ,2017,0,16419,8172,8247,49.77160607
OK,Pawnee ,2018,0,16356,8126,8230,49.68207386
OK,Pawnee ,2019,0,16376,8158,8218,49.81680508
OK,Payne ,2015,0,81363,41752,39611,51.31570861
OK,Payne ,2016,0,81850,41797,40053,51.06536347
OK,Payne ,2017,0,81908,41854,40054,51.09879377
OK,Payne ,2018,0,82172,41930,40242,51.02711386
OK,Payne ,2019,0,81784,41760,40024,51.06133229
OK,Pittsburg ,2015,0,44716,22720,21996,50.80955363
OK,Pittsburg ,2016,0,44335,22601,21734,50.97778279
OK,Pittsburg ,2017,0,44154,22528,21626,51.02142501
OK,Pittsburg ,2018,0,43870,22356,21514,50.95965352
OK,Pittsburg ,2019,0,43654,22222,21432,50.90484263
OK,Pontotoc ,2015,0,38336,18682,19654,48.7322621
OK,Pontotoc ,2016,0,38512,18780,19732,48.7640216
OK,Pontotoc ,2017,0,38371,18689,19682,48.70605405
OK,Pontotoc ,2018,0,38272,18624,19648,48.66220736
OK,Pontotoc ,2019,0,38284,18630,19654,48.66262668
OK,Pottawatomie ,2015,0,71479,34145,37334,47.76927489
OK,Pottawatomie ,2016,0,72001,34450,37551,47.84655769
OK,Pottawatomie ,2017,0,72185,34496,37689,47.78832167
OK,Pottawatomie ,2018,0,72513,34775,37738,47.95691807
OK,Pottawatomie ,2019,0,72592,34887,37705,48.05901477
OK,Pushmataha ,2015,0,11162,5501,5661,49.28328257
OK,Pushmataha ,2016,0,11070,5468,5602,49.39476061
OK,Pushmataha ,2017,0,11118,5468,5650,49.18150747
OK,Pushmataha ,2018,0,11192,5495,5697,49.09756969
OK,Pushmataha ,2019,0,11096,5441,5655,49.03568854
OK,Roger Mills ,2015,0,3773,1884,1889,49.93373973
OK,Roger Mills ,2016,0,3671,1817,1854,49.49605012
OK,Roger Mills ,2017,0,3661,1821,1840,49.74050806
OK,Roger Mills ,2018,0,3646,1814,1832,49.75315414
OK,Roger Mills ,2019,0,3583,1786,1797,49.84649735
OK,Rogers ,2015,0,90080,44938,45142,49.88676732
OK,Rogers ,2016,0,90992,45295,45697,49.77910146
OK,Rogers ,2017,0,91435,45536,45899,49.80149833
OK,Rogers ,2018,0,91801,45728,46073,49.81209355
OK,Rogers ,2019,0,92459,46041,46418,49.79612585
OK,Seminole ,2015,0,25399,12458,12941,49.04917516
OK,Seminole ,2016,0,25137,12315,12822,48.99152644
OK,Seminole ,2017,0,24845,12166,12679,48.96759911
OK,Seminole ,2018,0,24520,12037,12483,49.09053834
OK,Seminole ,2019,0,24258,11896,12362,49.03949213
OK,Sequoyah ,2015,0,41782,20645,21137,49.41122972
OK,Sequoyah ,2016,0,41867,20621,21246,49.25358875
OK,Sequoyah ,2017,0,41742,20601,21141,49.35316947
OK,Sequoyah ,2018,0,41585,20490,21095,49.27257425
OK,Sequoyah ,2019,0,41569,20507,21062,49.33243523
OK,Stephens ,2015,0,44576,21703,22873,48.6876346
OK,Stephens ,2016,0,43998,21351,22647,48.52720578
OK,Stephens ,2017,0,43340,20980,22360,48.40793724
OK,Stephens ,2018,0,43179,20875,22304,48.34526043
OK,Stephens ,2019,0,43143,20898,22245,48.43891245
OK,Texas ,2015,0,21446,11482,9964,53.53912151
OK,Texas ,2016,0,21183,11403,9780,53.83090214
OK,Texas ,2017,0,20924,11234,9690,53.68954311
OK,Texas ,2018,0,20491,10974,9517,53.55521936
OK,Texas ,2019,0,19983,10637,9346,53.23024571
OK,Tillman ,2015,0,7567,3804,3763,50.27091318
OK,Tillman ,2016,0,7525,3794,3731,50.41860465
OK,Tillman ,2017,0,7399,3731,3668,50.42573321
OK,Tillman ,2018,0,7323,3689,3634,50.37552915
OK,Tillman ,2019,0,7250,3674,3576,50.67586207
OK,Tulsa ,2015,0,640470,312521,327949,48.795572
OK,Tulsa ,2016,0,645951,315322,330629,48.81515781
OK,Tulsa ,2017,0,646437,315554,330883,48.81434695
OK,Tulsa ,2018,0,647683,316124,331559,48.80844487
OK,Tulsa ,2019,0,651552,318080,333472,48.81882029
OK,Wagoner ,2015,0,76733,37939,38794,49.44287334
OK,Wagoner ,2016,0,77662,38436,39226,49.49138575
OK,Wagoner ,2017,0,78984,39143,39841,49.55813836
OK,Wagoner ,2018,0,80123,39700,40423,49.54881869
OK,Wagoner ,2019,0,81289,40182,41107,49.43104233
OK,Washington ,2015,0,52091,25369,26722,48.70131117
OK,Washington ,2016,0,52027,25329,26698,48.68433698
OK,Washington ,2017,0,51996,25388,26608,48.82683283
OK,Washington ,2018,0,51791,25316,26475,48.88107972
OK,Washington ,2019,0,51527,25150,26377,48.80936208
OK,Washita ,2015,0,11687,5774,5913,49.40532215
OK,Washita ,2016,0,11433,5678,5755,49.66325549
OK,Washita ,2017,0,11055,5494,5561,49.6969697
OK,Washita ,2018,0,11036,5475,5561,49.61036607
OK,Washita ,2019,0,10916,5399,5517,49.45950898
OK,Woods ,2015,0,9303,4958,4345,53.29463614
OK,Woods ,2016,0,9157,4907,4250,53.58741946
OK,Woods ,2017,0,9069,4850,4219,53.47888411
OK,Woods ,2018,0,8893,4748,4145,53.39030698
OK,Woods ,2019,0,8793,4708,4085,53.5425907
OK,Woodward ,2015,0,21608,11365,10243,52.59626064
OK,Woodward ,2016,0,20975,11032,9943,52.59594756
OK,Woodward ,2017,0,20531,10750,9781,52.35984609
OK,Woodward ,2018,0,20312,10682,9630,52.58960221
OK,Woodward ,2019,0,20211,10647,9564,52.67923408
OR,Baker ,2015,0,15882,8057,7825,50.7303866
OR,Baker ,2016,0,15971,8126,7845,50.87971949
OR,Baker ,2017,0,16083,8190,7893,50.9233352
OR,Baker ,2018,0,16034,8158,7876,50.87938131
OR,Baker ,2019,0,16124,8225,7899,51.01091541
OR,Benton ,2015,0,88333,44351,43982,50.20886871
OR,Benton ,2016,0,89918,45205,44713,50.2735826
OR,Benton ,2017,0,91790,46091,45699,50.21353089
OR,Benton ,2018,0,92442,46423,46019,50.21851539
OR,Benton ,2019,0,93053,46619,46434,50.09940572
OR,Clackamas ,2015,0,399647,196530,203117,49.17589773
OR,Clackamas ,2016,0,406625,200029,206596,49.19249923
OR,Clackamas ,2017,0,412442,203111,209331,49.24595458
OR,Clackamas ,2018,0,415416,204756,210660,49.28938702
OR,Clackamas ,2019,0,418187,206274,211913,49.32578009
OR,Clatsop ,2015,0,37797,18715,19082,49.51451173
OR,Clatsop ,2016,0,38678,19086,19592,49.34588138
OR,Clatsop ,2017,0,39101,19335,19766,49.4488632
OR,Clatsop ,2018,0,39711,19654,20057,49.49258392
OR,Clatsop ,2019,0,40224,19895,20329,49.46052108
OR,Columbia ,2015,0,49646,24828,24818,50.0100713
OR,Columbia ,2016,0,50905,25462,25443,50.01866221
OR,Columbia ,2017,0,51724,25836,25888,49.9497332
OR,Columbia ,2018,0,52245,26149,26096,50.05072256
OR,Columbia ,2019,0,52354,26224,26130,50.08977347
OR,Coos ,2015,0,62643,30876,31767,49.28882716
OR,Coos ,2016,0,63319,31187,32132,49.25377849
OR,Coos ,2017,0,63708,31409,32299,49.3015006
OR,Coos ,2018,0,64272,31722,32550,49.35586258
OR,Coos ,2019,0,64487,31848,32639,49.38669809
OR,Crook ,2015,0,21455,10624,10831,49.51759497
OR,Crook ,2016,0,22306,11070,11236,49.62790281
OR,Crook ,2017,0,23065,11451,11614,49.64665077
OR,Crook ,2018,0,23825,11824,12001,49.62854145
OR,Crook ,2019,0,24404,12106,12298,49.60662187
OR,Curry ,2015,0,22293,10954,11339,49.13650025
OR,Curry ,2016,0,22607,11127,11480,49.21926837
OR,Curry ,2017,0,22630,11155,11475,49.29297393
OR,Curry ,2018,0,22795,11234,11561,49.28273744
OR,Curry ,2019,0,22925,11259,11666,49.11232279
OR,Deschutes ,2015,0,174246,85964,88282,49.33484843
OR,Deschutes ,2016,0,180666,89232,91434,49.39058816
OR,Deschutes ,2017,0,186744,92349,94395,49.45219124
OR,Deschutes ,2018,0,191905,94962,96943,49.4838592
OR,Deschutes ,2019,0,197692,97863,99829,49.50276187
OR,Douglas ,2015,0,107164,52770,54394,49.24228286
OR,Douglas ,2016,0,108116,53244,54872,49.24710496
OR,Douglas ,2017,0,109197,53831,55366,49.29714186
OR,Douglas ,2018,0,110114,54257,55857,49.27348021
OR,Douglas ,2019,0,110980,54671,56309,49.26202919
OR,Gilliam ,2015,0,1868,937,931,50.16059957
OR,Gilliam ,2016,0,1857,940,917,50.61927841
OR,Gilliam ,2017,0,1862,947,915,50.85929108
OR,Gilliam ,2018,0,1893,968,925,51.13576334
OR,Gilliam ,2019,0,1912,965,947,50.4707113
OR,Grant ,2015,0,7207,3624,3583,50.28444568
OR,Grant ,2016,0,7166,3615,3551,50.44655317
OR,Grant ,2017,0,7188,3636,3552,50.58430718
OR,Grant ,2018,0,7185,3601,3584,50.11830202
OR,Grant ,2019,0,7199,3620,3579,50.28476177
OR,Harney ,2015,0,7150,3603,3547,50.39160839
OR,Harney ,2016,0,7243,3652,3591,50.42109623
OR,Harney ,2017,0,7258,3687,3571,50.79911821
OR,Harney ,2018,0,7292,3716,3576,50.95995612
OR,Harney ,2019,0,7393,3765,3628,50.92655214
OR,Hood River ,2015,0,22927,11484,11443,50.08941423
OR,Hood River ,2016,0,23070,11497,11573,49.83528392
OR,Hood River ,2017,0,23398,11670,11728,49.87605778
OR,Hood River ,2018,0,23267,11606,11661,49.88180685
OR,Hood River ,2019,0,23382,11689,11693,49.99144641
OR,Jackson ,2015,0,211403,103064,108339,48.75238289
OR,Jackson ,2016,0,214366,104667,109699,48.82630641
OR,Jackson ,2017,0,216746,105911,110835,48.86410822
OR,Jackson ,2018,0,219411,107176,112235,48.84714075
OR,Jackson ,2019,0,220944,107935,113009,48.85174524
OR,Jefferson ,2015,0,22541,11688,10853,51.85218047
OR,Jefferson ,2016,0,23036,11948,11088,51.86664351
OR,Jefferson ,2017,0,23652,12219,11433,51.6615931
OR,Jefferson ,2018,0,24150,12473,11677,51.64803313
OR,Jefferson ,2019,0,24658,12744,11914,51.68302377
OR,Josephine ,2015,0,84528,41322,43206,48.88557638
OR,Josephine ,2016,0,85504,41817,43687,48.90648391
OR,Josephine ,2017,0,86584,42263,44321,48.81155872
OR,Josephine ,2018,0,87150,42548,44602,48.821572
OR,Josephine ,2019,0,87487,42652,44835,48.75238607
OR,Klamath ,2015,0,65670,32808,32862,49.95888534
OR,Klamath ,2016,0,66198,33047,33151,49.92144778
OR,Klamath ,2017,0,66810,33290,33520,49.82787008
OR,Klamath ,2018,0,67687,33849,33838,50.00812564
OR,Klamath ,2019,0,68238,34123,34115,50.00586184
OR,Lake ,2015,0,7779,4159,3620,53.46445559
OR,Lake ,2016,0,7830,4197,3633,53.60153257
OR,Lake ,2017,0,7874,4203,3671,53.37820676
OR,Lake ,2018,0,7835,4157,3678,53.05679643
OR,Lake ,2019,0,7869,4181,3688,53.13254543
OR,Lane ,2015,0,361946,178311,183635,49.26453117
OR,Lane ,2016,0,368874,181759,187115,49.27400684
OR,Lane ,2017,0,375264,184861,190403,49.26158651
OR,Lane ,2018,0,378549,186208,192341,49.18993314
OR,Lane ,2019,0,382067,187811,194256,49.15656155
OR,Lincoln ,2015,0,46999,22651,24348,48.19464244
OR,Lincoln ,2016,0,47793,23104,24689,48.34180738
OR,Lincoln ,2017,0,48757,23581,25176,48.36433743
OR,Lincoln ,2018,0,49224,23789,25435,48.32805136
OR,Lincoln ,2019,0,49962,24131,25831,48.29870702
OR,Linn ,2015,0,120236,59460,60776,49.45274294
OR,Linn ,2016,0,122769,60686,62083,49.4310453
OR,Linn ,2017,0,125035,61858,63177,49.47254769
OR,Linn ,2018,0,127451,63021,64430,49.44723855
OR,Linn ,2019,0,129749,64248,65501,49.51714464
OR,Malheur ,2015,0,30211,16387,13824,54.24183245
OR,Malheur ,2016,0,30340,16459,13881,54.24851681
OR,Malheur ,2017,0,30385,16507,13878,54.32614777
OR,Malheur ,2018,0,30553,16587,13966,54.28926783
OR,Malheur ,2019,0,30571,16617,13954,54.35543489
OR,Marion ,2015,0,329060,163959,165101,49.82647541
OR,Marion ,2016,0,335382,167184,168198,49.8488291
OR,Marion ,2017,0,340531,169650,170881,49.81925287
OR,Marion ,2018,0,345412,172096,173316,49.8233993
OR,Marion ,2019,0,347818,173337,174481,49.83554618
OR,Morrow ,2015,0,11130,5742,5388,51.5902965
OR,Morrow ,2016,0,11222,5800,5422,51.68419177
OR,Morrow ,2017,0,11198,5741,5457,51.26808359
OR,Morrow ,2018,0,11360,5819,5541,51.22359155
OR,Morrow ,2019,0,11603,5901,5702,50.85753684
OR,Multnomah ,2015,0,790008,391358,398650,49.53848569
OR,Multnomah ,2016,0,803212,398046,405166,49.55677953
OR,Multnomah ,2017,0,807885,400154,407731,49.53105949
OR,Multnomah ,2018,0,809072,400638,408434,49.51821346
OR,Multnomah ,2019,0,812855,402131,410724,49.47143094
OR,Polk ,2015,0,78962,38420,40542,48.6563157
OR,Polk ,2016,0,81436,39711,41725,48.76344614
OR,Polk ,2017,0,83711,40900,42811,48.85857295
OR,Polk ,2018,0,84992,41516,43476,48.8469503
OR,Polk ,2019,0,86085,42099,43986,48.90399024
OR,Sherman ,2015,0,1689,854,835,50.562463
OR,Sherman ,2016,0,1708,865,843,50.6440281
OR,Sherman ,2017,0,1735,887,848,51.12391931
OR,Sherman ,2018,0,1700,879,821,51.70588235
OR,Sherman ,2019,0,1780,925,855,51.96629213
OR,Tillamook ,2015,0,25561,12877,12684,50.37752827
OR,Tillamook ,2016,0,26116,13193,12923,50.51692449
OR,Tillamook ,2017,0,26522,13360,13162,50.37327502
OR,Tillamook ,2018,0,26710,13506,13204,50.56533134
OR,Tillamook ,2019,0,27036,13654,13382,50.50303299
OR,Umatilla ,2015,0,76467,39898,36569,52.17675599
OR,Umatilla ,2016,0,76686,40075,36611,52.25856088
OR,Umatilla ,2017,0,77120,40230,36890,52.16545643
OR,Umatilla ,2018,0,77421,40419,37002,52.20676561
OR,Umatilla ,2019,0,77950,40789,37161,52.32713278
OR,Union ,2015,0,25703,12736,12967,49.55063611
OR,Union ,2016,0,26061,12894,13167,49.47622885
OR,Union ,2017,0,26383,13038,13345,49.41818595
OR,Union ,2018,0,26701,13224,13477,49.52623497
OR,Union ,2019,0,26835,13295,13540,49.54350661
OR,Wallowa ,2015,0,6813,3346,3467,49.11199178
OR,Wallowa ,2016,0,6915,3383,3532,48.92263196
OR,Wallowa ,2017,0,7025,3453,3572,49.15302491
OR,Wallowa ,2018,0,7058,3484,3574,49.36242562
OR,Wallowa ,2019,0,7208,3543,3665,49.15371809
OR,Wasco ,2015,0,25457,12705,12752,49.90768747
OR,Wasco ,2016,0,25782,12876,12906,49.94181987
OR,Wasco ,2017,0,26296,13135,13161,49.95056282
OR,Wasco ,2018,0,26432,13258,13174,50.15889831
OR,Wasco ,2019,0,26682,13387,13295,50.17240087
OR,Washington ,2015,0,572664,282572,290092,49.34341953
OR,Washington ,2016,0,584910,288892,296018,49.39084646
OR,Washington ,2017,0,591336,292737,298599,49.50434271
OR,Washington ,2018,0,596904,295569,301335,49.51700776
OR,Washington ,2019,0,601592,297962,303630,49.52891661
OR,Wheeler ,2015,0,1326,665,661,50.15082956
OR,Wheeler ,2016,0,1319,667,652,50.56861259
OR,Wheeler ,2017,0,1348,682,666,50.59347181
OR,Wheeler ,2018,0,1351,667,684,49.37083642
OR,Wheeler ,2019,0,1332,647,685,48.57357357
OR,Yamhill ,2015,0,101381,50649,50732,49.95906531
OR,Yamhill ,2016,0,104070,51884,52186,49.85490535
OR,Yamhill ,2017,0,105238,52535,52703,49.92018092
OR,Yamhill ,2018,0,106367,53174,53193,49.99106866
OR,Yamhill ,2019,0,107100,53592,53508,50.03921569
PA,Adams ,2015,0,101808,50253,51555,49.36056106
PA,Adams ,2016,0,101911,50207,51704,49.26553561
PA,Adams ,2017,0,102562,50469,52093,49.20828377
PA,Adams ,2018,0,103062,50708,52354,49.20145155
PA,Adams ,2019,0,103009,50688,52321,49.20735081
PA,Allegheny ,2015,0,1228827,592865,635962,48.24641711
PA,Allegheny ,2016,0,1226426,592642,633784,48.32268722
PA,Allegheny ,2017,0,1220141,589234,630907,48.29228753
PA,Allegheny ,2018,0,1217281,588325,628956,48.33107557
PA,Allegheny ,2019,0,1216045,588435,627610,48.38924546
PA,Armstrong ,2015,0,66860,33181,33679,49.62758002
PA,Armstrong ,2016,0,66397,32989,33408,49.6844737
PA,Armstrong ,2017,0,65991,32802,33189,49.7067782
PA,Armstrong ,2018,0,65352,32531,32821,49.77812462
PA,Armstrong ,2019,0,64735,32228,32507,49.78450606
PA,Beaver ,2015,0,168241,81423,86818,48.39664529
PA,Beaver ,2016,0,166758,80796,85962,48.45104883
PA,Beaver ,2017,0,165654,80328,85326,48.49143395
PA,Beaver ,2018,0,164582,79872,84710,48.53021594
PA,Beaver ,2019,0,163929,79636,84293,48.57956798
PA,Bedford ,2015,0,48748,24310,24438,49.86871256
PA,Bedford ,2016,0,48601,24240,24361,49.87551696
PA,Bedford ,2017,0,48356,24079,24277,49.79526843
PA,Bedford ,2018,0,48094,23919,24175,49.73385453
PA,Bedford ,2019,0,47888,23807,24081,49.7139158
PA,Berks ,2015,0,415138,203983,211155,49.13619086
PA,Berks ,2016,0,415784,204450,211334,49.17216632
PA,Berks ,2017,0,417511,205411,212100,49.19894326
PA,Berks ,2018,0,420529,206857,213672,49.18971105
PA,Berks ,2019,0,421164,207341,213823,49.23046604
PA,Blair ,2015,0,124596,60899,63697,48.87717102
PA,Blair ,2016,0,123708,60437,63271,48.85456074
PA,Blair ,2017,0,123147,60249,62898,48.92445614
PA,Blair ,2018,0,122503,59963,62540,48.94818902
PA,Blair ,2019,0,121829,59681,62148,48.98751529
PA,Bradford ,2015,0,61644,30566,31078,49.58471222
PA,Bradford ,2016,0,61092,30279,30813,49.56295423
PA,Bradford ,2017,0,60963,30211,30752,49.55628824
PA,Bradford ,2018,0,60794,30113,30681,49.53284864
PA,Bradford ,2019,0,60323,29945,30378,49.64109875
PA,Bucks ,2015,0,625276,306783,318493,49.06361351
PA,Bucks ,2016,0,625861,307209,318652,49.08581938
PA,Bucks ,2017,0,626811,307705,319106,49.09055521
PA,Bucks ,2018,0,627812,308272,319540,49.10259759
PA,Bucks ,2019,0,628270,308236,320034,49.06107247
PA,Butler ,2015,0,185936,91822,94114,49.38365889
PA,Butler ,2016,0,186240,92068,94172,49.43513746
PA,Butler ,2017,0,186828,92482,94346,49.50114544
PA,Butler ,2018,0,187638,92941,94697,49.53207772
PA,Butler ,2019,0,187853,93141,94712,49.5818539
PA,Cambria ,2015,0,136028,66778,69250,49.09136354
PA,Cambria ,2016,0,134414,66067,68347,49.15187406
PA,Cambria ,2017,0,132960,65397,67563,49.18546931
PA,Cambria ,2018,0,131449,64624,66825,49.16279317
PA,Cambria ,2019,0,130192,64147,66045,49.27107656
PA,Cameron ,2015,0,4776,2382,2394,49.87437186
PA,Cameron ,2016,0,4710,2364,2346,50.1910828
PA,Cameron ,2017,0,4619,2323,2296,50.29227105
PA,Cameron ,2018,0,4501,2255,2246,50.09997778
PA,Cameron ,2019,0,4447,2223,2224,49.98875647
PA,Carbon ,2015,0,63753,31574,32179,49.52551252
PA,Carbon ,2016,0,63499,31509,31990,49.62125388
PA,Carbon ,2017,0,63828,31700,32128,49.66472395
PA,Carbon ,2018,0,64175,31994,32181,49.85430464
PA,Carbon ,2019,0,64182,31955,32227,49.78810258
PA,Centre ,2015,0,160466,84294,76172,52.53075418
PA,Centre ,2016,0,162034,85106,76928,52.52354444
PA,Centre ,2017,0,162316,85420,76896,52.62574238
PA,Centre ,2018,0,162601,85495,77106,52.57962743
PA,Centre ,2019,0,162385,85395,76990,52.58798534
PA,Chester ,2015,0,515055,253609,261446,49.23920746
PA,Chester ,2016,0,516767,254514,262253,49.25120993
PA,Chester ,2017,0,518901,255544,263357,49.2471589
PA,Chester ,2018,0,522086,257181,264905,49.26027513
PA,Chester ,2019,0,524989,258506,266483,49.2402698
PA,Clarion ,2015,0,38876,18973,19903,48.80388929
PA,Clarion ,2016,0,38590,18866,19724,48.88831303
PA,Clarion ,2017,0,38998,19109,19889,48.99994872
PA,Clarion ,2018,0,38672,18977,19695,49.07167977
PA,Clarion ,2019,0,38438,18857,19581,49.05822363
PA,Clearfield ,2015,0,80718,42219,38499,52.30431874
PA,Clearfield ,2016,0,80196,41934,38262,52.28939099
PA,Clearfield ,2017,0,79799,41856,37943,52.45178511
PA,Clearfield ,2018,0,79572,41891,37681,52.64540291
PA,Clearfield ,2019,0,79255,41790,37465,52.72853448
PA,Clinton ,2015,0,39400,19297,20103,48.97715736
PA,Clinton ,2016,0,39017,19150,19867,49.08116975
PA,Clinton ,2017,0,38830,19074,19756,49.12181303
PA,Clinton ,2018,0,38696,19028,19668,49.17304114
PA,Clinton ,2019,0,38632,18956,19676,49.06813005
PA,Columbia ,2015,0,66681,32181,34500,48.26112386
PA,Columbia ,2016,0,66133,31872,34261,48.1937913
PA,Columbia ,2017,0,65581,31639,33942,48.24415608
PA,Columbia ,2018,0,65215,31435,33780,48.20210074
PA,Columbia ,2019,0,64964,31272,33692,48.13742996
PA,Crawford ,2015,0,86510,42358,44152,48.96312565
PA,Crawford ,2016,0,86306,42166,44140,48.85639469
PA,Crawford ,2017,0,85772,41953,43819,48.91223243
PA,Crawford ,2018,0,85110,41692,43418,48.98601809
PA,Crawford ,2019,0,84629,41443,43186,48.97021116
PA,Cumberland ,2015,0,245744,121520,124224,49.44983397
PA,Cumberland ,2016,0,247369,122245,125124,49.41807583
PA,Cumberland ,2017,0,249024,123142,125882,49.44985222
PA,Cumberland ,2018,0,251131,124303,126828,49.49727433
PA,Cumberland ,2019,0,253370,125463,127907,49.51770139
PA,Dauphin ,2015,0,273085,132367,140718,48.47098889
PA,Dauphin ,2016,0,274196,132943,141253,48.48466061
PA,Dauphin ,2017,0,275714,133726,141988,48.50170829
PA,Dauphin ,2018,0,276864,134250,142614,48.4895111
PA,Dauphin ,2019,0,278299,134905,143394,48.47484181
PA,Delaware ,2015,0,563225,270871,292354,48.09285809
PA,Delaware ,2016,0,563708,271132,292576,48.09795142
PA,Delaware ,2017,0,563858,271273,292585,48.11016249
PA,Delaware ,2018,0,565231,271913,293318,48.10652636
PA,Delaware ,2019,0,566747,272823,293924,48.13841097
PA,Elk ,2015,0,30897,15518,15379,50.22494093
PA,Elk ,2016,0,30512,15297,15215,50.13437336
PA,Elk ,2017,0,30271,15151,15120,50.05120412
PA,Elk ,2018,0,30110,15105,15005,50.16605779
PA,Elk ,2019,0,29910,15026,14884,50.2373788
PA,Erie ,2015,0,278174,137434,140740,49.40576761
PA,Erie ,2016,0,276170,136397,139773,49.38878227
PA,Erie ,2017,0,273558,135021,138537,49.35735749
PA,Erie ,2018,0,271544,134120,137424,49.39162714
PA,Erie ,2019,0,269728,133330,136398,49.43127892
PA,Fayette ,2015,0,133252,65721,67531,49.32083571
PA,Fayette ,2016,0,132350,65373,66977,49.39403098
PA,Fayette ,2017,0,131309,65053,66256,49.5419202
PA,Fayette ,2018,0,130323,64584,65739,49.55687024
PA,Fayette ,2019,0,129274,64171,65103,49.63952535
PA,Forest ,2015,0,7381,4992,2389,67.63311204
PA,Forest ,2016,0,7334,4984,2350,67.95745841
PA,Forest ,2017,0,7317,5016,2301,68.55268553
PA,Forest ,2018,0,7284,4997,2287,68.60241625
PA,Forest ,2019,0,7247,4993,2254,68.89747482
PA,Franklin ,2015,0,153048,75137,77911,49.09374837
PA,Franklin ,2016,0,153705,75508,78197,49.12527244
PA,Franklin ,2017,0,154376,75768,78608,49.0801679
PA,Franklin ,2018,0,154579,75888,78691,49.09334386
PA,Franklin ,2019,0,155027,76241,78786,49.17917524
PA,Fulton ,2015,0,14509,7352,7157,50.67199669
PA,Fulton ,2016,0,14497,7361,7136,50.77602263
PA,Fulton ,2017,0,14469,7354,7115,50.82590366
PA,Fulton ,2018,0,14525,7345,7180,50.56798623
PA,Fulton ,2019,0,14530,7313,7217,50.330351
PA,Greene ,2015,0,37402,19412,17990,51.90096786
PA,Greene ,2016,0,37209,19307,17902,51.88798409
PA,Greene ,2017,0,36846,19076,17770,51.77224122
PA,Greene ,2018,0,36661,19085,17576,52.05804533
PA,Greene ,2019,0,36233,18888,17345,52.12927442
PA,Huntingdon ,2015,0,45499,24099,21400,52.96599925
PA,Huntingdon ,2016,0,45380,24063,21317,53.02556192
PA,Huntingdon ,2017,0,45429,24146,21283,53.1510709
PA,Huntingdon ,2018,0,45395,24219,21176,53.35169071
PA,Huntingdon ,2019,0,45144,24083,21061,53.34706716
PA,Indiana ,2015,0,86747,43405,43342,50.03631249
PA,Indiana ,2016,0,85155,42668,42487,50.10627679
PA,Indiana ,2017,0,84743,42450,42293,50.09263302
PA,Indiana ,2018,0,84441,42283,42158,50.07401618
PA,Indiana ,2019,0,84073,42061,42012,50.02914134
PA,Jefferson ,2015,0,44344,22023,22321,49.66399062
PA,Jefferson ,2016,0,44031,21892,22139,49.7195158
PA,Jefferson ,2017,0,43818,21777,22041,49.69875394
PA,Jefferson ,2018,0,43614,21683,21931,49.71568762
PA,Jefferson ,2019,0,43425,21610,21815,49.76396085
PA,Juniata ,2015,0,24445,12223,12222,50.00204541
PA,Juniata ,2016,0,24559,12300,12259,50.08347245
PA,Juniata ,2017,0,24635,12363,12272,50.18469657
PA,Juniata ,2018,0,24718,12403,12315,50.17800793
PA,Juniata ,2019,0,24763,12443,12320,50.2483544
PA,Lackawanna ,2015,0,211863,102537,109326,48.39778536
PA,Lackawanna ,2016,0,211004,102205,108799,48.43747038
PA,Lackawanna ,2017,0,210451,101986,108465,48.46068681
PA,Lackawanna ,2018,0,210269,102074,108195,48.54448349
PA,Lackawanna ,2019,0,209674,101884,107790,48.59162319
PA,Lancaster ,2015,0,535811,262334,273477,48.96017439
PA,Lancaster ,2016,0,538160,263508,274652,48.96462019
PA,Lancaster ,2017,0,541332,265073,276259,48.9668078
PA,Lancaster ,2018,0,543969,266443,277526,48.98128386
PA,Lancaster ,2019,0,545724,267409,278315,49.00077695
PA,Lawrence ,2015,0,88122,42648,45474,48.39654116
PA,Lawrence ,2016,0,87325,42233,45092,48.36301174
PA,Lawrence ,2017,0,86546,41836,44710,48.3396113
PA,Lawrence ,2018,0,86128,41687,44441,48.40121679
PA,Lawrence ,2019,0,85512,41398,44114,48.4119188
PA,Lebanon ,2015,0,137479,67443,70036,49.05694688
PA,Lebanon ,2016,0,138480,67927,70553,49.05184864
PA,Lebanon ,2017,0,139553,68502,71051,49.08672691
PA,Lebanon ,2018,0,141339,69439,71900,49.12939811
PA,Lebanon ,2019,0,141793,69733,72060,49.17943763
PA,Lehigh ,2015,0,359710,175467,184243,48.78012844
PA,Lehigh ,2016,0,362298,176885,185413,48.8230683
PA,Lehigh ,2017,0,365577,178791,186786,48.90652311
PA,Lehigh ,2018,0,368359,180472,187887,48.99350905
PA,Lehigh ,2019,0,369318,181143,188175,49.04797492
PA,Luzerne ,2015,0,318059,156932,161127,49.34053116
PA,Luzerne ,2016,0,317172,156565,160607,49.3628063
PA,Luzerne ,2017,0,317808,157089,160719,49.42890047
PA,Luzerne ,2018,0,317859,157292,160567,49.48483447
PA,Luzerne ,2019,0,317417,157152,160265,49.50963559
PA,Lycoming ,2015,0,115598,56722,58876,49.06832298
PA,Lycoming ,2016,0,114876,56321,58555,49.0276472
PA,Lycoming ,2017,0,114012,55797,58215,48.93958531
PA,Lycoming ,2018,0,113866,55732,58134,48.94525144
PA,Lycoming ,2019,0,113299,55496,57803,48.98189746
PA,McKean ,2015,0,42400,21854,20546,51.54245283
PA,McKean ,2016,0,41670,21412,20258,51.38468922
PA,McKean ,2017,0,41362,21260,20102,51.3998356
PA,McKean ,2018,0,40950,21002,19948,51.28693529
PA,McKean ,2019,0,40625,20854,19771,51.33292308
PA,Mercer ,2015,0,113624,55960,57664,49.25015842
PA,Mercer ,2016,0,112598,55609,56989,49.38720048
PA,Mercer ,2017,0,111473,55070,56403,49.40209737
PA,Mercer ,2018,0,110471,54611,55860,49.43469327
PA,Mercer ,2019,0,109424,54108,55316,49.44801872
PA,Mifflin ,2015,0,46427,22705,23722,48.90473216
PA,Mifflin ,2016,0,46316,22645,23671,48.8923914
PA,Mifflin ,2017,0,46290,22559,23731,48.73406783
PA,Mifflin ,2018,0,46211,22575,23636,48.85200493
PA,Mifflin ,2019,0,46138,22528,23610,48.82743075
PA,Monroe ,2015,0,166481,82240,84241,49.39903052
PA,Monroe ,2016,0,166220,82205,84015,49.45554085
PA,Monroe ,2017,0,167895,83119,84776,49.50653682
PA,Monroe ,2018,0,169294,83908,85386,49.56348128
PA,Monroe ,2019,0,170271,84490,85781,49.62089845
PA,Montgomery ,2015,0,817180,397016,420164,48.58366578
PA,Montgomery ,2016,0,819791,398448,421343,48.6036075
PA,Montgomery ,2017,0,824303,400784,423519,48.62095613
PA,Montgomery ,2018,0,826924,401787,425137,48.58814111
PA,Montgomery ,2019,0,830915,404000,426915,48.62109843
PA,Montour ,2015,0,18299,8742,9557,47.77310236
PA,Montour ,2016,0,18257,8796,9461,48.17878074
PA,Montour ,2017,0,18270,8819,9451,48.27038862
PA,Montour ,2018,0,18240,8826,9414,48.38815789
PA,Montour ,2019,0,18230,8834,9396,48.45858475
PA,Northampton ,2015,0,300090,147576,152514,49.17724683
PA,Northampton ,2016,0,301307,148360,152947,49.23881622
PA,Northampton ,2017,0,302801,149047,153754,49.22275686
PA,Northampton ,2018,0,304564,149921,154643,49.22479348
PA,Northampton ,2019,0,305285,150230,155055,49.20975482
PA,Northumberland ,2015,0,92878,46663,46215,50.2411766
PA,Northumberland ,2016,0,92283,46355,45928,50.23135355
PA,Northumberland ,2017,0,91721,46116,45605,50.27856216
PA,Northumberland ,2018,0,91080,45783,45297,50.26679842
PA,Northumberland ,2019,0,90843,45662,45181,50.26474247
PA,Perry ,2015,0,45849,23132,22717,50.45257258
PA,Perry ,2016,0,45945,23223,22722,50.54521711
PA,Perry ,2017,0,46046,23309,22737,50.62111801
PA,Perry ,2018,0,46154,23350,22804,50.59149803
PA,Perry ,2019,0,46272,23391,22881,50.55108921
PA,Philadelphia ,2015,0,1571065,743163,827902,47.30313513
PA,Philadelphia ,2016,0,1576051,746065,829986,47.33761788
PA,Philadelphia ,2017,0,1580601,747877,832724,47.3159893
PA,Philadelphia ,2018,0,1583592,749487,834105,47.3282891
PA,Philadelphia ,2019,0,1584064,749539,834525,47.3174695
PA,Pike ,2015,0,55322,27854,27468,50.34886664
PA,Pike ,2016,0,54955,27663,27292,50.3375489
PA,Pike ,2017,0,55397,27937,27460,50.43052873
PA,Pike ,2018,0,55780,28273,27507,50.68662603
PA,Pike ,2019,0,55809,28314,27495,50.73375262
PA,Potter ,2015,0,17086,8548,8538,50.02926372
PA,Potter ,2016,0,16954,8476,8478,49.99410169
PA,Potter ,2017,0,16841,8403,8438,49.89608693
PA,Potter ,2018,0,16623,8291,8332,49.87667689
PA,Potter ,2019,0,16526,8244,8282,49.88502965
PA,Schuylkill ,2015,0,144117,73486,70631,50.99051465
PA,Schuylkill ,2016,0,143497,73308,70189,51.0867823
PA,Schuylkill ,2017,0,142580,72958,69622,51.16986955
PA,Schuylkill ,2018,0,141815,72636,69179,51.21884145
PA,Schuylkill ,2019,0,141359,72432,68927,51.23975127
PA,Snyder ,2015,0,40509,20063,20446,49.52726555
PA,Snyder ,2016,0,40423,20056,20367,49.61531801
PA,Snyder ,2017,0,40594,20129,20465,49.58614574
PA,Snyder ,2018,0,40518,20110,20408,49.6322622
PA,Snyder ,2019,0,40372,20026,20346,49.60368572
PA,Somerset ,2015,0,75383,39243,36140,52.05815635
PA,Somerset ,2016,0,74860,39018,35842,52.12129308
PA,Somerset ,2017,0,74242,38706,35536,52.13491016
PA,Somerset ,2018,0,73872,38602,35270,52.25525233
PA,Somerset ,2019,0,73447,38411,35036,52.29757512
PA,Sullivan ,2015,0,6267,3300,2967,52.65677358
PA,Sullivan ,2016,0,6126,3224,2902,52.62814234
PA,Sullivan ,2017,0,6142,3244,2898,52.81667209
PA,Sullivan ,2018,0,6076,3183,2893,52.38643845
PA,Sullivan ,2019,0,6066,3170,2896,52.25848994
PA,Susquehanna ,2015,0,41775,21014,20761,50.30281269
PA,Susquehanna ,2016,0,41252,20768,20484,50.34422573
PA,Susquehanna ,2017,0,40934,20632,20302,50.4030879
PA,Susquehanna ,2018,0,40560,20446,20114,50.40927022
PA,Susquehanna ,2019,0,40328,20245,20083,50.20085301
PA,Tioga ,2015,0,41519,20610,20909,49.63992389
PA,Tioga ,2016,0,41250,20504,20746,49.70666667
PA,Tioga ,2017,0,40671,20209,20462,49.68896757
PA,Tioga ,2018,0,40690,20200,20490,49.64364709
PA,Tioga ,2019,0,40591,20147,20444,49.63415535
PA,Union ,2015,0,45519,25145,20374,55.24066873
PA,Union ,2016,0,45454,25004,20450,55.00946011
PA,Union ,2017,0,44642,24228,20414,54.27176202
PA,Union ,2018,0,45017,24598,20419,54.64157985
PA,Union ,2019,0,44923,24536,20387,54.61790174
PA,Venango ,2015,0,52954,26068,26886,49.22763153
PA,Venango ,2016,0,52477,25868,26609,49.29397641
PA,Venango ,2017,0,51790,25571,26219,49.3743966
PA,Venango ,2018,0,51201,25306,25895,49.42481592
PA,Venango ,2019,0,50668,25079,25589,49.49672377
PA,Warren ,2015,0,40334,20221,20113,50.13388208
PA,Warren ,2016,0,40026,20060,19966,50.11742367
PA,Warren ,2017,0,39679,19901,19778,50.15499383
PA,Warren ,2018,0,39551,19837,19714,50.15549544
PA,Warren ,2019,0,39191,19617,19574,50.05485953
PA,Washington ,2015,0,207718,101885,105833,49.04967311
PA,Washington ,2016,0,207386,101780,105606,49.07756551
PA,Washington ,2017,0,207075,101716,105359,49.12036702
PA,Washington ,2018,0,207018,101763,105255,49.15659508
PA,Washington ,2019,0,206865,101770,105095,49.19633577
PA,Wayne ,2015,0,51823,27468,24355,53.00349266
PA,Wayne ,2016,0,51339,27153,24186,52.88961608
PA,Wayne ,2017,0,51192,27054,24138,52.84810127
PA,Wayne ,2018,0,51395,27276,24119,53.07131044
PA,Wayne ,2019,0,51361,27280,24081,53.11423064
PA,Westmoreland ,2015,0,356923,174165,182758,48.79623896
PA,Westmoreland ,2016,0,354665,173235,181430,48.84468442
PA,Westmoreland ,2017,0,352006,172009,179997,48.86536025
PA,Westmoreland ,2018,0,350459,171462,178997,48.92498124
PA,Westmoreland ,2019,0,348899,170779,178120,48.94797635
PA,Wyoming ,2015,0,27812,13979,13833,50.26247663
PA,Wyoming ,2016,0,27546,13839,13707,50.23959922
PA,Wyoming ,2017,0,27396,13777,13619,50.28836326
PA,Wyoming ,2018,0,27087,13609,13478,50.24181342
PA,Wyoming ,2019,0,26794,13449,13345,50.1940733
PA,York ,2015,0,441741,218343,223398,49.42783215
PA,York ,2016,0,443693,219255,224438,49.41592498
PA,York ,2017,0,445484,220149,225335,49.41793645
PA,York ,2018,0,447847,221309,226538,49.41620687
PA,York ,2019,0,449058,221979,227079,49.43214462
RI,Bristol ,2015,0,49127,23676,25451,48.19345777
RI,Bristol ,2016,0,48844,23570,25274,48.25567112
RI,Bristol ,2017,0,48734,23543,25191,48.30918866
RI,Bristol ,2018,0,48637,23518,25119,48.35413368
RI,Bristol ,2019,0,48479,23428,25051,48.32607933
RI,Kent ,2015,0,163747,79153,84594,48.33859552
RI,Kent ,2016,0,163711,79099,84612,48.3162402
RI,Kent ,2017,0,163543,79060,84483,48.34202626
RI,Kent ,2018,0,164053,79358,84695,48.37339153
RI,Kent ,2019,0,164292,79538,84754,48.41258248
RI,Newport ,2015,0,83259,41055,42204,49.30998451
RI,Newport ,2016,0,83164,41108,42056,49.43004185
RI,Newport ,2017,0,82952,41056,41896,49.49368309
RI,Newport ,2018,0,82547,40748,41799,49.36339298
RI,Newport ,2019,0,82082,40525,41557,49.37136035
RI,Providence ,2015,0,633747,308000,325747,48.59983558
RI,Providence ,2016,0,634922,308858,326064,48.64503041
RI,Providence ,2017,0,634130,308406,325724,48.63450712
RI,Providence ,2018,0,636953,310150,326803,48.69276069
RI,Providence ,2019,0,638931,311386,327545,48.73546596
RI,Washington ,2015,0,126185,60994,65191,48.33696557
RI,Washington ,2016,0,126129,61048,65081,48.40124
RI,Washington ,2017,0,126314,61166,65148,48.42376934
RI,Washington ,2018,0,126097,61086,65011,48.44365845
RI,Washington ,2019,0,125577,60798,64779,48.41491674
SC,Abbeville ,2015,0,24796,12033,12763,48.52798839
SC,Abbeville ,2016,0,24657,11938,12719,48.41627124
SC,Abbeville ,2017,0,24567,11902,12665,48.44710384
SC,Abbeville ,2018,0,24587,11899,12688,48.39549355
SC,Abbeville ,2019,0,24527,11871,12656,48.39972275
SC,Aiken ,2015,0,165688,80211,85477,48.41086862
SC,Aiken ,2016,0,167172,80790,86382,48.32747111
SC,Aiken ,2017,0,168325,81324,87001,48.31367889
SC,Aiken ,2018,0,169449,81812,87637,48.28119375
SC,Aiken ,2019,0,170872,82478,88394,48.26887963
SC,Allendale ,2015,0,9430,5055,4375,53.60551432
SC,Allendale ,2016,0,9067,4783,4284,52.75173707
SC,Allendale ,2017,0,9012,4745,4267,52.65201953
SC,Allendale ,2018,0,8924,4673,4251,52.36441058
SC,Allendale ,2019,0,8688,4518,4170,52.00276243
SC,Anderson ,2015,0,193700,93323,100377,48.179143
SC,Anderson ,2016,0,195582,94291,101291,48.21046927
SC,Anderson ,2017,0,198186,95497,102689,48.18554287
SC,Anderson ,2018,0,200292,96416,103876,48.13771893
SC,Anderson ,2019,0,202558,97404,105154,48.08696768
SC,Bamberg ,2015,0,14682,7045,7637,47.9839259
SC,Bamberg ,2016,0,14478,6930,7548,47.86572731
SC,Bamberg ,2017,0,14384,6870,7514,47.76140156
SC,Bamberg ,2018,0,14272,6858,7414,48.05213004
SC,Bamberg ,2019,0,14066,6735,7331,47.88141618
SC,Barnwell ,2015,0,21781,10404,11377,47.76640191
SC,Barnwell ,2016,0,21606,10337,11269,47.84319171
SC,Barnwell ,2017,0,21355,10208,11147,47.80145165
SC,Barnwell ,2018,0,21121,10067,11054,47.6634629
SC,Barnwell ,2019,0,20866,9989,10877,47.87213649
SC,Beaufort ,2015,0,179796,88685,91111,49.3253465
SC,Beaufort ,2016,0,183184,90230,92954,49.25648528
SC,Beaufort ,2017,0,186497,91678,94819,49.1578953
SC,Beaufort ,2018,0,188876,92602,96274,49.02793367
SC,Beaufort ,2019,0,192122,94063,98059,48.96003581
SC,Berkeley ,2015,0,203066,101161,101905,49.81680833
SC,Berkeley ,2016,0,208525,103825,104700,49.79019302
SC,Berkeley ,2017,0,214541,106735,107806,49.75039736
SC,Berkeley ,2018,0,221182,109919,111263,49.69617781
SC,Berkeley ,2019,0,227907,113007,114900,49.58469902
SC,Calhoun ,2015,0,14759,7128,7631,48.29595501
SC,Calhoun ,2016,0,14744,7122,7622,48.30439501
SC,Calhoun ,2017,0,14696,7089,7607,48.23761568
SC,Calhoun ,2018,0,14563,6998,7565,48.05328572
SC,Calhoun ,2019,0,14553,6985,7568,47.99697657
SC,Charleston ,2015,0,389310,188482,200828,48.41437415
SC,Charleston ,2016,0,396880,192226,204654,48.43428744
SC,Charleston ,2017,0,402008,194847,207161,48.46843844
SC,Charleston ,2018,0,406222,196513,209709,48.37576498
SC,Charleston ,2019,0,411406,198854,212552,48.33522117
SC,Cherokee ,2015,0,56512,27503,29009,48.66753964
SC,Cherokee ,2016,0,56683,27615,29068,48.7183106
SC,Cherokee ,2017,0,56913,27674,29239,48.62509444
SC,Cherokee ,2018,0,57069,27780,29289,48.67791621
SC,Cherokee ,2019,0,57300,27854,29446,48.61082024
SC,Chester ,2015,0,32410,15646,16764,48.2752237
SC,Chester ,2016,0,32297,15621,16676,48.36672137
SC,Chester ,2017,0,32299,15633,16666,48.40087928
SC,Chester ,2018,0,32304,15544,16760,48.11788014
SC,Chester ,2019,0,32244,15525,16719,48.14849274
SC,Chesterfield ,2015,0,46135,22491,23644,48.75040642
SC,Chesterfield ,2016,0,46120,22442,23678,48.66001735
SC,Chesterfield ,2017,0,45979,22362,23617,48.63524653
SC,Chesterfield ,2018,0,45881,22315,23566,48.63669057
SC,Chesterfield ,2019,0,45650,22192,23458,48.61336254
SC,Clarendon ,2015,0,34029,16702,17327,49.08166564
SC,Clarendon ,2016,0,34259,16842,17417,49.16080446
SC,Clarendon ,2017,0,34012,16692,17320,49.07679642
SC,Clarendon ,2018,0,33742,16535,17207,49.0042084
SC,Clarendon ,2019,0,33745,16525,17220,48.97021781
SC,Colleton ,2015,0,37439,18017,19422,48.12361441
SC,Colleton ,2016,0,37579,18107,19472,48.18382607
SC,Colleton ,2017,0,37555,18072,19483,48.12142191
SC,Colleton ,2018,0,37676,18171,19505,48.22964221
SC,Colleton ,2019,0,37677,18081,19596,47.98948961
SC,Darlington ,2015,0,67520,31960,35560,47.33412322
SC,Darlington ,2016,0,67259,31824,35435,47.31560089
SC,Darlington ,2017,0,66981,31630,35351,47.22234664
SC,Darlington ,2018,0,66759,31530,35229,47.22958702
SC,Darlington ,2019,0,66618,31351,35267,47.06085442
SC,Dillon ,2015,0,31141,14720,16421,47.26887383
SC,Dillon ,2016,0,30719,14561,16158,47.40063153
SC,Dillon ,2017,0,30496,14447,16049,47.37342602
SC,Dillon ,2018,0,30612,14526,16086,47.45197962
SC,Dillon ,2019,0,30479,14428,16051,47.33751107
SC,Dorchester ,2015,0,152809,74488,78321,48.74581995
SC,Dorchester ,2016,0,156173,75955,80218,48.63516741
SC,Dorchester ,2017,0,158988,77253,81735,48.59045966
SC,Dorchester ,2018,0,160718,78126,82592,48.61060989
SC,Dorchester ,2019,0,162809,79153,83656,48.61709119
SC,Edgefield ,2015,0,26782,14461,12321,53.99522067
SC,Edgefield ,2016,0,26626,14344,12282,53.87215504
SC,Edgefield ,2017,0,26837,14424,12413,53.746693
SC,Edgefield ,2018,0,27132,14557,12575,53.65251364
SC,Edgefield ,2019,0,27260,14612,12648,53.60234776
SC,Fairfield ,2015,0,22874,10915,11959,47.71793302
SC,Fairfield ,2016,0,22633,10805,11828,47.74002563
SC,Fairfield ,2017,0,22593,10777,11816,47.70061523
SC,Fairfield ,2018,0,22376,10699,11677,47.81462281
SC,Fairfield ,2019,0,22347,10690,11657,47.83639862
SC,Florence ,2015,0,138715,64821,73894,46.72962549
SC,Florence ,2016,0,138595,64690,73905,46.6755655
SC,Florence ,2017,0,138495,64643,73852,46.67533124
SC,Florence ,2018,0,138277,64575,73702,46.69974038
SC,Florence ,2019,0,138293,64580,73713,46.6979529
SC,Georgetown ,2015,0,61456,29156,32300,47.44207238
SC,Georgetown ,2016,0,61565,29217,32348,47.4571591
SC,Georgetown ,2017,0,61826,29318,32508,47.42017921
SC,Georgetown ,2018,0,62232,29463,32769,47.34381026
SC,Georgetown ,2019,0,62680,29670,33010,47.33567326
SC,Greenville ,2015,0,490900,238262,252638,48.53575066
SC,Greenville ,2016,0,499122,242327,256795,48.55065495
SC,Greenville ,2017,0,506831,245971,260860,48.53116719
SC,Greenville ,2018,0,514621,249697,264924,48.52056173
SC,Greenville ,2019,0,523542,253869,269673,48.49066551
SC,Greenwood ,2015,0,69962,32683,37279,46.71535977
SC,Greenwood ,2016,0,70188,32688,37500,46.5720636
SC,Greenwood ,2017,0,70496,32833,37663,46.57427372
SC,Greenwood ,2018,0,70597,32883,37714,46.57846651
SC,Greenwood ,2019,0,70811,33006,37805,46.61140218
SC,Hampton ,2015,0,19963,10240,9723,51.29489556
SC,Hampton ,2016,0,19789,10116,9673,51.11930871
SC,Hampton ,2017,0,19498,9963,9535,51.09754847
SC,Hampton ,2018,0,19348,9893,9455,51.13189994
SC,Hampton ,2019,0,19222,9828,9394,51.12891479
SC,Horry ,2015,0,308987,149272,159715,48.31012308
SC,Horry ,2016,0,321033,154949,166084,48.26575461
SC,Horry ,2017,0,332655,160510,172145,48.25119117
SC,Horry ,2018,0,344105,165747,178358,48.16756513
SC,Horry ,2019,0,354081,170217,183864,48.07289857
SC,Jasper ,2015,0,27460,13981,13479,50.91405681
SC,Jasper ,2016,0,28085,14263,13822,50.78511661
SC,Jasper ,2017,0,28522,14464,14058,50.7117313
SC,Jasper ,2018,0,29147,14727,14420,50.52664082
SC,Jasper ,2019,0,30073,15138,14935,50.33751205
SC,Kershaw ,2015,0,63661,30861,32800,48.47708958
SC,Kershaw ,2016,0,64333,31128,33205,48.38574293
SC,Kershaw ,2017,0,65213,31568,33645,48.40752611
SC,Kershaw ,2018,0,65802,31737,34065,48.23105681
SC,Kershaw ,2019,0,66551,32061,34490,48.17508377
SC,Lancaster ,2015,0,86261,42009,44252,48.69987596
SC,Lancaster ,2016,0,89823,43646,46177,48.59111809
SC,Lancaster ,2017,0,92411,44856,47555,48.53967601
SC,Lancaster ,2018,0,95035,46143,48892,48.55369075
SC,Lancaster ,2019,0,98012,47643,50369,48.60935396
SC,Laurens ,2015,0,66421,32176,34245,48.44251065
SC,Laurens ,2016,0,66603,32177,34426,48.31163761
SC,Laurens ,2017,0,66822,32352,34470,48.4151926
SC,Laurens ,2018,0,66890,32316,34574,48.31215428
SC,Laurens ,2019,0,67493,32588,34905,48.2835257
SC,Lee ,2015,0,17809,9184,8625,51.56943119
SC,Lee ,2016,0,17506,8928,8578,50.99965726
SC,Lee ,2017,0,17388,8826,8562,50.75914424
SC,Lee ,2018,0,17294,8874,8420,51.31259396
SC,Lee ,2019,0,16828,8506,8322,50.54670787
SC,Lexington ,2015,0,281675,137369,144306,48.76861631
SC,Lexington ,2016,0,286277,139556,146721,48.74858965
SC,Lexington ,2017,0,290338,141438,148900,48.71494603
SC,Lexington ,2018,0,294350,143328,151022,48.69305249
SC,Lexington ,2019,0,298750,145338,153412,48.64870293
SC,McCormick ,2015,0,9656,5249,4407,54.35998343
SC,McCormick ,2016,0,9572,5199,4373,54.31466778
SC,McCormick ,2017,0,9554,5183,4371,54.24952899
SC,McCormick ,2018,0,9408,5058,4350,53.7627551
SC,McCormick ,2019,0,9463,5097,4366,53.8624115
SC,Marion ,2015,0,31770,14587,17183,45.91438464
SC,Marion ,2016,0,31760,14628,17132,46.05793451
SC,Marion ,2017,0,31295,14344,16951,45.83479789
SC,Marion ,2018,0,31056,14228,16828,45.8140134
SC,Marion ,2019,0,30657,14048,16609,45.8231399
SC,Marlboro ,2015,0,27585,14596,12989,52.91281494
SC,Marlboro ,2016,0,26979,14135,12844,52.39260165
SC,Marlboro ,2017,0,26691,13953,12738,52.27604811
SC,Marlboro ,2018,0,26392,13760,12632,52.13701122
SC,Marlboro ,2019,0,26118,13633,12485,52.19771805
SC,Newberry ,2015,0,37772,18468,19304,48.89336016
SC,Newberry ,2016,0,37934,18517,19417,48.81372911
SC,Newberry ,2017,0,38381,18725,19656,48.78716031
SC,Newberry ,2018,0,38443,18771,19672,48.82813516
SC,Newberry ,2019,0,38440,18775,19665,48.84235172
SC,Oconee ,2015,0,75863,37402,38461,49.30203129
SC,Oconee ,2016,0,76535,37662,38873,49.20885869
SC,Oconee ,2017,0,77388,38090,39298,49.21951724
SC,Oconee ,2018,0,78307,38516,39791,49.18589654
SC,Oconee ,2019,0,79546,39109,40437,49.16526287
SC,Orangeburg ,2015,0,89159,41795,47364,46.87692774
SC,Orangeburg ,2016,0,88419,41496,46923,46.93108947
SC,Orangeburg ,2017,0,87671,41043,46628,46.81479623
SC,Orangeburg ,2018,0,87013,40627,46386,46.69072437
SC,Orangeburg ,2019,0,86175,40207,45968,46.65738323
SC,Pickens ,2015,0,121500,60580,60920,49.8600823
SC,Pickens ,2016,0,123020,61352,61668,49.8715656
SC,Pickens ,2017,0,123518,61626,61892,49.89232339
SC,Pickens ,2018,0,125225,62379,62846,49.81353564
SC,Pickens ,2019,0,126884,63232,63652,49.8344945
SC,Richland ,2015,0,406008,197018,208990,48.52564481
SC,Richland ,2016,0,409014,198506,210508,48.53281306
SC,Richland ,2017,0,411800,199306,212494,48.39873725
SC,Richland ,2018,0,414202,200114,214088,48.3131419
SC,Richland ,2019,0,415759,200481,215278,48.2204835
SC,Saluda ,2015,0,20159,10175,9984,50.47373382
SC,Saluda ,2016,0,20187,10218,9969,50.61673354
SC,Saluda ,2017,0,20299,10219,10080,50.3423814
SC,Saluda ,2018,0,20397,10257,10140,50.28680688
SC,Saluda ,2019,0,20473,10294,10179,50.28085772
SC,Spartanburg ,2015,0,296558,143762,152796,48.47685782
SC,Spartanburg ,2016,0,300867,145984,154883,48.52110733
SC,Spartanburg ,2017,0,306740,149033,157707,48.58609898
SC,Spartanburg ,2018,0,314137,152436,161701,48.52532494
SC,Spartanburg ,2019,0,319785,155259,164526,48.55105774
SC,Sumter ,2015,0,107151,51778,55373,48.32246083
SC,Sumter ,2016,0,107075,51745,55330,48.32593976
SC,Sumter ,2017,0,106431,51311,55120,48.21057775
SC,Sumter ,2018,0,106409,51176,55233,48.09367629
SC,Sumter ,2019,0,106721,51344,55377,48.11049372
SC,Union ,2015,0,27743,13205,14538,47.59759219
SC,Union ,2016,0,27666,13169,14497,47.59994217
SC,Union ,2017,0,27400,13031,14369,47.55839416
SC,Union ,2018,0,27324,12946,14378,47.37959303
SC,Union ,2019,0,27316,12933,14383,47.34587787
SC,Williamsburg ,2015,0,32519,15803,16716,48.5962053
SC,Williamsburg ,2016,0,31912,15329,16583,48.03522186
SC,Williamsburg ,2017,0,31216,14923,16293,47.80561251
SC,Williamsburg ,2018,0,30606,14483,16123,47.32078677
SC,Williamsburg ,2019,0,30368,14419,15949,47.48090095
SC,York ,2015,0,250566,120939,129627,48.26632504
SC,York ,2016,0,257866,124431,133435,48.25413199
SC,York ,2017,0,266165,128414,137751,48.24601281
SC,York ,2018,0,273782,132091,141691,48.24678029
SC,York ,2019,0,280979,135549,145430,48.24168354
SD,Aurora ,2015,0,2744,1419,1325,51.71282799
SD,Aurora ,2016,0,2764,1436,1328,51.9536903
SD,Aurora ,2017,0,2769,1457,1312,52.61827375
SD,Aurora ,2018,0,2785,1469,1316,52.74685817
SD,Aurora ,2019,0,2751,1456,1295,52.92620865
SD,Beadle ,2015,0,18127,9159,8968,50.52683842
SD,Beadle ,2016,0,18188,9167,9021,50.40136354
SD,Beadle ,2017,0,18541,9401,9140,50.70384553
SD,Beadle ,2018,0,18423,9323,9100,50.60522173
SD,Beadle ,2019,0,18453,9346,9107,50.64759118
SD,Bennett ,2015,0,3402,1626,1776,47.79541446
SD,Bennett ,2016,0,3441,1674,1767,48.64864865
SD,Bennett ,2017,0,3446,1683,1763,48.83923389
SD,Bennett ,2018,0,3473,1702,1771,49.00662252
SD,Bennett ,2019,0,3365,1658,1707,49.27191679
SD,Bon Homme ,2015,0,6943,4074,2869,58.67780498
SD,Bon Homme ,2016,0,6940,4090,2850,58.93371758
SD,Bon Homme ,2017,0,6952,4111,2841,59.13406214
SD,Bon Homme ,2018,0,6910,4071,2839,58.9146165
SD,Bon Homme ,2019,0,6901,4087,2814,59.22330097
SD,Brookings ,2015,0,33800,17294,16506,51.16568047
SD,Brookings ,2016,0,34301,17639,16662,51.42415673
SD,Brookings ,2017,0,34749,17919,16830,51.56695157
SD,Brookings ,2018,0,35077,18065,17012,51.50098355
SD,Brookings ,2019,0,35077,18032,17045,51.40690481
SD,Brown ,2015,0,38400,18906,19494,49.234375
SD,Brown ,2016,0,38900,19132,19768,49.18251928
SD,Brown ,2017,0,39290,19358,19932,49.26953423
SD,Brown ,2018,0,39145,19256,19889,49.19146762
SD,Brown ,2019,0,38839,19161,19678,49.33443189
SD,Brule ,2015,0,5243,2589,2654,49.38012588
SD,Brule ,2016,0,5216,2586,2630,49.57822086
SD,Brule ,2017,0,5304,2635,2669,49.67948718
SD,Brule ,2018,0,5230,2617,2613,50.03824092
SD,Brule ,2019,0,5297,2643,2654,49.89616764
SD,Buffalo ,2015,0,2098,1046,1052,49.85700667
SD,Buffalo ,2016,0,2030,1003,1027,49.408867
SD,Buffalo ,2017,0,2013,991,1022,49.23000497
SD,Buffalo ,2018,0,2027,1001,1026,49.38332511
SD,Buffalo ,2019,0,1962,969,993,49.3883792
SD,Butte ,2015,0,10207,5157,5050,50.52415009
SD,Butte ,2016,0,10124,5087,5037,50.24693797
SD,Butte ,2017,0,10114,5099,5015,50.41526597
SD,Butte ,2018,0,10253,5199,5054,50.70711011
SD,Butte ,2019,0,10429,5320,5109,51.01160226
SD,Campbell ,2015,0,1413,727,686,51.45081387
SD,Campbell ,2016,0,1386,706,680,50.93795094
SD,Campbell ,2017,0,1372,705,667,51.38483965
SD,Campbell ,2018,0,1366,704,662,51.53733529
SD,Campbell ,2019,0,1376,711,665,51.67151163
SD,Charles Mix ,2015,0,9360,4659,4701,49.77564103
SD,Charles Mix ,2016,0,9358,4647,4711,49.65804659
SD,Charles Mix ,2017,0,9404,4698,4706,49.95746491
SD,Charles Mix ,2018,0,9331,4680,4651,50.15539599
SD,Charles Mix ,2019,0,9292,4680,4612,50.36590616
SD,Clark ,2015,0,3649,1823,1826,49.95889285
SD,Clark ,2016,0,3637,1836,1801,50.4811658
SD,Clark ,2017,0,3679,1854,1825,50.39412884
SD,Clark ,2018,0,3726,1908,1818,51.20772947
SD,Clark ,2019,0,3736,1915,1821,51.25802998
SD,Clay ,2015,0,13768,6838,6930,49.66589192
SD,Clay ,2016,0,13933,6929,7004,49.73085481
SD,Clay ,2017,0,14032,7007,7025,49.93586089
SD,Clay ,2018,0,13983,6992,6991,50.00357577
SD,Clay ,2019,0,14070,7019,7051,49.88628287
SD,Codington ,2015,0,27899,13996,13903,50.16667264
SD,Codington ,2016,0,28062,14099,13963,50.24232058
SD,Codington ,2017,0,28125,14131,13994,50.24355556
SD,Codington ,2018,0,28033,14061,13972,50.15874148
SD,Codington ,2019,0,28009,14061,13948,50.20172088
SD,Corson ,2015,0,4175,2080,2095,49.82035928
SD,Corson ,2016,0,4118,2059,2059,50
SD,Corson ,2017,0,4195,2104,2091,50.15494636
SD,Corson ,2018,0,4178,2093,2085,50.09573959
SD,Corson ,2019,0,4086,2031,2055,49.70631424
SD,Custer ,2015,0,8444,4201,4243,49.7513027
SD,Custer ,2016,0,8606,4292,4314,49.8721822
SD,Custer ,2017,0,8763,4378,4385,49.96005934
SD,Custer ,2018,0,8812,4373,4439,49.62551067
SD,Custer ,2019,0,8972,4445,4527,49.54302274
SD,Davison ,2015,0,19916,9966,9950,50.04016871
SD,Davison ,2016,0,20011,9979,10032,49.86757283
SD,Davison ,2017,0,19870,9916,9954,49.90437846
SD,Davison ,2018,0,19784,9891,9893,49.99494541
SD,Davison ,2019,0,19775,9886,9889,49.99241466
SD,Day ,2015,0,5496,2797,2699,50.8915575
SD,Day ,2016,0,5509,2798,2711,50.78961699
SD,Day ,2017,0,5494,2790,2704,50.78267201
SD,Day ,2018,0,5507,2793,2714,50.71726893
SD,Day ,2019,0,5424,2755,2669,50.79277286
SD,Deuel ,2015,0,4323,2230,2093,51.58454777
SD,Deuel ,2016,0,4253,2212,2041,52.01034564
SD,Deuel ,2017,0,4311,2256,2055,52.33124565
SD,Deuel ,2018,0,4352,2264,2088,52.02205882
SD,Deuel ,2019,0,4351,2262,2089,51.98804872
SD,Dewey ,2015,0,5705,2813,2892,49.30762489
SD,Dewey ,2016,0,5785,2864,2921,49.50734659
SD,Dewey ,2017,0,5857,2892,2965,49.37681407
SD,Dewey ,2018,0,5925,2939,2986,49.60337553
SD,Dewey ,2019,0,5892,2916,2976,49.49083503
SD,Douglas ,2015,0,2952,1460,1492,49.45799458
SD,Douglas ,2016,0,2919,1444,1475,49.46899623
SD,Douglas ,2017,0,2927,1453,1474,49.64127093
SD,Douglas ,2018,0,2926,1450,1476,49.55570745
SD,Douglas ,2019,0,2921,1458,1463,49.91441287
SD,Edmunds ,2015,0,3996,2010,1986,50.3003003
SD,Edmunds ,2016,0,3939,1980,1959,50.26656512
SD,Edmunds ,2017,0,3915,1985,1930,50.70242656
SD,Edmunds ,2018,0,3866,1946,1920,50.33626487
SD,Edmunds ,2019,0,3829,1915,1914,50.01305824
SD,Fall River ,2015,0,6800,3423,3377,50.33823529
SD,Fall River ,2016,0,6785,3425,3360,50.47899779
SD,Fall River ,2017,0,6698,3372,3326,50.34338609
SD,Fall River ,2018,0,6740,3407,3333,50.54896142
SD,Fall River ,2019,0,6713,3393,3320,50.54372114
SD,Faulk ,2015,0,2307,1138,1169,49.32813177
SD,Faulk ,2016,0,2317,1152,1165,49.71946483
SD,Faulk ,2017,0,2323,1155,1168,49.72018941
SD,Faulk ,2018,0,2315,1148,1167,49.58963283
SD,Faulk ,2019,0,2299,1151,1148,50.06524576
SD,Grant ,2015,0,7218,3730,3488,51.67636464
SD,Grant ,2016,0,7212,3761,3451,52.14919578
SD,Grant ,2017,0,7159,3726,3433,52.04637519
SD,Grant ,2018,0,7103,3719,3384,52.35815852
SD,Grant ,2019,0,7052,3692,3360,52.35394214
SD,Gregory ,2015,0,4192,2163,2029,51.59828244
SD,Gregory ,2016,0,4158,2141,2017,51.49110149
SD,Gregory ,2017,0,4206,2157,2049,51.28388017
SD,Gregory ,2018,0,4189,2156,2033,51.46813082
SD,Gregory ,2019,0,4185,2154,2031,51.46953405
SD,Haakon ,2015,0,1850,936,914,50.59459459
SD,Haakon ,2016,0,1885,946,939,50.18567639
SD,Haakon ,2017,0,1921,968,953,50.39042166
SD,Haakon ,2018,0,1902,952,950,50.05257624
SD,Haakon ,2019,0,1899,943,956,49.65771459
SD,Hamlin ,2015,0,5976,3042,2934,50.90361446
SD,Hamlin ,2016,0,5917,3027,2890,51.15768126
SD,Hamlin ,2017,0,5998,3069,2929,51.16705569
SD,Hamlin ,2018,0,6070,3111,2959,51.25205931
SD,Hamlin ,2019,0,6164,3158,3006,51.23296561
SD,Hand ,2015,0,3306,1648,1658,49.84875983
SD,Hand ,2016,0,3275,1643,1632,50.16793893
SD,Hand ,2017,0,3275,1634,1641,49.89312977
SD,Hand ,2018,0,3240,1614,1626,49.81481481
SD,Hand ,2019,0,3191,1589,1602,49.7963021
SD,Hanson ,2015,0,3387,1706,1681,50.36905816
SD,Hanson ,2016,0,3383,1695,1688,50.10345847
SD,Hanson ,2017,0,3409,1702,1707,49.92666471
SD,Hanson ,2018,0,3364,1681,1683,49.97027348
SD,Hanson ,2019,0,3453,1733,1720,50.18824211
SD,Harding ,2015,0,1270,662,608,52.12598425
SD,Harding ,2016,0,1267,674,593,53.19652723
SD,Harding ,2017,0,1244,655,589,52.65273312
SD,Harding ,2018,0,1252,663,589,52.95527157
SD,Harding ,2019,0,1298,688,610,53.0046225
SD,Hughes ,2015,0,17555,8666,8889,49.36485332
SD,Hughes ,2016,0,17604,8712,8892,49.48875256
SD,Hughes ,2017,0,17670,8717,8953,49.33220147
SD,Hughes ,2018,0,17683,8688,8995,49.13193463
SD,Hughes ,2019,0,17526,8642,8884,49.30959717
SD,Hutchinson ,2015,0,7267,3578,3689,49.23627357
SD,Hutchinson ,2016,0,7327,3596,3731,49.07874983
SD,Hutchinson ,2017,0,7349,3608,3741,49.09511498
SD,Hutchinson ,2018,0,7306,3587,3719,49.0966329
SD,Hutchinson ,2019,0,7291,3591,3700,49.25250309
SD,Hyde ,2015,0,1386,715,671,51.58730159
SD,Hyde ,2016,0,1333,681,652,51.08777194
SD,Hyde ,2017,0,1297,661,636,50.96376253
SD,Hyde ,2018,0,1271,656,615,51.61290323
SD,Hyde ,2019,0,1301,675,626,51.88316679
SD,Jackson ,2015,0,3278,1646,1632,50.21354484
SD,Jackson ,2016,0,3280,1645,1635,50.15243902
SD,Jackson ,2017,0,3269,1641,1628,50.19883757
SD,Jackson ,2018,0,3278,1637,1641,49.93898719
SD,Jackson ,2019,0,3344,1675,1669,50.08971292
SD,Jerauld ,2015,0,2018,994,1024,49.25668979
SD,Jerauld ,2016,0,2008,1002,1006,49.90039841
SD,Jerauld ,2017,0,2024,1007,1017,49.75296443
SD,Jerauld ,2018,0,2026,1017,1009,50.19743337
SD,Jerauld ,2019,0,2013,1007,1006,50.02483855
SD,Jones ,2015,0,917,455,462,49.61832061
SD,Jones ,2016,0,931,461,470,49.51664876
SD,Jones ,2017,0,922,458,464,49.67462039
SD,Jones ,2018,0,928,462,466,49.78448276
SD,Jones ,2019,0,903,458,445,50.71982281
SD,Kingsbury ,2015,0,4952,2499,2453,50.4644588
SD,Kingsbury ,2016,0,4973,2536,2437,50.99537503
SD,Kingsbury ,2017,0,4929,2494,2435,50.59849868
SD,Kingsbury ,2018,0,4926,2517,2409,51.09622412
SD,Kingsbury ,2019,0,4939,2531,2408,51.24519133
SD,Lake ,2015,0,12334,6396,5938,51.8566564
SD,Lake ,2016,0,12605,6558,6047,52.02697342
SD,Lake ,2017,0,12795,6667,6128,52.10629152
SD,Lake ,2018,0,13055,6804,6251,52.11796247
SD,Lake ,2019,0,12797,6666,6131,52.09033367
SD,Lawrence ,2015,0,24827,12384,12443,49.88117775
SD,Lawrence ,2016,0,25317,12660,12657,50.00592487
SD,Lawrence ,2017,0,25677,12858,12819,50.07594345
SD,Lawrence ,2018,0,25727,12842,12885,49.91643021
SD,Lawrence ,2019,0,25844,12951,12893,50.11221173
SD,Lincoln ,2015,0,52959,26317,26642,49.69315886
SD,Lincoln ,2016,0,54567,27140,27427,49.73702054
SD,Lincoln ,2017,0,56681,28217,28464,49.78211394
SD,Lincoln ,2018,0,58795,29139,29656,49.56033676
SD,Lincoln ,2019,0,61128,30281,30847,49.53703704
SD,Lyman ,2015,0,3881,2019,1862,52.02267457
SD,Lyman ,2016,0,3900,2026,1874,51.94871795
SD,Lyman ,2017,0,3876,2027,1849,52.29618163
SD,Lyman ,2018,0,3804,1991,1813,52.33964248
SD,Lyman ,2019,0,3781,1959,1822,51.81169003
SD,McCook ,2015,0,5483,2757,2726,50.28269196
SD,McCook ,2016,0,5508,2773,2735,50.3449528
SD,McCook ,2017,0,5561,2790,2771,50.17083258
SD,McCook ,2018,0,5601,2813,2788,50.22317443
SD,McCook ,2019,0,5586,2790,2796,49.94629431
SD,McPherson ,2015,0,2397,1181,1216,49.26992073
SD,McPherson ,2016,0,2418,1173,1245,48.51116625
SD,McPherson ,2017,0,2401,1180,1221,49.14618909
SD,McPherson ,2018,0,2401,1186,1215,49.39608496
SD,McPherson ,2019,0,2379,1189,1190,49.97898277
SD,Marshall ,2015,0,4821,2585,2236,53.619581
SD,Marshall ,2016,0,4833,2586,2247,53.50713842
SD,Marshall ,2017,0,4945,2633,2312,53.24570273
SD,Marshall ,2018,0,4921,2620,2301,53.24121114
SD,Marshall ,2019,0,4935,2628,2307,53.25227964
SD,Meade ,2015,0,26770,13918,12852,51.99103474
SD,Meade ,2016,0,27339,14220,13119,52.01360694
SD,Meade ,2017,0,27941,14576,13365,52.16706632
SD,Meade ,2018,0,28204,14664,13540,51.99262516
SD,Meade ,2019,0,28332,14742,13590,52.03303685
SD,Mellette ,2015,0,2025,1050,975,51.85185185
SD,Mellette ,2016,0,2076,1085,991,52.26396917
SD,Mellette ,2017,0,2063,1053,1010,51.04217159
SD,Mellette ,2018,0,2034,1049,985,51.57325467
SD,Mellette ,2019,0,2061,1057,1004,51.2857836
SD,Miner ,2015,0,2207,1141,1066,51.6991391
SD,Miner ,2016,0,2229,1150,1079,51.59264244
SD,Miner ,2017,0,2200,1134,1066,51.54545455
SD,Miner ,2018,0,2204,1144,1060,51.90562613
SD,Miner ,2019,0,2216,1149,1067,51.85018051
SD,Minnehaha ,2015,0,183439,92325,91114,50.33008248
SD,Minnehaha ,2016,0,186268,93791,92477,50.35271759
SD,Minnehaha ,2017,0,189538,95669,93869,50.47483882
SD,Minnehaha ,2018,0,190992,96489,94503,50.51991706
SD,Minnehaha ,2019,0,193134,97655,95479,50.56333944
SD,Moody ,2015,0,6453,3228,3225,50.023245
SD,Moody ,2016,0,6508,3259,3249,50.07682852
SD,Moody ,2017,0,6494,3266,3228,50.29257776
SD,Moody ,2018,0,6502,3253,3249,50.03075977
SD,Moody ,2019,0,6576,3300,3276,50.18248175
SD,Oglala Lakota ,2015,0,14358,7041,7317,49.03886335
SD,Oglala Lakota ,2016,0,14425,7123,7302,49.37954939
SD,Oglala Lakota ,2017,0,14384,7068,7316,49.13793103
SD,Oglala Lakota ,2018,0,14331,7024,7307,49.01262996
SD,Oglala Lakota ,2019,0,14177,6961,7216,49.10065599
SD,Pennington ,2015,0,108088,54371,53717,50.30253127
SD,Pennington ,2016,0,109111,54949,54162,50.36064192
SD,Pennington ,2017,0,110503,55651,54852,50.36152865
SD,Pennington ,2018,0,111950,56334,55616,50.32067887
SD,Pennington ,2019,0,113775,57216,56559,50.28872775
SD,Perkins ,2015,0,2984,1502,1482,50.33512064
SD,Perkins ,2016,0,2964,1481,1483,49.96626181
SD,Perkins ,2017,0,2962,1480,1482,49.96623903
SD,Perkins ,2018,0,2908,1462,1446,50.27510316
SD,Perkins ,2019,0,2865,1439,1426,50.22687609
SD,Potter ,2015,0,2295,1135,1160,49.45533769
SD,Potter ,2016,0,2256,1122,1134,49.73404255
SD,Potter ,2017,0,2214,1103,1111,49.81933153
SD,Potter ,2018,0,2206,1098,1108,49.77334542
SD,Potter ,2019,0,2153,1060,1093,49.2336275
SD,Roberts ,2015,0,10209,5091,5118,49.86776374
SD,Roberts ,2016,0,10192,5123,5069,50.26491366
SD,Roberts ,2017,0,10265,5161,5104,50.27764247
SD,Roberts ,2018,0,10376,5239,5137,50.49151889
SD,Roberts ,2019,0,10394,5287,5107,50.86588416
SD,Sanborn ,2015,0,2348,1238,1110,52.72572402
SD,Sanborn ,2016,0,2374,1236,1138,52.06402696
SD,Sanborn ,2017,0,2435,1262,1173,51.8275154
SD,Sanborn ,2018,0,2396,1235,1161,51.5442404
SD,Sanborn ,2019,0,2344,1215,1129,51.83447099
SD,Spink ,2015,0,6554,3304,3250,50.41196216
SD,Spink ,2016,0,6493,3298,3195,50.79316187
SD,Spink ,2017,0,6507,3281,3226,50.42262179
SD,Spink ,2018,0,6484,3251,3233,50.13880321
SD,Spink ,2019,0,6376,3202,3174,50.2195734
SD,Stanley ,2015,0,2974,1522,1452,51.17686617
SD,Stanley ,2016,0,3012,1535,1477,50.96281541
SD,Stanley ,2017,0,2986,1522,1464,50.97119893
SD,Stanley ,2018,0,3017,1544,1473,51.17666556
SD,Stanley ,2019,0,3098,1580,1518,51.00064558
SD,Sully ,2015,0,1401,751,650,53.60456817
SD,Sully ,2016,0,1410,751,659,53.26241135
SD,Sully ,2017,0,1398,738,660,52.78969957
SD,Sully ,2018,0,1377,722,655,52.43282498
SD,Sully ,2019,0,1391,730,661,52.48023005
SD,Todd ,2015,0,10041,4929,5112,49.08873618
SD,Todd ,2016,0,10233,4966,5267,48.52926805
SD,Todd ,2017,0,10277,4983,5294,48.48691252
SD,Todd ,2018,0,10245,4979,5266,48.59931674
SD,Todd ,2019,0,10177,4926,5251,48.40326226
SD,Tripp ,2015,0,5422,2685,2737,49.52047215
SD,Tripp ,2016,0,5495,2748,2747,50.00909918
SD,Tripp ,2017,0,5443,2721,2722,49.99081389
SD,Tripp ,2018,0,5491,2769,2722,50.42797305
SD,Tripp ,2019,0,5441,2730,2711,50.17460026
SD,Turner ,2015,0,8131,4113,4018,50.58418399
SD,Turner ,2016,0,8259,4169,4090,50.47826613
SD,Turner ,2017,0,8303,4165,4138,50.16259183
SD,Turner ,2018,0,8422,4224,4198,50.15435763
SD,Turner ,2019,0,8384,4204,4180,50.14312977
SD,Union ,2015,0,14925,7528,7397,50.43886097
SD,Union ,2016,0,15137,7663,7474,50.62429808
SD,Union ,2017,0,15277,7732,7545,50.61203116
SD,Union ,2018,0,15570,7854,7716,50.44315992
SD,Union ,2019,0,15932,8054,7878,50.55234748
SD,Walworth ,2015,0,5404,2671,2733,49.42635085
SD,Walworth ,2016,0,5472,2701,2771,49.36038012
SD,Walworth ,2017,0,5497,2724,2773,49.55430235
SD,Walworth ,2018,0,5477,2734,2743,49.91783823
SD,Walworth ,2019,0,5435,2725,2710,50.13799448
SD,Yankton ,2015,0,22682,11794,10888,51.99717838
SD,Yankton ,2016,0,22649,11761,10888,51.92723741
SD,Yankton ,2017,0,22682,11781,10901,51.93986421
SD,Yankton ,2018,0,22759,11860,10899,52.11125269
SD,Yankton ,2019,0,22814,11882,10932,52.08205488
SD,Ziebach ,2015,0,2837,1408,1429,49.62989073
SD,Ziebach ,2016,0,2871,1416,1455,49.32079415
SD,Ziebach ,2017,0,2748,1358,1390,49.41775837
SD,Ziebach ,2018,0,2744,1358,1386,49.48979592
SD,Ziebach ,2019,0,2756,1373,1383,49.81857765
TN,Anderson ,2015,0,75456,36684,38772,48.61641221
TN,Anderson ,2016,0,75528,36763,38765,48.6746637
TN,Anderson ,2017,0,76056,37036,39020,48.69569791
TN,Anderson ,2018,0,76287,37131,39156,48.67277518
TN,Anderson ,2019,0,76978,37510,39468,48.72820806
TN,Bedford ,2015,0,46948,23055,23893,49.10752322
TN,Bedford ,2016,0,47442,23271,24171,49.05147338
TN,Bedford ,2017,0,48211,23690,24521,49.13816349
TN,Bedford ,2018,0,49146,24156,24990,49.15150775
TN,Bedford ,2019,0,49713,24514,25199,49.3110454
TN,Benton ,2015,0,16220,7975,8245,49.1676942
TN,Benton ,2016,0,16082,7892,8190,49.07349832
TN,Benton ,2017,0,15993,7843,8150,49.04020509
TN,Benton ,2018,0,16246,7967,8279,49.03976363
TN,Benton ,2019,0,16160,7904,8256,48.91089109
TN,Bledsoe ,2015,0,14601,8631,5970,59.11238956
TN,Bledsoe ,2016,0,14738,8651,6087,58.69860225
TN,Bledsoe ,2017,0,14895,8832,6063,59.29506546
TN,Bledsoe ,2018,0,14883,8827,6056,59.30927904
TN,Bledsoe ,2019,0,15064,8965,6099,59.51274562
TN,Blount ,2015,0,126954,61658,65296,48.56719757
TN,Blount ,2016,0,128264,62233,66031,48.51945986
TN,Blount ,2017,0,129999,63118,66881,48.55268117
TN,Blount ,2018,0,131331,63816,67515,48.59172625
TN,Blount ,2019,0,133088,64662,68426,48.58589805
TN,Bradley ,2015,0,103774,50493,53281,48.65669628
TN,Bradley ,2016,0,104390,50800,53590,48.6636651
TN,Bradley ,2017,0,105421,51305,54116,48.66677417
TN,Bradley ,2018,0,107050,52127,54923,48.69406819
TN,Bradley ,2019,0,108110,52602,55508,48.65599852
TN,Campbell ,2015,0,39772,19434,20338,48.86352208
TN,Campbell ,2016,0,39784,19506,20278,49.02976071
TN,Campbell ,2017,0,39791,19545,20246,49.11914755
TN,Campbell ,2018,0,39795,19580,20215,49.20216108
TN,Campbell ,2019,0,39842,19572,20270,49.12403996
TN,Cannon ,2015,0,13740,6811,6929,49.5705968
TN,Cannon ,2016,0,13876,6865,7011,49.47391179
TN,Cannon ,2017,0,14157,7036,7121,49.69979515
TN,Cannon ,2018,0,14440,7171,7269,49.66066482
TN,Cannon ,2019,0,14678,7313,7365,49.82286415
TN,Carroll ,2015,0,27982,13596,14386,48.58837824
TN,Carroll ,2016,0,27901,13557,14344,48.58965628
TN,Carroll ,2017,0,27807,13569,14238,48.79706549
TN,Carroll ,2018,0,27975,13674,14301,48.87935657
TN,Carroll ,2019,0,27767,13589,14178,48.93938848
TN,Carter ,2015,0,56375,27654,28721,49.05365854
TN,Carter ,2016,0,56473,27669,28804,48.995095
TN,Carter ,2017,0,56510,27656,28854,48.94001062
TN,Carter ,2018,0,56417,27638,28779,48.98877998
TN,Carter ,2019,0,56391,27702,28689,49.12486035
TN,Cheatham ,2015,0,39593,19740,19853,49.85729801
TN,Cheatham ,2016,0,39775,19745,20030,49.64173476
TN,Cheatham ,2017,0,40366,20064,20302,49.70519744
TN,Cheatham ,2018,0,40502,20153,20349,49.75803664
TN,Cheatham ,2019,0,40667,20145,20522,49.53647921
TN,Chester ,2015,0,17123,8240,8883,48.12240846
TN,Chester ,2016,0,17130,8241,8889,48.10858144
TN,Chester ,2017,0,17154,8259,8895,48.14620497
TN,Chester ,2018,0,17245,8284,8961,48.03711221
TN,Chester ,2019,0,17297,8294,9003,47.95051165
TN,Claiborne ,2015,0,31555,15380,16175,48.74029472
TN,Claiborne ,2016,0,31634,15452,16182,48.84617816
TN,Claiborne ,2017,0,31661,15470,16191,48.86137519
TN,Claiborne ,2018,0,31850,15596,16254,48.96703297
TN,Claiborne ,2019,0,31959,15666,16293,49.01905567
TN,Clay ,2015,0,7663,3775,3888,49.26269085
TN,Clay ,2016,0,7654,3759,3895,49.11157565
TN,Clay ,2017,0,7663,3770,3893,49.19744225
TN,Clay ,2018,0,7677,3759,3918,48.96443923
TN,Clay ,2019,0,7615,3735,3880,49.04793171
TN,Cocke ,2015,0,35138,16970,18168,48.29529285
TN,Cocke ,2016,0,35234,17050,18184,48.39075893
TN,Cocke ,2017,0,35528,17217,18311,48.46036929
TN,Cocke ,2018,0,35858,17385,18473,48.48290479
TN,Cocke ,2019,0,36004,17462,18542,48.50016665
TN,Coffee ,2015,0,54093,26409,27684,48.82147413
TN,Coffee ,2016,0,54537,26651,27886,48.86774117
TN,Coffee ,2017,0,55016,26897,28119,48.88941399
TN,Coffee ,2018,0,55877,27306,28571,48.86804947
TN,Coffee ,2019,0,56520,27579,28941,48.79511677
TN,Crockett ,2015,0,14586,6950,7636,47.64843
TN,Crockett ,2016,0,14448,6918,7530,47.8820598
TN,Crockett ,2017,0,14436,6885,7551,47.69326683
TN,Crockett ,2018,0,14296,6840,7456,47.8455512
TN,Crockett ,2019,0,14230,6767,7463,47.5544624
TN,Cumberland ,2015,0,58217,28365,29852,48.72288163
TN,Cumberland ,2016,0,58580,28557,30023,48.7487197
TN,Cumberland ,2017,0,59023,28787,30236,48.77251241
TN,Cumberland ,2018,0,59738,29112,30626,48.73279989
TN,Cumberland ,2019,0,60520,29527,30993,48.78883014
TN,Davidson ,2015,0,679793,327683,352110,48.20335014
TN,Davidson ,2016,0,685829,330450,355379,48.18256446
TN,Davidson ,2017,0,687159,331250,355909,48.20572822
TN,Davidson ,2018,0,690516,332809,357707,48.19714532
TN,Davidson ,2019,0,694144,334350,359794,48.16723907
TN,Decatur ,2015,0,11600,5738,5862,49.46551724
TN,Decatur ,2016,0,11735,5814,5921,49.54409885
TN,Decatur ,2017,0,11732,5798,5934,49.42038868
TN,Decatur ,2018,0,11699,5751,5948,49.1580477
TN,Decatur ,2019,0,11663,5714,5949,48.99254051
TN,DeKalb ,2015,0,19292,9564,9728,49.57495335
TN,DeKalb ,2016,0,19444,9647,9797,49.6142769
TN,DeKalb ,2017,0,19876,9876,10000,49.68806601
TN,DeKalb ,2018,0,20133,10057,10076,49.95281379
TN,DeKalb ,2019,0,20490,10208,10282,49.81942411
TN,Dickson ,2015,0,51334,25171,26163,49.03377878
TN,Dickson ,2016,0,51900,25463,26437,49.06165703
TN,Dickson ,2017,0,52774,25932,26842,49.13783302
TN,Dickson ,2018,0,53446,26297,27149,49.2029338
TN,Dickson ,2019,0,53948,26481,27467,49.08615704
TN,Dyer ,2015,0,37753,18253,19500,48.34847562
TN,Dyer ,2016,0,37542,18088,19454,48.18070428
TN,Dyer ,2017,0,37339,18029,19310,48.28463537
TN,Dyer ,2018,0,37286,17982,19304,48.22721665
TN,Dyer ,2019,0,37159,17920,19239,48.22519443
TN,Fayette ,2015,0,39280,19382,19898,49.34317719
TN,Fayette ,2016,0,39703,19612,20091,49.39677102
TN,Fayette ,2017,0,40150,19856,20294,49.45454545
TN,Fayette ,2018,0,40556,20013,20543,49.3465825
TN,Fayette ,2019,0,41133,20269,20864,49.27673644
TN,Fentress ,2015,0,17965,8852,9113,49.27358753
TN,Fentress ,2016,0,18040,8856,9184,49.09090909
TN,Fentress ,2017,0,18214,8970,9244,49.24783134
TN,Fentress ,2018,0,18322,9011,9311,49.18131208
TN,Fentress ,2019,0,18523,9108,9415,49.17130055
TN,Franklin ,2015,0,41343,20199,21144,48.85712212
TN,Franklin ,2016,0,41518,20295,21223,48.88241245
TN,Franklin ,2017,0,41623,20302,21321,48.77591716
TN,Franklin ,2018,0,41935,20527,21408,48.9495648
TN,Franklin ,2019,0,42208,20692,21516,49.02388173
TN,Gibson ,2015,0,49329,23683,25646,48.0102982
TN,Gibson ,2016,0,49250,23711,25539,48.14416244
TN,Gibson ,2017,0,49255,23731,25524,48.17988022
TN,Gibson ,2018,0,49171,23656,25515,48.10965813
TN,Gibson ,2019,0,49133,23649,25484,48.13261962
TN,Giles ,2015,0,28973,14052,14921,48.50032789
TN,Giles ,2016,0,29165,14164,15001,48.56506086
TN,Giles ,2017,0,29379,14281,15098,48.60955104
TN,Giles ,2018,0,29446,14269,15177,48.45819466
TN,Giles ,2019,0,29464,14310,15154,48.56774369
TN,Grainger ,2015,0,22848,11476,11372,50.22759104
TN,Grainger ,2016,0,23095,11584,11511,50.15804287
TN,Grainger ,2017,0,23106,11626,11480,50.31593525
TN,Grainger ,2018,0,23137,11651,11486,50.35657172
TN,Grainger ,2019,0,23320,11731,11589,50.30445969
TN,Greene ,2015,0,68586,33763,34823,49.22724754
TN,Greene ,2016,0,68529,33771,34758,49.27986692
TN,Greene ,2017,0,68821,33902,34919,49.26112669
TN,Greene ,2018,0,69164,34076,35088,49.26840553
TN,Greene ,2019,0,69069,33957,35112,49.1638796
TN,Grundy ,2015,0,13337,6608,6729,49.54637475
TN,Grundy ,2016,0,13276,6582,6694,49.5781862
TN,Grundy ,2017,0,13332,6633,6699,49.75247525
TN,Grundy ,2018,0,13348,6622,6726,49.61042853
TN,Grundy ,2019,0,13427,6666,6761,49.6462352
TN,Hamblen ,2015,0,63353,30943,32410,48.84220163
TN,Hamblen ,2016,0,63681,31097,32584,48.8324618
TN,Hamblen ,2017,0,64062,31329,32733,48.90418657
TN,Hamblen ,2018,0,64629,31625,33004,48.93314147
TN,Hamblen ,2019,0,64934,31767,33167,48.92198232
TN,Hamilton ,2015,0,353690,170546,183144,48.21906189
TN,Hamilton ,2016,0,357778,172614,185164,48.2461191
TN,Hamilton ,2017,0,361032,174195,186837,48.24918567
TN,Hamilton ,2018,0,364293,176026,188267,48.31989635
TN,Hamilton ,2019,0,367804,177544,190260,48.27136192
TN,Hancock ,2015,0,6577,3250,3327,49.41462673
TN,Hancock ,2016,0,6583,3262,3321,49.55187604
TN,Hancock ,2017,0,6593,3260,3333,49.44638253
TN,Hancock ,2018,0,6561,3246,3315,49.47416552
TN,Hancock ,2019,0,6620,3256,3364,49.18429003
TN,Hardeman ,2015,0,25817,14131,11686,54.73525197
TN,Hardeman ,2016,0,25584,14049,11535,54.91322702
TN,Hardeman ,2017,0,25488,13968,11520,54.80225989
TN,Hardeman ,2018,0,25276,13850,11426,54.79506251
TN,Hardeman ,2019,0,25050,13797,11253,55.07784431
TN,Hardin ,2015,0,25754,12577,13177,48.83513241
TN,Hardin ,2016,0,25740,12546,13194,48.74125874
TN,Hardin ,2017,0,25738,12535,13203,48.70230787
TN,Hardin ,2018,0,25693,12506,13187,48.67473631
TN,Hardin ,2019,0,25652,12477,13175,48.6394823
TN,Hawkins ,2015,0,56370,27622,28748,49.0012418
TN,Hawkins ,2016,0,56565,27787,28778,49.12401662
TN,Hawkins ,2017,0,56620,27809,28811,49.11515366
TN,Hawkins ,2018,0,56713,27848,28865,49.10338018
TN,Hawkins ,2019,0,56786,27932,28854,49.18818019
TN,Haywood ,2015,0,18036,8452,9584,46.86183189
TN,Haywood ,2016,0,17822,8322,9500,46.69509595
TN,Haywood ,2017,0,17607,8247,9360,46.83932527
TN,Haywood ,2018,0,17347,8087,9260,46.61901193
TN,Haywood ,2019,0,17304,8099,9205,46.80420712
TN,Henderson ,2015,0,28078,13710,14368,48.82826412
TN,Henderson ,2016,0,27855,13579,14276,48.74887812
TN,Henderson ,2017,0,27851,13595,14256,48.81332807
TN,Henderson ,2018,0,27983,13674,14309,48.86538255
TN,Henderson ,2019,0,28117,13772,14345,48.9810435
TN,Henry ,2015,0,32127,15543,16584,48.3798674
TN,Henry ,2016,0,32232,15553,16679,48.25328866
TN,Henry ,2017,0,32380,15685,16695,48.44039531
TN,Henry ,2018,0,32336,15684,16652,48.50321623
TN,Henry ,2019,0,32345,15701,16644,48.54227856
TN,Hickman ,2015,0,24373,12788,11585,52.4678948
TN,Hickman ,2016,0,24666,12967,11699,52.57033974
TN,Hickman ,2017,0,24839,13085,11754,52.6792544
TN,Hickman ,2018,0,25007,13131,11876,52.5092974
TN,Hickman ,2019,0,25178,13223,11955,52.51807133
TN,Houston ,2015,0,8124,3989,4135,49.10142787
TN,Houston ,2016,0,8101,3981,4120,49.14208122
TN,Houston ,2017,0,8158,4017,4141,49.24000981
TN,Houston ,2018,0,8234,4051,4183,49.19844547
TN,Houston ,2019,0,8201,4039,4162,49.25009145
TN,Humphreys ,2015,0,18157,8958,9199,49.33634411
TN,Humphreys ,2016,0,18383,9094,9289,49.46961867
TN,Humphreys ,2017,0,18503,9200,9303,49.72166676
TN,Humphreys ,2018,0,18551,9239,9312,49.80324511
TN,Humphreys ,2019,0,18582,9272,9310,49.89775051
TN,Jackson ,2015,0,11534,5794,5740,50.23409051
TN,Jackson ,2016,0,11611,5820,5791,50.12488158
TN,Jackson ,2017,0,11702,5857,5845,50.05127329
TN,Jackson ,2018,0,11777,5877,5900,49.90235204
TN,Jackson ,2019,0,11786,5893,5893,50
TN,Jefferson ,2015,0,53011,26060,26951,49.15960838
TN,Jefferson ,2016,0,53148,26180,26968,49.25867389
TN,Jefferson ,2017,0,53730,26433,27297,49.1959799
TN,Jefferson ,2018,0,54012,26554,27458,49.16314893
TN,Jefferson ,2019,0,54495,26845,27650,49.26140013
TN,Johnson ,2015,0,17842,9624,8218,53.94014124
TN,Johnson ,2016,0,17759,9585,8174,53.97263359
TN,Johnson ,2017,0,17603,9515,8088,54.05328637
TN,Johnson ,2018,0,17774,9586,8188,53.9327107
TN,Johnson ,2019,0,17788,9544,8244,53.65414886
TN,Knox ,2015,0,451297,219399,231898,48.61521348
TN,Knox ,2016,0,456089,221601,234488,48.58722749
TN,Knox ,2017,0,461565,224340,237225,48.60420526
TN,Knox ,2018,0,466258,226693,239565,48.61964835
TN,Knox ,2019,0,470313,228725,241588,48.63250644
TN,Lake ,2015,0,7602,4861,2741,63.94369903
TN,Lake ,2016,0,7531,4821,2710,64.015403
TN,Lake ,2017,0,7451,4772,2679,64.04509462
TN,Lake ,2018,0,7407,4767,2640,64.35803969
TN,Lake ,2019,0,7016,4408,2608,62.82782212
TN,Lauderdale ,2015,0,26903,14067,12836,52.28784894
TN,Lauderdale ,2016,0,25320,12588,12732,49.71563981
TN,Lauderdale ,2017,0,26093,13382,12711,51.28578546
TN,Lauderdale ,2018,0,25997,13482,12515,51.85982998
TN,Lauderdale ,2019,0,25633,13300,12333,51.88624039
TN,Lawrence ,2015,0,42592,20888,21704,49.04207363
TN,Lawrence ,2016,0,43056,21115,21941,49.0407841
TN,Lawrence ,2017,0,43388,21273,22115,49.02968563
TN,Lawrence ,2018,0,43771,21517,22254,49.15811839
TN,Lawrence ,2019,0,44142,21767,22375,49.31131349
TN,Lewis ,2015,0,11875,5793,6082,48.78315789
TN,Lewis ,2016,0,11891,5779,6112,48.59978135
TN,Lewis ,2017,0,12025,5860,6165,48.73180873
TN,Lewis ,2018,0,12074,5882,6192,48.71624979
TN,Lewis ,2019,0,12268,6005,6263,48.94848386
TN,Lincoln ,2015,0,33609,16443,17166,48.92439525
TN,Lincoln ,2016,0,33564,16438,17126,48.97509236
TN,Lincoln ,2017,0,33892,16704,17188,49.28596719
TN,Lincoln ,2018,0,34189,16845,17344,49.27023312
TN,Lincoln ,2019,0,34366,16821,17545,48.9466333
TN,Loudon ,2015,0,50916,24978,25938,49.0572708
TN,Loudon ,2016,0,51373,25290,26083,49.2281938
TN,Loudon ,2017,0,52260,25826,26434,49.41829315
TN,Loudon ,2018,0,53082,26184,26898,49.32745563
TN,Loudon ,2019,0,54068,26668,27400,49.32307465
TN,McMinn ,2015,0,52502,25634,26868,48.82480667
TN,McMinn ,2016,0,52700,25692,27008,48.75142315
TN,McMinn ,2017,0,52931,25861,27070,48.85794714
TN,McMinn ,2018,0,53336,25982,27354,48.71381431
TN,McMinn ,2019,0,53794,26194,27600,48.69316281
TN,McNairy ,2015,0,25864,12672,13192,48.99474173
TN,McNairy ,2016,0,25832,12669,13163,49.04382162
TN,McNairy ,2017,0,26001,12795,13206,49.20964578
TN,McNairy ,2018,0,25830,12680,13150,49.09020519
TN,McNairy ,2019,0,25694,12587,13107,48.9880906
TN,Macon ,2015,0,23076,11243,11833,48.72161553
TN,Macon ,2016,0,23340,11402,11938,48.85175664
TN,Macon ,2017,0,23905,11699,12206,48.93955239
TN,Macon ,2018,0,24289,11880,12409,48.91102968
TN,Macon ,2019,0,24602,12028,12574,48.89033412
TN,Madison ,2015,0,97569,46132,51437,47.2814111
TN,Madison ,2016,0,97478,46170,51308,47.36453354
TN,Madison ,2017,0,97491,46131,51360,47.31821399
TN,Madison ,2018,0,97603,46273,51330,47.4094034
TN,Madison ,2019,0,97984,46414,51570,47.3689582
TN,Marion ,2015,0,28397,13896,14501,48.93474663
TN,Marion ,2016,0,28383,13878,14505,48.8954656
TN,Marion ,2017,0,28406,13917,14489,48.99317046
TN,Marion ,2018,0,28598,14009,14589,48.98594307
TN,Marion ,2019,0,28907,14158,14749,48.97775625
TN,Marshall ,2015,0,31590,15474,16116,48.98385565
TN,Marshall ,2016,0,32035,15702,16333,49.01513969
TN,Marshall ,2017,0,33020,16181,16839,49.00363416
TN,Marshall ,2018,0,33806,16570,17236,49.01496776
TN,Marshall ,2019,0,34375,16833,17542,48.96872727
TN,Maury ,2015,0,87425,42128,45297,48.18758936
TN,Maury ,2016,0,89556,43138,46418,48.16874358
TN,Maury ,2017,0,92237,44550,47687,48.29948936
TN,Maury ,2018,0,94273,45534,48739,48.30014957
TN,Maury ,2019,0,96387,46563,49824,48.30838184
TN,Meigs ,2015,0,11804,5905,5899,50.02541511
TN,Meigs ,2016,0,11953,5982,5971,50.04601355
TN,Meigs ,2017,0,12042,5982,6060,49.67613353
TN,Meigs ,2018,0,12297,6090,6207,49.52427421
TN,Meigs ,2019,0,12422,6158,6264,49.57333763
TN,Monroe ,2015,0,45625,22627,22998,49.59342466
TN,Monroe ,2016,0,45848,22816,23032,49.76443902
TN,Monroe ,2017,0,46035,22912,23123,49.77082655
TN,Monroe ,2018,0,46269,23074,23195,49.86924291
TN,Monroe ,2019,0,46545,23186,23359,49.81415834
TN,Montgomery ,2015,0,192398,96224,96174,50.0129939
TN,Montgomery ,2016,0,194424,97150,97274,49.96811093
TN,Montgomery ,2017,0,199771,99739,100032,49.92666603
TN,Montgomery ,2018,0,205312,102153,103159,49.75500701
TN,Montgomery ,2019,0,208993,104004,104989,49.76434617
TN,Moore ,2015,0,6261,3107,3154,49.6246606
TN,Moore ,2016,0,6293,3119,3174,49.56300652
TN,Moore ,2017,0,6391,3167,3224,49.5540604
TN,Moore ,2018,0,6457,3195,3262,49.48118321
TN,Moore ,2019,0,6488,3192,3296,49.19852035
TN,Morgan ,2015,0,21494,11743,9751,54.63385131
TN,Morgan ,2016,0,21741,11900,9841,54.73529276
TN,Morgan ,2017,0,21555,11767,9788,54.59058223
TN,Morgan ,2018,0,21534,11766,9768,54.63917526
TN,Morgan ,2019,0,21403,11694,9709,54.63720039
TN,Obion ,2015,0,30561,14830,15731,48.52589902
TN,Obion ,2016,0,30547,14833,15714,48.55795987
TN,Obion ,2017,0,30375,14740,15635,48.52674897
TN,Obion ,2018,0,30274,14685,15589,48.50696968
TN,Obion ,2019,0,30069,14542,15527,48.3621005
TN,Overton ,2015,0,22067,10876,11191,49.28626456
TN,Overton ,2016,0,21964,10834,11130,49.3261701
TN,Overton ,2017,0,21998,10883,11115,49.47267933
TN,Overton ,2018,0,22068,10961,11107,49.66920428
TN,Overton ,2019,0,22241,11052,11189,49.69201025
TN,Perry ,2015,0,7852,3968,3884,50.53489557
TN,Perry ,2016,0,7880,3975,3905,50.44416244
TN,Perry ,2017,0,7954,4000,3954,50.28916269
TN,Perry ,2018,0,8050,4060,3990,50.43478261
TN,Perry ,2019,0,8076,4065,4011,50.33432392
TN,Pickett ,2015,0,5139,2554,2585,49.6983849
TN,Pickett ,2016,0,5091,2535,2556,49.79375368
TN,Pickett ,2017,0,5062,2517,2545,49.72342947
TN,Pickett ,2018,0,5053,2516,2537,49.79220265
TN,Pickett ,2019,0,5048,2509,2539,49.70285261
TN,Polk ,2015,0,16769,8339,8430,49.72866599
TN,Polk ,2016,0,16794,8344,8450,49.6844111
TN,Polk ,2017,0,16759,8297,8462,49.50772719
TN,Polk ,2018,0,16918,8363,8555,49.43255704
TN,Polk ,2019,0,16832,8324,8508,49.45342205
TN,Putnam ,2015,0,75074,37202,37872,49.55377361
TN,Putnam ,2016,0,75985,37778,38207,49.71770744
TN,Putnam ,2017,0,77299,38487,38812,49.78977736
TN,Putnam ,2018,0,78631,39156,39475,49.79715379
TN,Putnam ,2019,0,80245,39863,40382,49.67661537
TN,Rhea ,2015,0,32373,15940,16433,49.238563
TN,Rhea ,2016,0,32474,16051,16423,49.42723409
TN,Rhea ,2017,0,32671,16150,16521,49.43221818
TN,Rhea ,2018,0,32911,16277,16634,49.45762815
TN,Rhea ,2019,0,33167,16466,16701,49.6457322
TN,Roane ,2015,0,52770,25831,26939,48.95016108
TN,Roane ,2016,0,52944,25905,27039,48.92905712
TN,Roane ,2017,0,53020,25976,27044,48.99283289
TN,Roane ,2018,0,53258,26057,27201,48.92598295
TN,Roane ,2019,0,53382,26223,27159,49.12329999
TN,Robertson ,2015,0,68687,33890,34797,49.33975862
TN,Robertson ,2016,0,69393,34231,35162,49.32918306
TN,Robertson ,2017,0,70328,34719,35609,49.3672506
TN,Robertson ,2018,0,71179,35202,35977,49.45559786
TN,Robertson ,2019,0,71813,35454,36359,49.36989125
TN,Rutherford ,2015,0,298197,147167,151030,49.35227383
TN,Rutherford ,2016,0,307415,151512,155903,49.28581884
TN,Rutherford ,2017,0,316531,155966,160565,49.27353087
TN,Rutherford ,2018,0,324647,159695,164952,49.19035137
TN,Rutherford ,2019,0,332285,163252,169033,49.13011421
TN,Scott ,2015,0,21893,10800,11093,49.33083634
TN,Scott ,2016,0,21890,10785,11105,49.26907264
TN,Scott ,2017,0,21964,10809,11155,49.21234748
TN,Scott ,2018,0,22028,10798,11230,49.01942982
TN,Scott ,2019,0,22068,10837,11231,49.10730469
TN,Sequatchie ,2015,0,14641,7208,7433,49.23160986
TN,Sequatchie ,2016,0,14754,7274,7480,49.30188423
TN,Sequatchie ,2017,0,14767,7278,7489,49.28556917
TN,Sequatchie ,2018,0,14891,7358,7533,49.41239675
TN,Sequatchie ,2019,0,15026,7442,7584,49.52748569
TN,Sevier ,2015,0,95417,46785,48632,49.03214312
TN,Sevier ,2016,0,96470,47396,49074,49.13029957
TN,Sevier ,2017,0,97307,47809,49498,49.13212821
TN,Sevier ,2018,0,97895,48024,49871,49.05664232
TN,Sevier ,2019,0,98250,48257,49993,49.11653944
TN,Shelby ,2015,0,937067,446047,491020,47.60033167
TN,Shelby ,2016,0,936021,445130,490891,47.55555698
TN,Shelby ,2017,0,935251,444096,491155,47.48415131
TN,Shelby ,2018,0,936365,444456,491909,47.46610563
TN,Shelby ,2019,0,937166,444634,492532,47.44452957
TN,Smith ,2015,0,19308,9605,9703,49.74621918
TN,Smith ,2016,0,19526,9709,9817,49.72344566
TN,Smith ,2017,0,19732,9782,9950,49.57429556
TN,Smith ,2018,0,19979,9932,10047,49.71219781
TN,Smith ,2019,0,20157,10021,10136,49.7147393
TN,Stewart ,2015,0,13187,6586,6601,49.94312581
TN,Stewart ,2016,0,13190,6616,6574,50.15921152
TN,Stewart ,2017,0,13422,6727,6695,50.11920727
TN,Stewart ,2018,0,13619,6833,6786,50.17255305
TN,Stewart ,2019,0,13715,6852,6863,49.95989792
TN,Sullivan ,2015,0,156199,75774,80425,48.51119405
TN,Sullivan ,2016,0,156182,75823,80359,48.54784802
TN,Sullivan ,2017,0,156924,76288,80636,48.61461599
TN,Sullivan ,2018,0,157599,76661,80938,48.64307515
TN,Sullivan ,2019,0,158348,77058,81290,48.66370273
TN,Sumner ,2015,0,175326,85838,89488,48.95908194
TN,Sumner ,2016,0,179332,87796,91536,48.95724132
TN,Sumner ,2017,0,183756,89857,93899,48.90017197
TN,Sumner ,2018,0,187490,91516,95974,48.81113659
TN,Sumner ,2019,0,191283,93379,97904,48.81719756
TN,Tipton ,2015,0,61533,30314,31219,49.26462224
TN,Tipton ,2016,0,61223,30188,31035,49.3082665
TN,Tipton ,2017,0,61305,30179,31126,49.22763233
TN,Tipton ,2018,0,61576,30375,31201,49.32928414
TN,Tipton ,2019,0,61599,30348,31251,49.26703356
TN,Trousdale ,2015,0,8051,3973,4078,49.34790709
TN,Trousdale ,2016,0,9955,5647,4308,56.72526369
TN,Trousdale ,2017,0,10831,6430,4401,59.36663281
TN,Trousdale ,2018,0,11033,6557,4476,59.43079851
TN,Trousdale ,2019,0,11284,6642,4642,58.86210564
TN,Unicoi ,2015,0,17819,8751,9068,49.11050003
TN,Unicoi ,2016,0,17737,8731,9006,49.22478435
TN,Unicoi ,2017,0,17796,8778,9018,49.32569117
TN,Unicoi ,2018,0,17822,8795,9027,49.34911907
TN,Unicoi ,2019,0,17883,8849,9034,49.48274898
TN,Union ,2015,0,19159,9498,9661,49.57461245
TN,Union ,2016,0,19219,9506,9713,49.46147042
TN,Union ,2017,0,19399,9584,9815,49.40460848
TN,Union ,2018,0,19689,9703,9986,49.2813246
TN,Union ,2019,0,19972,9895,10077,49.54436211
TN,Van Buren ,2015,0,5695,2887,2808,50.69359087
TN,Van Buren ,2016,0,5721,2894,2827,50.58556196
TN,Van Buren ,2017,0,5747,2927,2820,50.93092048
TN,Van Buren ,2018,0,5763,2900,2863,50.32101336
TN,Van Buren ,2019,0,5872,2961,2911,50.42574932
TN,Warren ,2015,0,40262,19856,20406,49.31697382
TN,Warren ,2016,0,40428,19981,20447,49.42366677
TN,Warren ,2017,0,40717,20149,20568,49.4854729
TN,Warren ,2018,0,40826,20213,20613,49.5101161
TN,Warren ,2019,0,41277,20508,20769,49.6838433
TN,Washington ,2015,0,126137,61599,64538,48.83499687
TN,Washington ,2016,0,127247,62182,65065,48.86716386
TN,Washington ,2017,0,127603,62299,65304,48.82251985
TN,Washington ,2018,0,128661,62799,65862,48.8096626
TN,Washington ,2019,0,129375,63205,66170,48.85410628
TN,Wayne ,2015,0,16767,9312,7455,55.53766327
TN,Wayne ,2016,0,16747,9266,7481,55.32931271
TN,Wayne ,2017,0,16641,9253,7388,55.60362959
TN,Wayne ,2018,0,16635,9227,7408,55.46738804
TN,Wayne ,2019,0,16673,9233,7440,55.37695676
TN,Weakley ,2015,0,33872,16521,17351,48.77479924
TN,Weakley ,2016,0,33610,16386,17224,48.75334722
TN,Weakley ,2017,0,33325,16312,17013,48.94823706
TN,Weakley ,2018,0,33413,16372,17041,48.99889265
TN,Weakley ,2019,0,33328,16277,17051,48.83881421
TN,White ,2015,0,26342,12880,13462,48.89530028
TN,White ,2016,0,26463,12973,13490,49.02316442
TN,White ,2017,0,26764,13093,13671,48.9201913
TN,White ,2018,0,27086,13260,13826,48.9551798
TN,White ,2019,0,27345,13386,13959,48.95227647
TN,Williamson ,2015,0,211605,103590,108015,48.95441979
TN,Williamson ,2016,0,218903,107277,111626,49.00663764
TN,Williamson ,2017,0,226048,110721,115327,48.98118984
TN,Williamson ,2018,0,231978,113793,118185,49.05335851
TN,Williamson ,2019,0,238412,117098,121314,49.11581632
TN,Wilson ,2015,0,128536,63097,65439,49.08897118
TN,Wilson ,2016,0,132494,65044,67450,49.09203436
TN,Wilson ,2017,0,136691,67144,69547,49.12101016
TN,Wilson ,2018,0,140954,69363,71591,49.20967124
TN,Wilson ,2019,0,144657,71178,73479,49.20467036
TX,Anderson ,2015,0,57639,35268,22371,61.18773747
TX,Anderson ,2016,0,57526,35003,22523,60.84726906
TX,Anderson ,2017,0,58175,35615,22560,61.22045552
TX,Anderson ,2018,0,57974,35545,22429,61.31196743
TX,Anderson ,2019,0,57735,35474,22261,61.442799
TX,Andrews ,2015,0,18072,9297,8775,51.44422311
TX,Andrews ,2016,0,17791,9100,8691,51.14945759
TX,Andrews ,2017,0,17603,8958,8645,50.889053
TX,Andrews ,2018,0,18011,9221,8790,51.19649103
TX,Andrews ,2019,0,18705,9568,9137,51.15209837
TX,Angelina ,2015,0,87829,42898,44931,48.8426374
TX,Angelina ,2016,0,87682,42861,44821,48.88232476
TX,Angelina ,2017,0,87572,42720,44852,48.78271594
TX,Angelina ,2018,0,86810,42361,44449,48.79737357
TX,Angelina ,2019,0,86715,42353,44362,48.84160757
TX,Aransas ,2015,0,24800,12375,12425,49.89919355
TX,Aransas ,2016,0,25162,12481,12681,49.60257531
TX,Aransas ,2017,0,25392,12573,12819,49.51559546
TX,Aransas ,2018,0,23446,11593,11853,49.44553442
TX,Aransas ,2019,0,23510,11633,11877,49.48107188
TX,Archer ,2015,0,8763,4375,4388,49.92582449
TX,Archer ,2016,0,8781,4354,4427,49.5843298
TX,Archer ,2017,0,8783,4355,4428,49.58442446
TX,Archer ,2018,0,8700,4284,4416,49.24137931
TX,Archer ,2019,0,8553,4186,4367,48.94189173
TX,Armstrong ,2015,0,1901,928,973,48.81641241
TX,Armstrong ,2016,0,1843,908,935,49.26749864
TX,Armstrong ,2017,0,1867,901,966,48.25923942
TX,Armstrong ,2018,0,1879,906,973,48.21713677
TX,Armstrong ,2019,0,1887,923,964,48.9136195
TX,Atascosa ,2015,0,48363,24079,24284,49.78806112
TX,Atascosa ,2016,0,48720,24226,24494,49.72495895
TX,Atascosa ,2017,0,49083,24445,24638,49.80339425
TX,Atascosa ,2018,0,50322,25058,25264,49.79531815
TX,Atascosa ,2019,0,51153,25474,25679,49.79962075
TX,Austin ,2015,0,29471,14611,14860,49.57755081
TX,Austin ,2016,0,29629,14637,14992,49.40092477
TX,Austin ,2017,0,29722,14719,15003,49.52223942
TX,Austin ,2018,0,29965,14900,15065,49.72467879
TX,Austin ,2019,0,30032,14931,15101,49.71696857
TX,Bailey ,2015,0,7223,3659,3564,50.65762149
TX,Bailey ,2016,0,7196,3629,3567,50.43079489
TX,Bailey ,2017,0,7066,3526,3540,49.90093405
TX,Bailey ,2018,0,7015,3491,3524,49.76478974
TX,Bailey ,2019,0,7000,3516,3484,50.22857143
TX,Bandera ,2015,0,21144,10484,10660,49.58380628
TX,Bandera ,2016,0,21701,10740,10961,49.49080688
TX,Bandera ,2017,0,22327,11058,11269,49.52747794
TX,Bandera ,2018,0,22792,11283,11509,49.504212
TX,Bandera ,2019,0,23112,11472,11640,49.63655244
TX,Bastrop ,2015,0,80115,40791,39324,50.91555888
TX,Bastrop ,2016,0,82591,41937,40654,50.77671901
TX,Bastrop ,2017,0,84585,42919,41666,50.74067506
TX,Bastrop ,2018,0,86595,44017,42578,50.83087938
TX,Bastrop ,2019,0,88723,45112,43611,50.84589114
TX,Baylor ,2015,0,3609,1777,1832,49.23801607
TX,Baylor ,2016,0,3638,1786,1852,49.09290819
TX,Baylor ,2017,0,3555,1750,1805,49.22644163
TX,Baylor ,2018,0,3573,1741,1832,48.72656031
TX,Baylor ,2019,0,3509,1704,1805,48.56084355
TX,Bee ,2015,0,32617,19705,12912,60.41328142
TX,Bee ,2016,0,32812,19917,12895,60.70035353
TX,Bee ,2017,0,32592,19834,12758,60.85542464
TX,Bee ,2018,0,32467,19732,12735,60.77555672
TX,Bee ,2019,0,32565,19825,12740,60.87824351
TX,Bell ,2015,0,336076,168563,167513,50.15621467
TX,Bell ,2016,0,341094,170314,170780,49.93169038
TX,Bell ,2017,0,347377,173030,174347,49.8104365
TX,Bell ,2018,0,355397,176623,178774,49.69738068
TX,Bell ,2019,0,362924,180296,182628,49.67872061
TX,Bexar ,2015,0,1894834,934283,960551,49.30685221
TX,Bexar ,2016,0,1927651,951374,976277,49.35405839
TX,Bexar ,2017,0,1956988,966522,990466,49.38824357
TX,Bexar ,2018,0,1981187,978444,1002743,49.38675653
TX,Bexar ,2019,0,2003554,989790,1013764,49.40171316
TX,Blanco ,2015,0,11029,5539,5490,50.22214163
TX,Blanco ,2016,0,11301,5665,5636,50.12830723
TX,Blanco ,2017,0,11481,5742,5739,50.01306506
TX,Blanco ,2018,0,11648,5837,5811,50.11160714
TX,Blanco ,2019,0,11931,5950,5981,49.87008633
TX,Borden ,2015,0,655,348,307,53.12977099
TX,Borden ,2016,0,657,341,316,51.90258752
TX,Borden ,2017,0,670,351,319,52.3880597
TX,Borden ,2018,0,647,337,310,52.08655332
TX,Borden ,2019,0,654,337,317,51.52905199
TX,Bosque ,2015,0,17864,8810,9054,49.31706225
TX,Bosque ,2016,0,18009,8882,9127,49.31978455
TX,Bosque ,2017,0,18295,9052,9243,49.47799945
TX,Bosque ,2018,0,18629,9205,9424,49.41220677
TX,Bosque ,2019,0,18685,9237,9448,49.43537597
TX,Bowie ,2015,0,93050,46665,46385,50.15045674
TX,Bowie ,2016,0,93424,46850,46574,50.14771365
TX,Bowie ,2017,0,93458,46851,46607,50.13053992
TX,Bowie ,2018,0,93688,47023,46665,50.19105969
TX,Bowie ,2019,0,93245,46673,46572,50.0541584
TX,Brazoria ,2015,0,345227,174879,170348,50.65623488
TX,Brazoria ,2016,0,353155,178620,174535,50.57835794
TX,Brazoria ,2017,0,361853,183279,178574,50.65012588
TX,Brazoria ,2018,0,368887,186514,182373,50.56128299
TX,Brazoria ,2019,0,374264,189053,185211,50.51327405
TX,Brazos ,2015,0,216258,109641,106617,50.69916489
TX,Brazos ,2016,0,219739,111231,108508,50.61959871
TX,Brazos ,2017,0,223917,113294,110623,50.59642635
TX,Brazos ,2018,0,225781,113921,111860,50.45641573
TX,Brazos ,2019,0,229211,115425,113786,50.35753083
TX,Brewster ,2015,0,9143,4571,4572,49.99453134
TX,Brewster ,2016,0,9211,4642,4569,50.39626533
TX,Brewster ,2017,0,9325,4721,4604,50.62734584
TX,Brewster ,2018,0,9272,4686,4586,50.53925798
TX,Brewster ,2019,0,9203,4689,4514,50.95077692
TX,Briscoe ,2015,0,1514,738,776,48.74504624
TX,Briscoe ,2016,0,1483,731,752,49.29197572
TX,Briscoe ,2017,0,1514,752,762,49.66974901
TX,Briscoe ,2018,0,1512,748,764,49.47089947
TX,Briscoe ,2019,0,1546,769,777,49.74126779
TX,Brooks ,2015,0,7190,3645,3545,50.69541029
TX,Brooks ,2016,0,7190,3657,3533,50.86230876
TX,Brooks ,2017,0,7132,3638,3494,51.00953449
TX,Brooks ,2018,0,7099,3620,3479,50.99309762
TX,Brooks ,2019,0,7093,3616,3477,50.97983928
TX,Brown ,2015,0,37736,18641,19095,49.39845241
TX,Brown ,2016,0,38039,18772,19267,49.34935198
TX,Brown ,2017,0,37815,18659,19156,49.34285337
TX,Brown ,2018,0,37820,18730,19090,49.52406134
TX,Brown ,2019,0,37864,18732,19132,49.47179379
TX,Burleson ,2015,0,17611,8762,8849,49.75299529
TX,Burleson ,2016,0,17848,8856,8992,49.61900493
TX,Burleson ,2017,0,18053,8930,9123,49.4654628
TX,Burleson ,2018,0,18335,9032,9303,49.26097627
TX,Burleson ,2019,0,18443,9104,9339,49.36290191
TX,Burnet ,2015,0,44734,21887,22847,48.92699066
TX,Burnet ,2016,0,45817,22453,23364,49.00582753
TX,Burnet ,2017,0,46600,22805,23795,48.93776824
TX,Burnet ,2018,0,47344,23204,24140,49.01149037
TX,Burnet ,2019,0,48155,23599,24556,49.00633371
TX,Caldwell ,2015,0,40419,20291,20128,50.20163784
TX,Caldwell ,2016,0,41147,20693,20454,50.29042214
TX,Caldwell ,2017,0,42328,21278,21050,50.26932527
TX,Caldwell ,2018,0,43161,21733,21428,50.35332824
TX,Caldwell ,2019,0,43664,22029,21635,50.45117259
TX,Calhoun ,2015,0,21887,11228,10659,51.29985836
TX,Calhoun ,2016,0,21948,11216,10732,51.10260616
TX,Calhoun ,2017,0,21712,11117,10595,51.20210022
TX,Calhoun ,2018,0,21504,11026,10478,51.27418155
TX,Calhoun ,2019,0,21290,10930,10360,51.33865665
TX,Callahan ,2015,0,13589,6704,6885,49.33402016
TX,Callahan ,2016,0,13789,6810,6979,49.38719269
TX,Callahan ,2017,0,13968,6917,7051,49.52033219
TX,Callahan ,2018,0,13990,6927,7063,49.51393853
TX,Callahan ,2019,0,13943,6915,7028,49.59477874
TX,Cameron ,2015,0,419450,203296,216154,48.46727858
TX,Cameron ,2016,0,421350,204604,216746,48.5591551
TX,Cameron ,2017,0,422227,205247,216980,48.61058151
TX,Cameron ,2018,0,422139,205547,216592,48.69178162
TX,Cameron ,2019,0,423163,206296,216867,48.75095412
TX,Camp ,2015,0,12699,6128,6571,48.25576817
TX,Camp ,2016,0,12771,6194,6577,48.50050897
TX,Camp ,2017,0,12845,6219,6626,48.41572596
TX,Camp ,2018,0,12983,6295,6688,48.48648232
TX,Camp ,2019,0,13094,6362,6732,48.58713915
TX,Carson ,2015,0,6013,3005,3008,49.97505405
TX,Carson ,2016,0,6096,3041,3055,49.8851706
TX,Carson ,2017,0,6005,2997,3008,49.90840966
TX,Carson ,2018,0,6007,2999,3008,49.9250874
TX,Carson ,2019,0,5926,2982,2944,50.32062099
TX,Cass ,2015,0,30140,14571,15569,48.34439283
TX,Cass ,2016,0,30058,14539,15519,48.36981835
TX,Cass ,2017,0,29966,14461,15505,48.25802576
TX,Cass ,2018,0,30106,14556,15550,48.34916628
TX,Cass ,2019,0,30026,14512,15514,48.33144608
TX,Castro ,2015,0,7787,3950,3837,50.72556825
TX,Castro ,2016,0,7765,3959,3806,50.98518995
TX,Castro ,2017,0,7696,3949,3747,51.31237006
TX,Castro ,2018,0,7588,3904,3684,51.44965735
TX,Castro ,2019,0,7530,3863,3667,51.30146082
TX,Chambers ,2015,0,39028,19697,19331,50.46889413
TX,Chambers ,2016,0,40163,20323,19840,50.6012997
TX,Chambers ,2017,0,41269,20883,20386,50.60214689
TX,Chambers ,2018,0,42227,21377,20850,50.62400834
TX,Chambers ,2019,0,43837,22123,21714,50.4665009
TX,Cherokee ,2015,0,51568,26248,25320,50.89978281
TX,Cherokee ,2016,0,51879,26467,25412,51.01678907
TX,Cherokee ,2017,0,52116,26584,25532,51.00928698
TX,Cherokee ,2018,0,52381,26666,25715,50.9077719
TX,Cherokee ,2019,0,52646,26824,25822,50.95163925
TX,Childress ,2015,0,7169,4279,2890,59.68754359
TX,Childress ,2016,0,7204,4317,2887,59.92504164
TX,Childress ,2017,0,7269,4447,2822,61.17760352
TX,Childress ,2018,0,7315,4471,2844,61.12098428
TX,Childress ,2019,0,7306,4475,2831,61.25102655
TX,Clay ,2015,0,10359,5174,5185,49.94690607
TX,Clay ,2016,0,10251,5122,5129,49.96585699
TX,Clay ,2017,0,10484,5206,5278,49.65661961
TX,Clay ,2018,0,10448,5197,5251,49.74157734
TX,Clay ,2019,0,10471,5230,5241,49.94747398
TX,Cochran ,2015,0,2977,1486,1491,49.91602284
TX,Cochran ,2016,0,2921,1468,1453,50.25676138
TX,Cochran ,2017,0,2853,1421,1432,49.80722047
TX,Cochran ,2018,0,2831,1421,1410,50.19427764
TX,Cochran ,2019,0,2853,1447,1406,50.71854189
TX,Coke ,2015,0,3227,1606,1621,49.76758599
TX,Coke ,2016,0,3259,1609,1650,49.37097269
TX,Coke ,2017,0,3285,1630,1655,49.6194825
TX,Coke ,2018,0,3355,1666,1689,49.65722802
TX,Coke ,2019,0,3387,1695,1692,50.04428698
TX,Coleman ,2015,0,8316,4141,4175,49.7955748
TX,Coleman ,2016,0,8412,4209,4203,50.03566334
TX,Coleman ,2017,0,8399,4236,4163,50.43457554
TX,Coleman ,2018,0,8367,4212,4155,50.34062388
TX,Coleman ,2019,0,8175,4161,4014,50.89908257
TX,Collin ,2015,0,915243,449470,465773,49.10936221
TX,Collin ,2016,0,943742,463856,479886,49.15072128
TX,Collin ,2017,0,971864,478480,493384,49.23322605
TX,Collin ,2018,0,1004307,494514,509793,49.23932622
TX,Collin ,2019,0,1034730,509556,525174,49.24531037
TX,Collingsworth ,2015,0,3010,1444,1566,47.97342193
TX,Collingsworth ,2016,0,3007,1456,1551,48.42035251
TX,Collingsworth ,2017,0,2964,1424,1540,48.04318489
TX,Collingsworth ,2018,0,2942,1438,1504,48.87831407
TX,Collingsworth ,2019,0,2920,1430,1490,48.97260274
TX,Colorado ,2015,0,20951,10485,10466,50.0453439
TX,Colorado ,2016,0,21081,10574,10507,50.15891087
TX,Colorado ,2017,0,21291,10682,10609,50.17143394
TX,Colorado ,2018,0,21305,10702,10603,50.23233983
TX,Colorado ,2019,0,21493,10823,10670,50.35592984
TX,Comal ,2015,0,128795,63709,65086,49.46542956
TX,Comal ,2016,0,134343,66416,67927,49.43763352
TX,Comal ,2017,0,140721,69601,71120,49.46027956
TX,Comal ,2018,0,148141,73201,74940,49.41305918
TX,Comal ,2019,0,156209,77331,78878,49.50483007
TX,Comanche ,2015,0,13395,6595,6800,49.2347891
TX,Comanche ,2016,0,13543,6706,6837,49.51635531
TX,Comanche ,2017,0,13533,6737,6796,49.78201434
TX,Comanche ,2018,0,13540,6752,6788,49.86706056
TX,Comanche ,2019,0,13635,6794,6841,49.82764943
TX,Concho ,2015,0,4072,2831,1241,69.52357564
TX,Concho ,2016,0,4140,2873,1267,69.39613527
TX,Concho ,2017,0,2707,1463,1244,54.04506834
TX,Concho ,2018,0,2683,1443,1240,53.78307864
TX,Concho ,2019,0,2726,1449,1277,53.15480558
TX,Cooke ,2015,0,39170,19434,19736,49.61450089
TX,Cooke ,2016,0,39343,19627,19716,49.8868922
TX,Cooke ,2017,0,39932,19897,20035,49.82720625
TX,Cooke ,2018,0,40504,20194,20310,49.85680427
TX,Cooke ,2019,0,41257,20576,20681,49.87274887
TX,Coryell ,2015,0,76145,38279,37866,50.27119312
TX,Coryell ,2016,0,74803,37297,37506,49.86029972
TX,Coryell ,2017,0,74760,37280,37480,49.86623863
TX,Coryell ,2018,0,74741,37174,37567,49.73709209
TX,Coryell ,2019,0,75951,37826,38125,49.80316257
TX,Cottle ,2015,0,1439,686,753,47.67199444
TX,Cottle ,2016,0,1402,685,717,48.85877318
TX,Cottle ,2017,0,1375,664,711,48.29090909
TX,Cottle ,2018,0,1382,671,711,48.552822
TX,Cottle ,2019,0,1398,681,717,48.71244635
TX,Crane ,2015,0,4995,2509,2486,50.23023023
TX,Crane ,2016,0,4779,2396,2383,50.13601172
TX,Crane ,2017,0,4685,2351,2334,50.1814301
TX,Crane ,2018,0,4755,2386,2369,50.1787592
TX,Crane ,2019,0,4797,2418,2379,50.40650407
TX,Crockett ,2015,0,3735,1868,1867,50.01338688
TX,Crockett ,2016,0,3642,1835,1807,50.38440417
TX,Crockett ,2017,0,3535,1765,1770,49.92927864
TX,Crockett ,2018,0,3439,1708,1731,49.66560047
TX,Crockett ,2019,0,3464,1738,1726,50.17321016
TX,Crosby ,2015,0,5918,2927,2991,49.45927678
TX,Crosby ,2016,0,5911,2923,2988,49.45017763
TX,Crosby ,2017,0,5849,2908,2941,49.7179005
TX,Crosby ,2018,0,5764,2853,2911,49.49687717
TX,Crosby ,2019,0,5737,2847,2890,49.62523967
TX,Culberson ,2015,0,2254,1101,1153,48.84649512
TX,Culberson ,2016,0,2220,1095,1125,49.32432432
TX,Culberson ,2017,0,2230,1115,1115,50
TX,Culberson ,2018,0,2194,1084,1110,49.40747493
TX,Culberson ,2019,0,2171,1083,1088,49.88484569
TX,Dallam ,2015,0,7301,3793,3508,51.95178743
TX,Dallam ,2016,0,7357,3847,3510,52.29033573
TX,Dallam ,2017,0,7272,3818,3454,52.50275028
TX,Dallam ,2018,0,7303,3843,3460,52.62221005
TX,Dallam ,2019,0,7287,3836,3451,52.64169068
TX,Dallas ,2015,0,2557830,1260139,1297691,49.26594027
TX,Dallas ,2016,0,2591488,1277092,1314396,49.28025906
TX,Dallas ,2017,0,2620154,1292290,1327864,49.32114677
TX,Dallas ,2018,0,2629350,1297155,1332195,49.33367562
TX,Dallas ,2019,0,2635516,1300175,1335341,49.33284412
TX,Dawson ,2015,0,12987,7082,5905,54.53145453
TX,Dawson ,2016,0,12999,7112,5887,54.71190092
TX,Dawson ,2017,0,12744,6967,5777,54.66886378
TX,Dawson ,2018,0,12605,6906,5699,54.78778263
TX,Dawson ,2019,0,12728,6962,5766,54.69830295
TX,Deaf Smith ,2015,0,18825,9372,9453,49.78486056
TX,Deaf Smith ,2016,0,18846,9395,9451,49.85142736
TX,Deaf Smith ,2017,0,18753,9317,9436,49.68271743
TX,Deaf Smith ,2018,0,18711,9325,9386,49.83699428
TX,Deaf Smith ,2019,0,18546,9246,9300,49.85441605
TX,Delta ,2015,0,5159,2527,2632,48.98236092
TX,Delta ,2016,0,5147,2521,2626,48.97998834
TX,Delta ,2017,0,5276,2618,2658,49.62092494
TX,Delta ,2018,0,5332,2642,2690,49.54988747
TX,Delta ,2019,0,5331,2653,2678,49.76552242
TX,Denton ,2015,0,779584,383422,396162,49.18289755
TX,Denton ,2016,0,808212,397663,410549,49.20280817
TX,Denton ,2017,0,835364,411002,424362,49.20034859
TX,Denton ,2018,0,858741,422436,436305,49.19248062
TX,Denton ,2019,0,887207,436223,450984,49.16811973
TX,DeWitt ,2015,0,20632,10818,9814,52.43311361
TX,DeWitt ,2016,0,20623,10830,9793,52.51418319
TX,DeWitt ,2017,0,20180,10627,9553,52.66105055
TX,DeWitt ,2018,0,20106,10571,9535,52.57634537
TX,DeWitt ,2019,0,20160,10585,9575,52.50496032
TX,Dickens ,2015,0,2204,1253,951,56.85117967
TX,Dickens ,2016,0,2193,1228,965,55.99635203
TX,Dickens ,2017,0,2190,1234,956,56.34703196
TX,Dickens ,2018,0,2218,1233,985,55.59062218
TX,Dickens ,2019,0,2211,1227,984,55.49525102
TX,Dimmit ,2015,0,10910,5381,5529,49.32172319
TX,Dimmit ,2016,0,10679,5244,5435,49.10572151
TX,Dimmit ,2017,0,10282,5029,5253,48.91071776
TX,Dimmit ,2018,0,10195,5000,5195,49.04364885
TX,Dimmit ,2019,0,10124,4933,5191,48.72580008
TX,Donley ,2015,0,3391,1676,1715,49.42494839
TX,Donley ,2016,0,3387,1674,1713,49.42426926
TX,Donley ,2017,0,3340,1648,1692,49.34131737
TX,Donley ,2018,0,3315,1635,1680,49.32126697
TX,Donley ,2019,0,3278,1612,1666,49.17632703
TX,Duval ,2015,0,11336,5811,5525,51.26146789
TX,Duval ,2016,0,11431,5919,5512,51.7802467
TX,Duval ,2017,0,11270,5834,5436,51.76574978
TX,Duval ,2018,0,11147,5698,5449,51.11689244
TX,Duval ,2019,0,11157,5707,5450,51.1517433
TX,Eastland ,2015,0,18152,9009,9143,49.63089467
TX,Eastland ,2016,0,18240,9029,9211,49.50109649
TX,Eastland ,2017,0,18294,9105,9189,49.77041653
TX,Eastland ,2018,0,18319,9172,9147,50.06823517
TX,Eastland ,2019,0,18360,9180,9180,50
TX,Ector ,2015,0,159903,81136,78767,50.74076159
TX,Ector ,2016,0,157858,79818,78040,50.56316436
TX,Ector ,2017,0,156951,79435,77516,50.6113373
TX,Ector ,2018,0,161960,82303,79657,50.81686836
TX,Ector ,2019,0,166223,84862,81361,51.05310336
TX,Edwards ,2015,0,1910,996,914,52.14659686
TX,Edwards ,2016,0,1908,1001,907,52.46331237
TX,Edwards ,2017,0,1929,1017,912,52.72161742
TX,Edwards ,2018,0,1908,1003,905,52.56813417
TX,Edwards ,2019,0,1932,1024,908,53.00207039
TX,Ellis ,2015,0,163292,80540,82752,49.32268574
TX,Ellis ,2016,0,168332,83023,85309,49.32098472
TX,Ellis ,2017,0,173405,85570,87835,49.34690465
TX,Ellis ,2018,0,179006,88354,90652,49.35812207
TX,Ellis ,2019,0,184826,91277,93549,49.38536786
TX,El Paso ,2015,0,831898,407369,424529,48.96862356
TX,El Paso ,2016,0,834949,410070,424879,49.11317937
TX,El Paso ,2017,0,837401,412225,425176,49.22671456
TX,El Paso ,2018,0,836825,412759,424066,49.32441072
TX,El Paso ,2019,0,839238,414807,424431,49.42662272
TX,Erath ,2015,0,41191,20294,20897,49.26804399
TX,Erath ,2016,0,41372,20391,20981,49.28695736
TX,Erath ,2017,0,41723,20461,21262,49.04009779
TX,Erath ,2018,0,42223,20696,21527,49.01593918
TX,Erath ,2019,0,42698,20923,21775,49.00229519
TX,Falls ,2015,0,17216,8140,9076,47.28159851
TX,Falls ,2016,0,17276,8175,9101,47.31998148
TX,Falls ,2017,0,17340,8221,9119,47.4106113
TX,Falls ,2018,0,17231,8163,9068,47.3739191
TX,Falls ,2019,0,17297,8196,9101,47.38393941
TX,Fannin ,2015,0,33502,17780,15722,53.07145842
TX,Fannin ,2016,0,33933,18057,15876,53.21368579
TX,Fannin ,2017,0,34550,18378,16172,53.19247467
TX,Fannin ,2018,0,35185,18687,16498,53.11070058
TX,Fannin ,2019,0,35514,18876,16638,53.15087008
TX,Fayette ,2015,0,24945,12224,12721,49.00380838
TX,Fayette ,2016,0,25018,12275,12743,49.06467344
TX,Fayette ,2017,0,25119,12319,12800,49.04255743
TX,Fayette ,2018,0,25278,12412,12866,49.10198592
TX,Fayette ,2019,0,25346,12486,12860,49.262211
TX,Fisher ,2015,0,3877,1937,1940,49.96131029
TX,Fisher ,2016,0,3877,1938,1939,49.98710343
TX,Fisher ,2017,0,3874,1927,1947,49.74186887
TX,Fisher ,2018,0,3821,1899,1922,49.69903167
TX,Fisher ,2019,0,3830,1916,1914,50.02610966
TX,Floyd ,2015,0,5843,2903,2940,49.68338182
TX,Floyd ,2016,0,5847,2934,2913,50.17957927
TX,Floyd ,2017,0,5830,2949,2881,50.58319039
TX,Floyd ,2018,0,5783,2906,2877,50.25073491
TX,Floyd ,2019,0,5712,2871,2841,50.26260504
TX,Foard ,2015,0,1225,586,639,47.83673469
TX,Foard ,2016,0,1200,566,634,47.16666667
TX,Foard ,2017,0,1202,572,630,47.58735441
TX,Foard ,2018,0,1191,566,625,47.52308984
TX,Foard ,2019,0,1155,547,608,47.35930736
TX,Fort Bend ,2015,0,715331,351645,363686,49.15836165
TX,Fort Bend ,2016,0,744160,365816,378344,49.15824554
TX,Fort Bend ,2017,0,767712,377055,390657,49.11412092
TX,Fort Bend ,2018,0,788081,386744,401337,49.07414339
TX,Fort Bend ,2019,0,811688,398284,413404,49.06860764
TX,Franklin ,2015,0,10603,5253,5350,49.54258229
TX,Franklin ,2016,0,10677,5319,5358,49.81736443
TX,Franklin ,2017,0,10798,5353,5445,49.57399518
TX,Franklin ,2018,0,10778,5352,5426,49.65670811
TX,Franklin ,2019,0,10725,5337,5388,49.76223776
TX,Freestone ,2015,0,19746,10267,9479,51.99534083
TX,Freestone ,2016,0,19669,10229,9440,52.00569424
TX,Freestone ,2017,0,19649,10229,9420,52.05862894
TX,Freestone ,2018,0,19789,10301,9488,52.05417151
TX,Freestone ,2019,0,19717,10246,9471,51.96530912
TX,Frio ,2015,0,19361,11437,7924,59.07236196
TX,Frio ,2016,0,19584,11592,7992,59.19117647
TX,Frio ,2017,0,19895,11784,8111,59.23096255
TX,Frio ,2018,0,20211,11960,8251,59.1756964
TX,Frio ,2019,0,20306,12016,8290,59.17462819
TX,Gaines ,2015,0,20217,10211,10006,50.50699906
TX,Gaines ,2016,0,20446,10281,10165,50.28367407
TX,Gaines ,2017,0,20553,10342,10211,50.31868827
TX,Gaines ,2018,0,20820,10550,10270,50.67243036
TX,Gaines ,2019,0,21492,10877,10615,50.60952913
TX,Galveston ,2015,0,320974,158254,162720,49.30430502
TX,Galveston ,2016,0,328820,162130,166690,49.30661152
TX,Galveston ,2017,0,334633,164825,169808,49.25545299
TX,Galveston ,2018,0,337858,165996,171862,49.13188381
TX,Galveston ,2019,0,342139,167942,174197,49.08589784
TX,Garza ,2015,0,6391,4161,2230,65.10718197
TX,Garza ,2016,0,6212,3991,2221,64.24661945
TX,Garza ,2017,0,6490,4251,2239,65.50077042
TX,Garza ,2018,0,6243,4027,2216,64.50424475
TX,Garza ,2019,0,6229,4050,2179,65.01846203
TX,Gillespie ,2015,0,25916,12562,13354,48.47198642
TX,Gillespie ,2016,0,26206,12713,13493,48.51179119
TX,Gillespie ,2017,0,26483,12838,13645,48.47638107
TX,Gillespie ,2018,0,26702,12970,13732,48.57314059
TX,Gillespie ,2019,0,26988,13151,13837,48.72906477
TX,Glasscock ,2015,0,1380,763,617,55.28985507
TX,Glasscock ,2016,0,1365,764,601,55.97069597
TX,Glasscock ,2017,0,1363,759,604,55.68598679
TX,Glasscock ,2018,0,1391,771,620,55.42774982
TX,Glasscock ,2019,0,1409,777,632,55.14549326
TX,Goliad ,2015,0,7513,3741,3772,49.79369094
TX,Goliad ,2016,0,7512,3720,3792,49.52076677
TX,Goliad ,2017,0,7552,3753,3799,49.69544492
TX,Goliad ,2018,0,7588,3741,3847,49.30152873
TX,Goliad ,2019,0,7658,3766,3892,49.1773309
TX,Gonzales ,2015,0,20510,10426,10084,50.83373964
TX,Gonzales ,2016,0,20787,10514,10273,50.57968923
TX,Gonzales ,2017,0,20742,10468,10274,50.46765018
TX,Gonzales ,2018,0,20781,10499,10282,50.52211154
TX,Gonzales ,2019,0,20837,10554,10283,50.65028555
TX,Gray ,2015,0,23265,12393,10872,53.2688588
TX,Gray ,2016,0,22741,12067,10674,53.0627501
TX,Gray ,2017,0,22106,11711,10395,52.97656745
TX,Gray ,2018,0,22051,11810,10241,53.55766178
TX,Gray ,2019,0,21886,11773,10113,53.79237869
TX,Grayson ,2015,0,125628,61464,64164,48.9253988
TX,Grayson ,2016,0,128291,62671,65620,48.85065983
TX,Grayson ,2017,0,131152,63994,67158,48.79376601
TX,Grayson ,2018,0,133787,65300,68487,48.80892762
TX,Grayson ,2019,0,136212,66608,69604,48.90024374
TX,Gregg ,2015,0,123800,60561,63239,48.9184168
TX,Gregg ,2016,0,123367,60224,63143,48.81694456
TX,Gregg ,2017,0,122852,59882,62970,48.7432032
TX,Gregg ,2018,0,123251,59921,63330,48.61704976
TX,Gregg ,2019,0,123945,60264,63681,48.62156602
TX,Grimes ,2015,0,27299,14901,12398,54.58441701
TX,Grimes ,2016,0,27494,14984,12510,54.49916345
TX,Grimes ,2017,0,27955,15227,12728,54.46968342
TX,Grimes ,2018,0,28291,15380,12911,54.36357852
TX,Grimes ,2019,0,28880,15713,13167,54.40789474
TX,Guadalupe ,2015,0,150578,74340,76238,49.36976185
TX,Guadalupe ,2016,0,154492,76378,78114,49.43815861
TX,Guadalupe ,2017,0,159639,79039,80600,49.51108438
TX,Guadalupe ,2018,0,163276,80789,82487,49.48002156
TX,Guadalupe ,2019,0,166847,82545,84302,49.47346971
TX,Hale ,2015,0,34034,17694,16340,51.98918728
TX,Hale ,2016,0,34107,17689,16418,51.86325388
TX,Hale ,2017,0,33954,17681,16273,52.07339341
TX,Hale ,2018,0,33631,17523,16108,52.10371384
TX,Hale ,2019,0,33406,17410,15996,52.11638628
TX,Hall ,2015,0,3094,1503,1591,48.5778927
TX,Hall ,2016,0,3113,1529,1584,49.11660777
TX,Hall ,2017,0,3042,1493,1549,49.07955293
TX,Hall ,2018,0,3025,1499,1526,49.55371901
TX,Hall ,2019,0,2964,1450,1514,48.92037787
TX,Hamilton ,2015,0,8080,4034,4046,49.92574257
TX,Hamilton ,2016,0,8237,4111,4126,49.90894743
TX,Hamilton ,2017,0,8407,4195,4212,49.89889378
TX,Hamilton ,2018,0,8477,4227,4250,49.8643388
TX,Hamilton ,2019,0,8461,4231,4230,50.00590947
TX,Hansford ,2015,0,5654,2881,2773,50.95507605
TX,Hansford ,2016,0,5592,2854,2738,51.03719599
TX,Hansford ,2017,0,5485,2804,2681,51.12123974
TX,Hansford ,2018,0,5470,2789,2681,50.98720293
TX,Hansford ,2019,0,5399,2723,2676,50.43526579
TX,Hardeman ,2015,0,3920,1946,1974,49.64285714
TX,Hardeman ,2016,0,3982,1995,1987,50.10045203
TX,Hardeman ,2017,0,3959,1998,1961,50.46728972
TX,Hardeman ,2018,0,3929,1985,1944,50.52176126
TX,Hardeman ,2019,0,3933,1986,1947,50.49580473
TX,Hardin ,2015,0,55758,27604,28154,49.50679723
TX,Hardin ,2016,0,56242,27772,28470,49.3794673
TX,Hardin ,2017,0,57117,28108,29009,49.2112681
TX,Hardin ,2018,0,57107,28120,28987,49.24089866
TX,Hardin ,2019,0,57602,28325,29277,49.1736398
TX,Harris ,2015,0,4557846,2267932,2289914,49.75885539
TX,Harris ,2016,0,4623960,2299387,2324573,49.72765768
TX,Harris ,2017,0,4657972,2314349,2343623,49.68576453
TX,Harris ,2018,0,4680045,2323805,2356240,49.65347555
TX,Harris ,2019,0,4713325,2339443,2373882,49.63466343
TX,Harrison ,2015,0,66685,32552,34133,48.81457599
TX,Harrison ,2016,0,66611,32578,34033,48.90783804
TX,Harrison ,2017,0,66468,32569,33899,48.99951857
TX,Harrison ,2018,0,66584,32661,33923,49.05232488
TX,Harrison ,2019,0,66553,32613,33940,49.0030502
TX,Hartley ,2015,0,5702,3365,2337,59.01438092
TX,Hartley ,2016,0,5740,3419,2321,59.56445993
TX,Hartley ,2017,0,5716,3412,2304,59.69209237
TX,Hartley ,2018,0,5611,3357,2254,59.8289075
TX,Hartley ,2019,0,5576,3355,2221,60.16857963
TX,Haskell ,2015,0,5821,3107,2714,53.37570864
TX,Haskell ,2016,0,5751,3060,2691,53.20813772
TX,Haskell ,2017,0,5699,3036,2663,53.27250395
TX,Haskell ,2018,0,5699,3039,2660,53.32514476
TX,Haskell ,2019,0,5658,2999,2659,53.00459526
TX,Hays ,2015,0,194662,96906,97756,49.78167285
TX,Hays ,2016,0,204546,101810,102736,49.77364505
TX,Hays ,2017,0,214726,106800,107926,49.73780539
TX,Hays ,2018,0,222706,110732,111974,49.72115704
TX,Hays ,2019,0,230191,114298,115893,49.65354857
TX,Hemphill ,2015,0,4277,2165,2112,50.61959317
TX,Hemphill ,2016,0,4101,2027,2074,49.42696903
TX,Hemphill ,2017,0,3929,1968,1961,50.08908119
TX,Hemphill ,2018,0,3845,1925,1920,50.06501951
TX,Hemphill ,2019,0,3819,1905,1914,49.88216811
TX,Henderson ,2015,0,79492,38782,40710,48.78729935
TX,Henderson ,2016,0,80062,39121,40941,48.86338088
TX,Henderson ,2017,0,80954,39552,41402,48.85737579
TX,Henderson ,2018,0,82103,40158,41945,48.91173282
TX,Henderson ,2019,0,82737,40514,42223,48.96720935
TX,Hidalgo ,2015,0,839667,410016,429651,48.83078649
TX,Hidalgo ,2016,0,848960,415188,433772,48.90548436
TX,Hidalgo ,2017,0,856249,419211,437038,48.95900608
TX,Hidalgo ,2018,0,862298,422472,439826,48.99373534
TX,Hidalgo ,2019,0,868707,426020,442687,49.04070072
TX,Hill ,2015,0,34828,17229,17599,49.46881819
TX,Hill ,2016,0,35102,17447,17655,49.70372059
TX,Hill ,2017,0,35703,17795,17908,49.84174999
TX,Hill ,2018,0,36165,18023,18142,49.83547629
TX,Hill ,2019,0,36649,18208,18441,49.68211957
TX,Hockley ,2015,0,23310,11590,11720,49.72114972
TX,Hockley ,2016,0,23043,11463,11580,49.74612681
TX,Hockley ,2017,0,22977,11468,11509,49.91078035
TX,Hockley ,2018,0,22971,11442,11529,49.8106308
TX,Hockley ,2019,0,23021,11476,11545,49.85013683
TX,Hood ,2015,0,55227,27101,28126,49.07201188
TX,Hood ,2016,0,56569,27755,28814,49.06397497
TX,Hood ,2017,0,57973,28511,29462,49.17979059
TX,Hood ,2018,0,60177,29415,30762,48.88080164
TX,Hood ,2019,0,61643,30043,31600,48.73708288
TX,Hopkins ,2015,0,35973,17744,18229,49.3258833
TX,Hopkins ,2016,0,36184,17765,18419,49.09628565
TX,Hopkins ,2017,0,36451,17943,18508,49.22498697
TX,Hopkins ,2018,0,36738,18079,18659,49.2106266
TX,Hopkins ,2019,0,37084,18259,18825,49.23686765
TX,Houston ,2015,0,22747,12131,10616,53.33010946
TX,Houston ,2016,0,22897,12240,10657,53.45678473
TX,Houston ,2017,0,23089,12387,10702,53.64892373
TX,Houston ,2018,0,23068,12345,10723,53.51569273
TX,Houston ,2019,0,22968,12294,10674,53.52664577
TX,Howard ,2015,0,37123,21191,15932,57.08320987
TX,Howard ,2016,0,36214,20537,15677,56.71011211
TX,Howard ,2017,0,35817,20406,15411,56.97294581
TX,Howard ,2018,0,35925,20452,15473,56.92971468
TX,Howard ,2019,0,36664,20951,15713,57.14324678
TX,Hudspeth ,2015,0,3541,1830,1711,51.68031629
TX,Hudspeth ,2016,0,4254,2234,2020,52.51527974
TX,Hudspeth ,2017,0,4604,2444,2160,53.08427454
TX,Hudspeth ,2018,0,4788,2540,2248,53.04928989
TX,Hudspeth ,2019,0,4886,2594,2292,53.09046255
TX,Hunt ,2015,0,89670,44261,45409,49.3598751
TX,Hunt ,2016,0,91895,45370,46525,49.37156537
TX,Hunt ,2017,0,94046,46263,47783,49.19188482
TX,Hunt ,2018,0,96606,47521,49085,49.19052647
TX,Hunt ,2019,0,98594,48534,50060,49.22611924
TX,Hutchinson ,2015,0,21793,10916,10877,50.08947827
TX,Hutchinson ,2016,0,21528,10835,10693,50.32980305
TX,Hutchinson ,2017,0,21343,10712,10631,50.18975777
TX,Hutchinson ,2018,0,21119,10623,10496,50.30067712
TX,Hutchinson ,2019,0,20938,10583,10355,50.54446461
TX,Irion ,2015,0,1543,796,747,51.58781594
TX,Irion ,2016,0,1562,798,764,51.08834827
TX,Irion ,2017,0,1512,767,745,50.72751323
TX,Irion ,2018,0,1516,772,744,50.92348285
TX,Irion ,2019,0,1536,781,755,50.84635417
TX,Jack ,2015,0,8883,5000,3883,56.28729033
TX,Jack ,2016,0,8789,4951,3838,56.33177836
TX,Jack ,2017,0,8828,4966,3862,56.2528319
TX,Jack ,2018,0,8825,4968,3857,56.29461756
TX,Jack ,2019,0,8935,5047,3888,56.48573027
TX,Jackson ,2015,0,14808,7338,7470,49.55429498
TX,Jackson ,2016,0,14873,7380,7493,49.62011699
TX,Jackson ,2017,0,14806,7342,7464,49.58800486
TX,Jackson ,2018,0,14834,7351,7483,49.55507618
TX,Jackson ,2019,0,14760,7345,7415,49.76287263
TX,Jasper ,2015,0,35266,17447,17819,49.47257982
TX,Jasper ,2016,0,35417,17467,17950,49.31812406
TX,Jasper ,2017,0,35549,17615,17934,49.55132353
TX,Jasper ,2018,0,35769,17679,18090,49.42548016
TX,Jasper ,2019,0,35529,17578,17951,49.4750767
TX,Jeff Davis ,2015,0,2199,1128,1071,51.29604366
TX,Jeff Davis ,2016,0,2231,1134,1097,50.82922456
TX,Jeff Davis ,2017,0,2260,1162,1098,51.4159292
TX,Jeff Davis ,2018,0,2243,1156,1087,51.53811859
TX,Jeff Davis ,2019,0,2274,1164,1110,51.18733509
TX,Jefferson ,2015,0,255112,130661,124451,51.21711248
TX,Jefferson ,2016,0,255748,130938,124810,51.19805433
TX,Jefferson ,2017,0,256041,131170,124871,51.23007643
TX,Jefferson ,2018,0,253234,129343,123891,51.07647472
TX,Jefferson ,2019,0,251565,128629,122936,51.13151671
TX,Jim Hogg ,2015,0,5296,2677,2619,50.54758308
TX,Jim Hogg ,2016,0,5257,2663,2594,50.65626783
TX,Jim Hogg ,2017,0,5212,2659,2553,51.01688411
TX,Jim Hogg ,2018,0,5192,2660,2532,51.23266564
TX,Jim Hogg ,2019,0,5200,2666,2534,51.26923077
TX,Jim Wells ,2015,0,41523,20414,21109,49.16311442
TX,Jim Wells ,2016,0,41181,20309,20872,49.31643234
TX,Jim Wells ,2017,0,40920,20223,20697,49.42082111
TX,Jim Wells ,2018,0,40756,20186,20570,49.52890372
TX,Jim Wells ,2019,0,40482,20086,20396,49.61711378
TX,Johnson ,2015,0,159345,79440,79905,49.85409018
TX,Johnson ,2016,0,162763,81302,81461,49.95115598
TX,Johnson ,2017,0,167012,83451,83561,49.96706823
TX,Johnson ,2018,0,171121,85464,85657,49.94360716
TX,Johnson ,2019,0,175817,87897,87920,49.99345911
TX,Jones ,2015,0,19966,12577,7389,62.99208655
TX,Jones ,2016,0,19971,12563,7408,62.90621401
TX,Jones ,2017,0,19827,12431,7396,62.69733192
TX,Jones ,2018,0,19866,12474,7392,62.79069767
TX,Jones ,2019,0,20083,12602,7481,62.7495892
TX,Karnes ,2015,0,15413,9109,6304,59.09946149
TX,Karnes ,2016,0,15494,9129,6365,58.91958177
TX,Karnes ,2017,0,15556,9171,6385,58.95474415
TX,Karnes ,2018,0,15660,9178,6482,58.60791826
TX,Karnes ,2019,0,15601,9136,6465,58.5603487
TX,Kaufman ,2015,0,114055,56049,58006,49.14208058
TX,Kaufman ,2016,0,117904,58069,59835,49.25108563
TX,Kaufman ,2017,0,122628,60364,62264,49.22529928
TX,Kaufman ,2018,0,128279,63121,65158,49.20602749
TX,Kaufman ,2019,0,136154,67120,69034,49.29711944
TX,Kendall ,2015,0,39938,19495,20443,48.8131604
TX,Kendall ,2016,0,41903,20465,21438,48.83898528
TX,Kendall ,2017,0,43969,21516,22453,48.93447656
TX,Kendall ,2018,0,45603,22340,23263,48.98800518
TX,Kendall ,2019,0,47431,23250,24181,49.01857435
TX,Kenedy ,2015,0,441,228,213,51.70068027
TX,Kenedy ,2016,0,436,221,215,50.68807339
TX,Kenedy ,2017,0,427,222,205,51.99063232
TX,Kenedy ,2018,0,437,226,211,51.71624714
TX,Kenedy ,2019,0,404,212,192,52.47524752
TX,Kent ,2015,0,747,354,393,47.38955823
TX,Kent ,2016,0,748,364,384,48.6631016
TX,Kent ,2017,0,759,373,386,49.14361001
TX,Kent ,2018,0,726,362,364,49.86225895
TX,Kent ,2019,0,762,388,374,50.91863517
TX,Kerr ,2015,0,50880,24599,26281,48.34709119
TX,Kerr ,2016,0,51426,24825,26601,48.273247
TX,Kerr ,2017,0,51892,24992,26900,48.16156633
TX,Kerr ,2018,0,52415,25220,27195,48.11599733
TX,Kerr ,2019,0,52600,25326,27274,48.14828897
TX,Kimble ,2015,0,4391,2177,2214,49.57868367
TX,Kimble ,2016,0,4413,2185,2228,49.51280308
TX,Kimble ,2017,0,4385,2157,2228,49.19042189
TX,Kimble ,2018,0,4338,2131,2207,49.12402029
TX,Kimble ,2019,0,4337,2126,2211,49.02005995
TX,King ,2015,0,282,139,143,49.29078014
TX,King ,2016,0,292,143,149,48.97260274
TX,King ,2017,0,289,144,145,49.82698962
TX,King ,2018,0,276,138,138,50
TX,King ,2019,0,272,136,136,50
TX,Kinney ,2015,0,3589,1987,1602,55.36361103
TX,Kinney ,2016,0,3636,1998,1638,54.95049505
TX,Kinney ,2017,0,3711,2042,1669,55.02559957
TX,Kinney ,2018,0,3692,2028,1664,54.92957746
TX,Kinney ,2019,0,3667,2012,1655,54.8677393
TX,Kleberg ,2015,0,31413,16087,15326,51.21128195
TX,Kleberg ,2016,0,31304,15988,15316,51.07334526
TX,Kleberg ,2017,0,30752,15680,15072,50.98855359
TX,Kleberg ,2018,0,30722,15634,15088,50.88861402
TX,Kleberg ,2019,0,30680,15592,15088,50.82138201
TX,Knox ,2015,0,3792,1882,1910,49.63080169
TX,Knox ,2016,0,3732,1847,1885,49.4908896
TX,Knox ,2017,0,3674,1825,1849,49.67338051
TX,Knox ,2018,0,3662,1800,1862,49.15346805
TX,Knox ,2019,0,3664,1792,1872,48.90829694
TX,Lamar ,2015,0,49373,23788,25585,48.18017945
TX,Lamar ,2016,0,49528,23888,25640,48.23130351
TX,Lamar ,2017,0,49568,23902,25666,48.22062621
TX,Lamar ,2018,0,49729,23999,25730,48.25956685
TX,Lamar ,2019,0,49859,23999,25860,48.13373714
TX,Lamb ,2015,0,13259,6566,6693,49.52108002
TX,Lamb ,2016,0,13195,6547,6648,49.61727927
TX,Lamb ,2017,0,13165,6518,6647,49.51006457
TX,Lamb ,2018,0,13103,6500,6603,49.60696024
TX,Lamb ,2019,0,12893,6395,6498,49.60055844
TX,Lampasas ,2015,0,20362,9995,10367,49.08653374
TX,Lampasas ,2016,0,20524,10087,10437,49.1473397
TX,Lampasas ,2017,0,20861,10247,10614,49.12036815
TX,Lampasas ,2018,0,21134,10435,10699,49.37541402
TX,Lampasas ,2019,0,21428,10526,10902,49.12264327
TX,La Salle ,2015,0,7637,4514,3123,59.10697918
TX,La Salle ,2016,0,7596,4504,3092,59.29436546
TX,La Salle ,2017,0,7530,4435,3095,58.89774236
TX,La Salle ,2018,0,7493,4424,3069,59.04177232
TX,La Salle ,2019,0,7520,4425,3095,58.84308511
TX,Lavaca ,2015,0,19919,9721,10198,48.80265074
TX,Lavaca ,2016,0,19891,9742,10149,48.97692424
TX,Lavaca ,2017,0,20028,9788,10240,48.87157979
TX,Lavaca ,2018,0,20114,9813,10301,48.78691459
TX,Lavaca ,2019,0,20154,9863,10291,48.93817604
TX,Lee ,2015,0,16868,8433,8435,49.99407161
TX,Lee ,2016,0,16975,8524,8451,50.21502209
TX,Lee ,2017,0,17109,8612,8497,50.33608043
TX,Lee ,2018,0,17097,8592,8505,50.2544306
TX,Lee ,2019,0,17239,8678,8561,50.33934683
TX,Leon ,2015,0,17028,8498,8530,49.90603712
TX,Leon ,2016,0,17200,8601,8599,50.00581395
TX,Leon ,2017,0,17235,8593,8642,49.8578474
TX,Leon ,2018,0,17260,8586,8674,49.74507532
TX,Leon ,2019,0,17404,8654,8750,49.72420133
TX,Liberty ,2015,0,79537,39248,40289,49.34558759
TX,Liberty ,2016,0,81354,40164,41190,49.36942252
TX,Liberty ,2017,0,83597,41299,42298,49.40249052
TX,Liberty ,2018,0,85802,42449,43353,49.47320575
TX,Liberty ,2019,0,88219,43574,44645,49.39298791
TX,Limestone ,2015,0,23442,12047,11395,51.39066633
TX,Limestone ,2016,0,23472,12040,11432,51.29516019
TX,Limestone ,2017,0,23391,11996,11395,51.28468214
TX,Limestone ,2018,0,23343,11987,11356,51.35158292
TX,Limestone ,2019,0,23437,12034,11403,51.34616205
TX,Lipscomb ,2015,0,3559,1846,1713,51.86850239
TX,Lipscomb ,2016,0,3494,1814,1680,51.91757298
TX,Lipscomb ,2017,0,3364,1731,1633,51.45659929
TX,Lipscomb ,2018,0,3342,1717,1625,51.3764213
TX,Lipscomb ,2019,0,3233,1653,1580,51.12898237
TX,Live Oak ,2015,0,12173,6582,5591,54.07048386
TX,Live Oak ,2016,0,12023,6532,5491,54.32920236
TX,Live Oak ,2017,0,12146,6618,5528,54.48707393
TX,Live Oak ,2018,0,12148,6668,5480,54.88969378
TX,Live Oak ,2019,0,12207,6705,5502,54.92750061
TX,Llano ,2015,0,20081,9750,10331,48.5533589
TX,Llano ,2016,0,20592,9973,10619,48.43142968
TX,Llano ,2017,0,21167,10265,10902,48.49529929
TX,Llano ,2018,0,21600,10470,11130,48.47222222
TX,Llano ,2019,0,21795,10558,11237,48.44230328
TX,Loving ,2015,0,119,69,50,57.98319328
TX,Loving ,2016,0,117,65,52,55.55555556
TX,Loving ,2017,0,133,70,63,52.63157895
TX,Loving ,2018,0,148,80,68,54.05405405
TX,Loving ,2019,0,169,98,71,57.98816568
TX,Lubbock ,2015,0,298337,147330,151007,49.38375059
TX,Lubbock ,2016,0,302094,149036,153058,49.33431316
TX,Lubbock ,2017,0,305413,150637,154776,49.32239296
TX,Lubbock ,2018,0,307627,151566,156061,49.26940743
TX,Lubbock ,2019,0,310569,153010,157559,49.26763457
TX,Lynn ,2015,0,5746,2942,2804,51.20083536
TX,Lynn ,2016,0,5775,2950,2825,51.08225108
TX,Lynn ,2017,0,5832,2974,2858,50.99451303
TX,Lynn ,2018,0,5848,2982,2866,50.99179207
TX,Lynn ,2019,0,5951,3051,2900,51.26869434
TX,McCulloch ,2015,0,8255,4146,4109,50.2241066
TX,McCulloch ,2016,0,8124,4079,4045,50.20925652
TX,McCulloch ,2017,0,7941,3989,3952,50.23296814
TX,McCulloch ,2018,0,7982,4009,3973,50.22550739
TX,McCulloch ,2019,0,7984,4023,3961,50.38827655
TX,McLennan ,2015,0,245444,119832,125612,48.82254201
TX,McLennan ,2016,0,247553,120865,126688,48.82388822
TX,McLennan ,2017,0,251631,122752,128879,48.78254269
TX,McLennan ,2018,0,254196,124089,130107,48.81626776
TX,McLennan ,2019,0,256623,125261,131362,48.81129127
TX,McMullen ,2015,0,828,444,384,53.62318841
TX,McMullen ,2016,0,806,417,389,51.7369727
TX,McMullen ,2017,0,765,399,366,52.15686275
TX,McMullen ,2018,0,731,386,345,52.80437756
TX,McMullen ,2019,0,743,392,351,52.75908479
TX,Madison ,2015,0,13968,8009,5959,57.3382016
TX,Madison ,2016,0,14120,8116,6004,57.47875354
TX,Madison ,2017,0,14251,8179,6072,57.39246369
TX,Madison ,2018,0,14363,8231,6132,57.3069693
TX,Madison ,2019,0,14284,8226,6058,57.58891067
TX,Marion ,2015,0,10136,4952,5184,48.85556433
TX,Marion ,2016,0,10125,4931,5194,48.70123457
TX,Marion ,2017,0,10057,4881,5176,48.53335985
TX,Marion ,2018,0,9915,4831,5084,48.72415532
TX,Marion ,2019,0,9854,4836,5018,49.07651715
TX,Martin ,2015,0,5646,2879,2767,50.99185264
TX,Martin ,2016,0,5616,2849,2767,50.73005698
TX,Martin ,2017,0,5531,2814,2717,50.87687579
TX,Martin ,2018,0,5681,2876,2805,50.62488998
TX,Martin ,2019,0,5771,2896,2875,50.1819442
TX,Mason ,2015,0,4057,2045,2012,50.40670446
TX,Mason ,2016,0,4161,2104,2057,50.56476808
TX,Mason ,2017,0,4179,2120,2059,50.72983967
TX,Mason ,2018,0,4259,2149,2110,50.45785396
TX,Mason ,2019,0,4274,2186,2088,51.14646701
TX,Matagorda ,2015,0,36766,18425,18341,50.11423598
TX,Matagorda ,2016,0,37088,18644,18444,50.26962899
TX,Matagorda ,2017,0,36805,18511,18294,50.2947969
TX,Matagorda ,2018,0,36566,18412,18154,50.35278674
TX,Matagorda ,2019,0,36643,18425,18218,50.28245504
TX,Maverick ,2015,0,57720,28685,29035,49.6968122
TX,Maverick ,2016,0,58041,28915,29126,49.81823194
TX,Maverick ,2017,0,58111,28982,29129,49.87351792
TX,Maverick ,2018,0,58276,29089,29187,49.91591736
TX,Maverick ,2019,0,58722,29442,29280,50.13793808
TX,Medina ,2015,0,48402,25092,23310,51.84083302
TX,Medina ,2016,0,49254,25530,23724,51.83335364
TX,Medina ,2017,0,50183,25938,24245,51.68682622
TX,Medina ,2018,0,50862,26263,24599,51.63579883
TX,Medina ,2019,0,51584,26629,24955,51.62259615
TX,Menard ,2015,0,2134,1053,1081,49.34395501
TX,Menard ,2016,0,2091,1049,1042,50.16738403
TX,Menard ,2017,0,2110,1054,1056,49.95260664
TX,Menard ,2018,0,2120,1058,1062,49.90566038
TX,Menard ,2019,0,2138,1066,1072,49.85968195
TX,Midland ,2015,0,162328,81637,80691,50.29138534
TX,Midland ,2016,0,163850,82315,81535,50.23802258
TX,Midland ,2017,0,165318,83105,82213,50.26978308
TX,Midland ,2018,0,172505,87120,85385,50.50288397
TX,Midland ,2019,0,176832,89761,87071,50.76060894
TX,Milam ,2015,0,24362,11967,12395,49.12158279
TX,Milam ,2016,0,24680,12115,12565,49.08833063
TX,Milam ,2017,0,24939,12221,12718,49.00356871
TX,Milam ,2018,0,25045,12350,12695,49.31123977
TX,Milam ,2019,0,24823,12255,12568,49.36953632
TX,Mills ,2015,0,4889,2405,2484,49.19206382
TX,Mills ,2016,0,4884,2420,2464,49.54954955
TX,Mills ,2017,0,4917,2435,2482,49.5220663
TX,Mills ,2018,0,4883,2441,2442,49.98976039
TX,Mills ,2019,0,4873,2436,2437,49.98973938
TX,Mitchell ,2015,0,8856,5313,3543,59.99322493
TX,Mitchell ,2016,0,8474,5011,3463,59.1338211
TX,Mitchell ,2017,0,8215,4772,3443,58.08886184
TX,Mitchell ,2018,0,8525,5159,3366,60.51612903
TX,Mitchell ,2019,0,8545,5176,3369,60.57343476
TX,Montague ,2015,0,19252,9465,9787,49.16372325
TX,Montague ,2016,0,19390,9504,9886,49.01495616
TX,Montague ,2017,0,19399,9555,9844,49.25511624
TX,Montague ,2018,0,19584,9603,9981,49.03492647
TX,Montague ,2019,0,19818,9735,10083,49.12201029
TX,Montgomery ,2015,0,535753,265498,270255,49.55604542
TX,Montgomery ,2016,0,555216,275245,279971,49.57439987
TX,Montgomery ,2017,0,571615,283151,288464,49.53526412
TX,Montgomery ,2018,0,589770,291925,297845,49.49810943
TX,Montgomery ,2019,0,607391,300569,306822,49.48525744
TX,Moore ,2015,0,21725,11312,10413,52.06904488
TX,Moore ,2016,0,21641,11228,10413,51.88299986
TX,Moore ,2017,0,21604,11221,10383,51.93945566
TX,Moore ,2018,0,21083,10926,10157,51.82374425
TX,Moore ,2019,0,20940,10861,10079,51.86723973
TX,Morris ,2015,0,12370,5941,6429,48.02748585
TX,Morris ,2016,0,12429,5988,6441,48.17764905
TX,Morris ,2017,0,12375,5956,6419,48.12929293
TX,Morris ,2018,0,12303,5906,6397,48.00455174
TX,Morris ,2019,0,12388,5947,6441,48.00613497
TX,Motley ,2015,0,1146,589,557,51.39616056
TX,Motley ,2016,0,1170,598,572,51.11111111
TX,Motley ,2017,0,1226,627,599,51.14192496
TX,Motley ,2018,0,1232,628,604,50.97402597
TX,Motley ,2019,0,1200,612,588,51
TX,Nacogdoches ,2015,0,65462,31337,34125,47.8705203
TX,Nacogdoches ,2016,0,65549,31455,34094,47.98700209
TX,Nacogdoches ,2017,0,65317,31317,34000,47.94617022
TX,Nacogdoches ,2018,0,65161,31299,33862,48.03333282
TX,Nacogdoches ,2019,0,65204,31370,33834,48.11054537
TX,Navarro ,2015,0,48181,23674,24507,49.13555136
TX,Navarro ,2016,0,48405,23789,24616,49.14574941
TX,Navarro ,2017,0,48739,23924,24815,49.0859476
TX,Navarro ,2018,0,49536,24304,25232,49.06330749
TX,Navarro ,2019,0,50113,24600,25513,49.08905873
TX,Newton ,2015,0,14158,7312,6846,51.64571267
TX,Newton ,2016,0,14160,7342,6818,51.85028249
TX,Newton ,2017,0,13908,7189,6719,51.68967501
TX,Newton ,2018,0,13751,7075,6676,51.45080358
TX,Newton ,2019,0,13595,6972,6623,51.28356013
TX,Nolan ,2015,0,15111,7550,7561,49.96360267
TX,Nolan ,2016,0,15044,7544,7500,50.1462377
TX,Nolan ,2017,0,14854,7459,7395,50.21543019
TX,Nolan ,2018,0,14799,7416,7383,50.11149402
TX,Nolan ,2019,0,14714,7342,7372,49.89805627
TX,Nueces ,2015,0,360504,178152,182352,49.41748219
TX,Nueces ,2016,0,361642,178710,182932,49.41627355
TX,Nueces ,2017,0,361235,178470,182765,49.40551165
TX,Nueces ,2018,0,362026,179012,183014,49.44727727
TX,Nueces ,2019,0,362294,179014,183280,49.41125164
TX,Ochiltree ,2015,0,10698,5463,5235,51.06561974
TX,Ochiltree ,2016,0,10257,5211,5046,50.80432875
TX,Ochiltree ,2017,0,9996,5059,4937,50.6102441
TX,Ochiltree ,2018,0,9866,4983,4883,50.506791
TX,Ochiltree ,2019,0,9836,4935,4901,50.17283449
TX,Oldham ,2015,0,2064,1084,980,52.51937984
TX,Oldham ,2016,0,2074,1084,990,52.26615236
TX,Oldham ,2017,0,2104,1093,1011,51.9486692
TX,Oldham ,2018,0,2118,1103,1015,52.07743154
TX,Oldham ,2019,0,2112,1107,1005,52.41477273
TX,Orange ,2015,0,83955,41529,42426,49.46578524
TX,Orange ,2016,0,84549,41819,42730,49.46125915
TX,Orange ,2017,0,84971,42059,42912,49.49806405
TX,Orange ,2018,0,83474,41433,42041,49.63581474
TX,Orange ,2019,0,83396,41354,42042,49.58751019
TX,Palo Pinto ,2015,0,27966,13782,14184,49.28127011
TX,Palo Pinto ,2016,0,28125,13878,14247,49.344
TX,Palo Pinto ,2017,0,28544,14051,14493,49.22575673
TX,Palo Pinto ,2018,0,28874,14214,14660,49.22767888
TX,Palo Pinto ,2019,0,29189,14338,14851,49.1212443
TX,Panola ,2015,0,23667,11682,11985,49.35986817
TX,Panola ,2016,0,23419,11544,11875,49.29330885
TX,Panola ,2017,0,23211,11434,11777,49.26112619
TX,Panola ,2018,0,23142,11450,11692,49.47714113
TX,Panola ,2019,0,23194,11509,11685,49.62059153
TX,Parker ,2015,0,125640,62497,63143,49.74291627
TX,Parker ,2016,0,128967,64121,64846,49.71892034
TX,Parker ,2017,0,133501,66454,67047,49.77790429
TX,Parker ,2018,0,138070,68708,69362,49.76316361
TX,Parker ,2019,0,142878,71181,71697,49.81942636
TX,Parmer ,2015,0,9794,5053,4741,51.59281193
TX,Parmer ,2016,0,9762,5056,4706,51.79266544
TX,Parmer ,2017,0,9710,5049,4661,51.99794027
TX,Parmer ,2018,0,9719,5042,4677,51.8777652
TX,Parmer ,2019,0,9605,4968,4637,51.72306091
TX,Pecos ,2015,0,16030,9073,6957,56.60012477
TX,Pecos ,2016,0,15881,8988,6893,56.59593225
TX,Pecos ,2017,0,15634,8850,6784,56.60739414
TX,Pecos ,2018,0,15709,8893,6816,56.61086002
TX,Pecos ,2019,0,15823,8972,6851,56.70226885
TX,Polk ,2015,0,46613,25035,21578,53.70819299
TX,Polk ,2016,0,47656,25622,22034,53.76447876
TX,Polk ,2017,0,48990,26461,22529,54.01306389
TX,Polk ,2018,0,49955,26972,22983,53.99259333
TX,Polk ,2019,0,51353,27759,23594,54.05526454
TX,Potter ,2015,0,121272,62617,58655,51.63351804
TX,Potter ,2016,0,120632,62342,58290,51.67948803
TX,Potter ,2017,0,120340,62084,58256,51.5904936
TX,Potter ,2018,0,118711,60980,57731,51.36844943
TX,Potter ,2019,0,117415,60341,57074,51.39121918
TX,Presidio ,2015,0,7057,3548,3509,50.27632138
TX,Presidio ,2016,0,7156,3632,3524,50.75461151
TX,Presidio ,2017,0,7100,3624,3476,51.04225352
TX,Presidio ,2018,0,6856,3508,3348,51.16686114
TX,Presidio ,2019,0,6704,3439,3265,51.2977327
TX,Rains ,2015,0,11136,5608,5528,50.3591954
TX,Rains ,2016,0,11304,5648,5656,49.9646143
TX,Rains ,2017,0,11730,5847,5883,49.84654731
TX,Rains ,2018,0,12147,6053,6094,49.83123405
TX,Rains ,2019,0,12514,6250,6264,49.94406265
TX,Randall ,2015,0,130368,63972,66396,49.07032401
TX,Randall ,2016,0,132342,64918,67424,49.05321062
TX,Randall ,2017,0,134015,65886,68129,49.16315338
TX,Randall ,2018,0,135691,66656,69035,49.12337591
TX,Randall ,2019,0,137713,67567,70146,49.06363234
TX,Reagan ,2015,0,3807,1997,1810,52.4560021
TX,Reagan ,2016,0,3726,1969,1757,52.84487386
TX,Reagan ,2017,0,3712,1977,1735,53.25969828
TX,Reagan ,2018,0,3736,1991,1745,53.29229122
TX,Reagan ,2019,0,3849,2056,1793,53.41647181
TX,Real ,2015,0,3297,1648,1649,49.9848347
TX,Real ,2016,0,3399,1706,1693,50.19123272
TX,Real ,2017,0,3417,1706,1711,49.92683641
TX,Real ,2018,0,3477,1724,1753,49.58297383
TX,Real ,2019,0,3452,1705,1747,49.39165701
TX,Red River ,2015,0,12345,6050,6295,49.00769542
TX,Red River ,2016,0,12179,5971,6208,49.02701371
TX,Red River ,2017,0,12164,5944,6220,48.86550477
TX,Red River ,2018,0,12143,5909,6234,48.66178045
TX,Red River ,2019,0,12023,5840,6183,48.57356733
TX,Reeves ,2015,0,15574,9712,5862,62.36034416
TX,Reeves ,2016,0,15229,9344,5885,61.35662223
TX,Reeves ,2017,0,15166,9258,5908,61.04444151
TX,Reeves ,2018,0,15513,9497,6016,61.21962225
TX,Reeves ,2019,0,15976,9771,6205,61.16049074
TX,Refugio ,2015,0,7326,3603,3723,49.18099918
TX,Refugio ,2016,0,7272,3563,3709,48.99614961
TX,Refugio ,2017,0,7180,3518,3662,48.99721448
TX,Refugio ,2018,0,7000,3445,3555,49.21428571
TX,Refugio ,2019,0,6948,3436,3512,49.45308002
TX,Roberts ,2015,0,910,462,448,50.76923077
TX,Roberts ,2016,0,910,460,450,50.54945055
TX,Roberts ,2017,0,941,474,467,50.37194474
TX,Roberts ,2018,0,898,447,451,49.77728285
TX,Roberts ,2019,0,854,423,431,49.53161593
TX,Robertson ,2015,0,16698,8198,8500,49.09570008
TX,Robertson ,2016,0,16804,8246,8558,49.07164961
TX,Robertson ,2017,0,17153,8427,8726,49.12843234
TX,Robertson ,2018,0,17219,8441,8778,49.02142982
TX,Robertson ,2019,0,17074,8396,8678,49.17418297
TX,Rockwall ,2015,0,90170,44413,45757,49.25474104
TX,Rockwall ,2016,0,93421,46057,47364,49.30047848
TX,Rockwall ,2017,0,96824,47839,48985,49.40820458
TX,Rockwall ,2018,0,100546,49707,50839,49.43707358
TX,Rockwall ,2019,0,104915,51816,53099,49.38855264
TX,Runnels ,2015,0,10387,5204,5183,50.1010879
TX,Runnels ,2016,0,10276,5186,5090,50.46710782
TX,Runnels ,2017,0,10282,5219,5063,50.75860727
TX,Runnels ,2018,0,10178,5167,5011,50.76635881
TX,Runnels ,2019,0,10264,5201,5063,50.67225253
TX,Rusk ,2015,0,52965,27835,25130,52.55357311
TX,Rusk ,2016,0,52892,27828,25064,52.61287151
TX,Rusk ,2017,0,54213,29134,25079,53.73987789
TX,Rusk ,2018,0,54301,29264,25037,53.89219351
TX,Rusk ,2019,0,54406,29236,25170,53.73672021
TX,Sabine ,2015,0,10440,5169,5271,49.51149425
TX,Sabine ,2016,0,10381,5146,5235,49.57133224
TX,Sabine ,2017,0,10417,5111,5306,49.06402995
TX,Sabine ,2018,0,10576,5198,5378,49.14901664
TX,Sabine ,2019,0,10542,5160,5382,48.94706887
TX,San Augustine ,2015,0,8349,4042,4307,48.41298359
TX,San Augustine ,2016,0,8288,4064,4224,49.03474903
TX,San Augustine ,2017,0,8302,4090,4212,49.26523729
TX,San Augustine ,2018,0,8254,4060,4194,49.18827235
TX,San Augustine ,2019,0,8237,4061,4176,49.30193031
TX,San Jacinto ,2015,0,27361,13663,13698,49.93604035
TX,San Jacinto ,2016,0,27732,13833,13899,49.88100389
TX,San Jacinto ,2017,0,28231,14073,14158,49.84945627
TX,San Jacinto ,2018,0,28717,14268,14449,49.68485566
TX,San Jacinto ,2019,0,28859,14367,14492,49.78342978
TX,San Patricio ,2015,0,67117,33578,33539,50.02905374
TX,San Patricio ,2016,0,67311,33765,33546,50.16267772
TX,San Patricio ,2017,0,67210,33752,33458,50.21871745
TX,San Patricio ,2018,0,66671,33574,33097,50.35772675
TX,San Patricio ,2019,0,66730,33647,33083,50.42259853
TX,San Saba ,2015,0,5922,3186,2736,53.7993921
TX,San Saba ,2016,0,5922,3215,2707,54.28909152
TX,San Saba ,2017,0,5996,3260,2736,54.36957972
TX,San Saba ,2018,0,6060,3292,2768,54.32343234
TX,San Saba ,2019,0,6055,3280,2775,54.17010735
TX,Schleicher ,2015,0,3195,1618,1577,50.64162754
TX,Schleicher ,2016,0,3057,1535,1522,50.21262676
TX,Schleicher ,2017,0,2989,1488,1501,49.78253597
TX,Schleicher ,2018,0,2880,1425,1455,49.47916667
TX,Schleicher ,2019,0,2793,1386,1407,49.62406015
TX,Scurry ,2015,0,17570,9489,8081,54.00682982
TX,Scurry ,2016,0,17394,9387,8007,53.96688513
TX,Scurry ,2017,0,17003,9183,7820,54.00811621
TX,Scurry ,2018,0,16812,9085,7727,54.03878182
TX,Scurry ,2019,0,16703,9028,7675,54.05017063
TX,Shackelford ,2015,0,3333,1599,1734,47.97479748
TX,Shackelford ,2016,0,3337,1607,1730,48.15702727
TX,Shackelford ,2017,0,3289,1582,1707,48.09972636
TX,Shackelford ,2018,0,3256,1579,1677,48.495086
TX,Shackelford ,2019,0,3265,1595,1670,48.85145482
TX,Shelby ,2015,0,25373,12574,12799,49.5566153
TX,Shelby ,2016,0,25566,12666,12900,49.54236095
TX,Shelby ,2017,0,25225,12540,12685,49.71258672
TX,Shelby ,2018,0,25307,12571,12736,49.67400324
TX,Shelby ,2019,0,25274,12536,12738,49.60037984
TX,Sherman ,2015,0,3058,1575,1483,51.50425114
TX,Sherman ,2016,0,3070,1581,1489,51.49837134
TX,Sherman ,2017,0,3046,1580,1466,51.87130663
TX,Sherman ,2018,0,3101,1613,1488,52.01547888
TX,Sherman ,2019,0,3022,1576,1446,52.15089345
TX,Smith ,2015,0,222390,107370,115020,48.28004856
TX,Smith ,2016,0,225161,108649,116512,48.25391609
TX,Smith ,2017,0,227195,109629,117566,48.25326262
TX,Smith ,2018,0,229749,110885,118864,48.26353978
TX,Smith ,2019,0,232751,112259,120492,48.23137172
TX,Somervell ,2015,0,8618,4224,4394,49.01369227
TX,Somervell ,2016,0,8671,4233,4438,48.81789874
TX,Somervell ,2017,0,8855,4348,4507,49.10220215
TX,Somervell ,2018,0,9030,4448,4582,49.25802879
TX,Somervell ,2019,0,9128,4508,4620,49.38650307
TX,Starr ,2015,0,63484,30857,32627,48.60594796
TX,Starr ,2016,0,63894,31057,32837,48.60706796
TX,Starr ,2017,0,64130,31195,32935,48.64338063
TX,Starr ,2018,0,64249,31268,32981,48.66690532
TX,Starr ,2019,0,64633,31537,33096,48.79395974
TX,Stephens ,2015,0,9385,4922,4463,52.44539158
TX,Stephens ,2016,0,9377,4932,4445,52.59677935
TX,Stephens ,2017,0,9287,4904,4383,52.80499623
TX,Stephens ,2018,0,9405,4955,4450,52.68474216
TX,Stephens ,2019,0,9366,4932,4434,52.65855221
TX,Sterling ,2015,0,1333,669,664,50.18754689
TX,Sterling ,2016,0,1339,677,662,50.56011949
TX,Sterling ,2017,0,1287,650,637,50.50505051
TX,Sterling ,2018,0,1304,663,641,50.84355828
TX,Sterling ,2019,0,1291,653,638,50.580945
TX,Stonewall ,2015,0,1398,661,737,47.28183119
TX,Stonewall ,2016,0,1401,666,735,47.53747323
TX,Stonewall ,2017,0,1376,659,717,47.89244186
TX,Stonewall ,2018,0,1352,658,694,48.66863905
TX,Stonewall ,2019,0,1350,658,692,48.74074074
TX,Sutton ,2015,0,3915,1967,1948,50.24265645
TX,Sutton ,2016,0,3886,1986,1900,51.10653628
TX,Sutton ,2017,0,3792,1935,1857,51.02848101
TX,Sutton ,2018,0,3752,1914,1838,51.01279318
TX,Sutton ,2019,0,3776,1928,1848,51.05932203
TX,Swisher ,2015,0,7477,3949,3528,52.81530025
TX,Swisher ,2016,0,7428,3955,3473,53.24448034
TX,Swisher ,2017,0,7446,3973,3473,53.35750739
TX,Swisher ,2018,0,7413,3945,3468,53.21732092
TX,Swisher ,2019,0,7397,3955,3442,53.46762201
TX,Tarrant ,2015,0,1984880,971793,1013087,48.95978598
TX,Tarrant ,2016,0,2023556,990596,1032960,48.95322887
TX,Tarrant ,2017,0,2056451,1006144,1050307,48.92623262
TX,Tarrant ,2018,0,2081446,1017750,1063696,48.89629613
TX,Tarrant ,2019,0,2102515,1027836,1074679,48.88602459
TX,Taylor ,2015,0,136133,66626,69507,48.94184364
TX,Taylor ,2016,0,136257,66677,69580,48.93473363
TX,Taylor ,2017,0,136634,66805,69829,48.89339403
TX,Taylor ,2018,0,137294,66960,70334,48.77125002
TX,Taylor ,2019,0,138034,67130,70904,48.63294551
TX,Terrell ,2015,0,867,457,410,52.71049596
TX,Terrell ,2016,0,818,415,403,50.73349633
TX,Terrell ,2017,0,814,407,407,50
TX,Terrell ,2018,0,810,409,401,50.49382716
TX,Terrell ,2019,0,776,391,385,50.38659794
TX,Terry ,2015,0,12759,6759,6000,52.97437103
TX,Terry ,2016,0,12770,6750,6020,52.85826155
TX,Terry ,2017,0,12429,6504,5925,52.32923003
TX,Terry ,2018,0,12344,6486,5858,52.54374595
TX,Terry ,2019,0,12337,6506,5831,52.73567318
TX,Throckmorton ,2015,0,1559,762,797,48.87748557
TX,Throckmorton ,2016,0,1537,738,799,48.01561483
TX,Throckmorton ,2017,0,1510,720,790,47.68211921
TX,Throckmorton ,2018,0,1504,708,796,47.07446809
TX,Throckmorton ,2019,0,1501,718,783,47.83477682
TX,Titus ,2015,0,32626,16068,16558,49.24906516
TX,Titus ,2016,0,32463,15979,16484,49.22219142
TX,Titus ,2017,0,32619,16092,16527,49.33321071
TX,Titus ,2018,0,32743,16076,16667,49.09751703
TX,Titus ,2019,0,32750,16045,16705,48.99236641
TX,Tom Green ,2015,0,117514,58362,59152,49.66386984
TX,Tom Green ,2016,0,117634,58416,59218,49.65911216
TX,Tom Green ,2017,0,117566,58444,59122,49.71165133
TX,Tom Green ,2018,0,118014,58705,59309,49.74409816
TX,Tom Green ,2019,0,119200,59315,59885,49.76090604
TX,Travis ,2015,0,1179805,594894,584911,50.42307839
TX,Travis ,2016,0,1206110,608973,597137,50.49066835
TX,Travis ,2017,0,1227585,620075,607510,50.51177719
TX,Travis ,2018,0,1246572,630166,616406,50.55191357
TX,Travis ,2019,0,1273954,643738,630216,50.5307099
TX,Trinity ,2015,0,14539,7086,7453,48.73787743
TX,Trinity ,2016,0,14543,7052,7491,48.4906828
TX,Trinity ,2017,0,14677,7113,7564,48.46358248
TX,Trinity ,2018,0,14688,7075,7613,48.16857298
TX,Trinity ,2019,0,14651,7040,7611,48.05132755
TX,Tyler ,2015,0,21370,11522,9848,53.91670566
TX,Tyler ,2016,0,21423,11567,9856,53.99337161
TX,Tyler ,2017,0,21517,11624,9893,54.02240089
TX,Tyler ,2018,0,21609,11677,9932,54.03766949
TX,Tyler ,2019,0,21672,11694,9978,53.95902547
TX,Upshur ,2015,0,40317,19996,20321,49.59694422
TX,Upshur ,2016,0,40771,20215,20556,49.5818106
TX,Upshur ,2017,0,41069,20366,20703,49.58971487
TX,Upshur ,2018,0,41179,20326,20853,49.36011074
TX,Upshur ,2019,0,41753,20582,21171,49.29466146
TX,Upton ,2015,0,3652,1880,1772,51.47864184
TX,Upton ,2016,0,3690,1898,1792,51.43631436
TX,Upton ,2017,0,3658,1882,1776,51.44887917
TX,Upton ,2018,0,3637,1853,1784,50.948584
TX,Upton ,2019,0,3657,1844,1813,50.42384468
TX,Uvalde ,2015,0,26949,13243,13706,49.14096998
TX,Uvalde ,2016,0,27081,13309,13772,49.14515712
TX,Uvalde ,2017,0,27043,13229,13814,48.91838923
TX,Uvalde ,2018,0,26787,13154,13633,49.10590958
TX,Uvalde ,2019,0,26741,13126,13615,49.08567368
TX,Val Verde ,2015,0,48891,24911,23980,50.95211798
TX,Val Verde ,2016,0,48911,25005,23906,51.12346916
TX,Val Verde ,2017,0,49028,25024,24004,51.04022191
TX,Val Verde ,2018,0,48988,25027,23961,51.08802156
TX,Val Verde ,2019,0,49025,25054,23971,51.1045385
TX,Van Zandt ,2015,0,53430,26184,27246,49.00617631
TX,Van Zandt ,2016,0,54367,26589,27778,48.90650578
TX,Van Zandt ,2017,0,55163,26981,28182,48.91140801
TX,Van Zandt ,2018,0,55966,27349,28617,48.86716935
TX,Van Zandt ,2019,0,56590,27633,28957,48.83018201
TX,Victoria ,2015,0,92136,45213,46923,49.07202396
TX,Victoria ,2016,0,92402,45315,47087,49.0411463
TX,Victoria ,2017,0,92045,45120,46925,49.01950133
TX,Victoria ,2018,0,91878,45003,46875,48.98125775
TX,Victoria ,2019,0,92084,45112,46972,48.99005256
TX,Walker ,2015,0,70836,41396,29440,58.4392117
TX,Walker ,2016,0,71845,41959,29886,58.40211567
TX,Walker ,2017,0,72816,42298,30518,58.08888156
TX,Walker ,2018,0,73136,42518,30618,58.13552833
TX,Walker ,2019,0,72971,42377,30594,58.07375533
TX,Waller ,2015,0,48641,24140,24501,49.62891388
TX,Waller ,2016,0,50046,24889,25157,49.73224633
TX,Waller ,2017,0,51717,25734,25983,49.75926678
TX,Waller ,2018,0,53512,26659,26853,49.81873225
TX,Waller ,2019,0,55246,27503,27743,49.7827897
TX,Ward ,2015,0,11631,5834,5797,50.15905769
TX,Ward ,2016,0,11571,5797,5774,50.0993864
TX,Ward ,2017,0,11383,5675,5708,49.855047
TX,Ward ,2018,0,11709,5880,5829,50.21778119
TX,Ward ,2019,0,11998,6082,5916,50.69178196
TX,Washington ,2015,0,34836,17218,17618,49.42588127
TX,Washington ,2016,0,34740,17085,17655,49.17962003
TX,Washington ,2017,0,34861,17151,17710,49.19824446
TX,Washington ,2018,0,35496,17419,18077,49.073135
TX,Washington ,2019,0,35882,17537,18345,48.87408729
TX,Webb ,2015,0,269865,131912,137953,48.88073666
TX,Webb ,2016,0,272301,133384,138917,48.9840287
TX,Webb ,2017,0,273691,134252,139439,49.05239851
TX,Webb ,2018,0,275120,135288,139832,49.17417854
TX,Webb ,2019,0,276652,136141,140511,49.21019909
TX,Wharton ,2015,0,41383,20331,21052,49.12886934
TX,Wharton ,2016,0,41609,20402,21207,49.0326612
TX,Wharton ,2017,0,41837,20513,21324,49.03076224
TX,Wharton ,2018,0,41499,20425,21074,49.21805345
TX,Wharton ,2019,0,41556,20413,21143,49.12166715
TX,Wheeler ,2015,0,5658,2859,2799,50.53022269
TX,Wheeler ,2016,0,5518,2779,2739,50.36245016
TX,Wheeler ,2017,0,5300,2664,2636,50.26415094
TX,Wheeler ,2018,0,5158,2607,2551,50.54284606
TX,Wheeler ,2019,0,5056,2539,2517,50.21756329
TX,Wichita ,2015,0,130961,67720,63241,51.71005108
TX,Wichita ,2016,0,131295,68037,63258,51.81994745
TX,Wichita ,2017,0,131689,68255,63434,51.83044901
TX,Wichita ,2018,0,131807,68187,63620,51.7324573
TX,Wichita ,2019,0,132230,68342,63888,51.68418664
TX,Wilbarger ,2015,0,13055,6467,6588,49.53657602
TX,Wilbarger ,2016,0,12880,6393,6487,49.63509317
TX,Wilbarger ,2017,0,12683,6267,6416,49.41259954
TX,Wilbarger ,2018,0,12777,6311,6466,49.39344134
TX,Wilbarger ,2019,0,12769,6278,6491,49.16594878
TX,Willacy ,2015,0,21863,12026,9837,55.00617482
TX,Willacy ,2016,0,21761,12015,9746,55.21345526
TX,Willacy ,2017,0,21508,11910,9598,55.37474428
TX,Willacy ,2018,0,21450,11881,9569,55.38927739
TX,Willacy ,2019,0,21358,11817,9541,55.32821425
TX,Williamson ,2015,0,507133,249380,257753,49.17447691
TX,Williamson ,2016,0,527622,259597,268025,49.20132216
TX,Williamson ,2017,0,546251,268965,277286,49.2383538
TX,Williamson ,2018,0,566463,278949,287514,49.24399299
TX,Williamson ,2019,0,590551,291138,299413,49.29938312
TX,Wilson ,2015,0,47178,23701,23477,50.23739879
TX,Wilson ,2016,0,48212,24171,24041,50.13482121
TX,Wilson ,2017,0,49211,24679,24532,50.14935685
TX,Wilson ,2018,0,50196,25168,25028,50.13945334
TX,Wilson ,2019,0,51070,25632,25438,50.18993538
TX,Winkler ,2015,0,8027,4144,3883,51.62576305
TX,Winkler ,2016,0,7915,4059,3856,51.28237524
TX,Winkler ,2017,0,7605,3907,3698,51.37409599
TX,Winkler ,2018,0,7778,3976,3802,51.11853947
TX,Winkler ,2019,0,8010,4138,3872,51.66042447
TX,Wise ,2015,0,62857,31539,31318,50.17579585
TX,Wise ,2016,0,64478,32334,32144,50.14733708
TX,Wise ,2017,0,65848,33003,32845,50.11997327
TX,Wise ,2018,0,68284,34136,34148,49.99121317
TX,Wise ,2019,0,69984,35060,34924,50.09716507
TX,Wood ,2015,0,43117,21356,21761,49.53034766
TX,Wood ,2016,0,43753,21688,22065,49.5691724
TX,Wood ,2017,0,44263,22050,22213,49.8158733
TX,Wood ,2018,0,45157,22391,22766,49.58478198
TX,Wood ,2019,0,45539,22602,22937,49.6321834
TX,Yoakum ,2015,0,8644,4303,4341,49.78019435
TX,Yoakum ,2016,0,8652,4356,4296,50.34674064
TX,Yoakum ,2017,0,8557,4350,4207,50.83557321
TX,Yoakum ,2018,0,8590,4373,4217,50.9080326
TX,Yoakum ,2019,0,8713,4434,4279,50.8894755
TX,Young ,2015,0,18163,8982,9181,49.45218301
TX,Young ,2016,0,18098,8942,9156,49.40877445
TX,Young ,2017,0,17922,8855,9067,49.40854815
TX,Young ,2018,0,17986,8899,9087,49.47737129
TX,Young ,2019,0,18010,8942,9068,49.65019434
TX,Zapata ,2015,0,14493,7288,7205,50.28634513
TX,Zapata ,2016,0,14446,7230,7216,50.04845632
TX,Zapata ,2017,0,14254,7122,7132,49.96492213
TX,Zapata ,2018,0,14149,7049,7100,49.81977525
TX,Zapata ,2019,0,14179,7051,7128,49.72847168
TX,Zavala ,2015,0,12310,6211,6099,50.4549147
TX,Zavala ,2016,0,12121,6126,5995,50.54038446
TX,Zavala ,2017,0,11957,6051,5906,50.60633938
TX,Zavala ,2018,0,11969,6051,5918,50.55560197
TX,Zavala ,2019,0,11840,6028,5812,50.91216216
UT,Beaver ,2015,0,6353,3263,3090,51.36156147
UT,Beaver ,2016,0,6478,3324,3154,51.31213337
UT,Beaver ,2017,0,6421,3282,3139,51.11353372
UT,Beaver ,2018,0,6625,3381,3244,51.03396226
UT,Beaver ,2019,0,6710,3408,3302,50.78986587
UT,Box Elder ,2015,0,51826,26182,25644,50.5190445
UT,Box Elder ,2016,0,52975,26794,26181,50.5785748
UT,Box Elder ,2017,0,53977,27344,26633,50.65861385
UT,Box Elder ,2018,0,54906,27899,27007,50.81229738
UT,Box Elder ,2019,0,56046,28576,27470,50.98668951
UT,Cache ,2015,0,119697,59913,59784,50.05388606
UT,Cache ,2016,0,122201,61257,60944,50.12806769
UT,Cache ,2017,0,124236,62250,61986,50.1062494
UT,Cache ,2018,0,126400,63226,63174,50.02056962
UT,Cache ,2019,0,128289,64178,64111,50.02611292
UT,Carbon ,2015,0,20391,10142,10249,49.73762935
UT,Carbon ,2016,0,20324,10091,10233,49.65065932
UT,Carbon ,2017,0,20131,9976,10155,49.55541205
UT,Carbon ,2018,0,20233,10060,10173,49.72075322
UT,Carbon ,2019,0,20463,10163,10300,49.66524947
UT,Daggett ,2015,0,1107,639,468,57.72357724
UT,Daggett ,2016,0,1076,626,450,58.17843866
UT,Daggett ,2017,0,1013,563,450,55.5774926
UT,Daggett ,2018,0,974,551,423,56.57084189
UT,Daggett ,2019,0,950,546,404,57.47368421
UT,Davis ,2015,0,334597,168452,166145,50.34474308
UT,Davis ,2016,0,341000,172143,168857,50.48181818
UT,Davis ,2017,0,346658,175057,171601,50.498474
UT,Davis ,2018,0,351101,177427,173674,50.53446159
UT,Davis ,2019,0,355481,179556,175925,50.51071647
UT,Duchesne ,2015,0,20748,10573,10175,50.95912859
UT,Duchesne ,2016,0,20242,10256,9986,50.66693015
UT,Duchesne ,2017,0,19868,10054,9814,50.60398631
UT,Duchesne ,2018,0,19943,10088,9855,50.58416487
UT,Duchesne ,2019,0,19938,10080,9858,50.55672585
UT,Emery ,2015,0,10359,5263,5096,50.80606236
UT,Emery ,2016,0,10206,5172,5034,50.6760729
UT,Emery ,2017,0,10006,5087,4919,50.8394963
UT,Emery ,2018,0,10003,5106,4897,51.04468659
UT,Emery ,2019,0,10012,5095,4917,50.88893328
UT,Garfield ,2015,0,4962,2588,2374,52.15638855
UT,Garfield ,2016,0,4952,2605,2347,52.60500808
UT,Garfield ,2017,0,5025,2634,2391,52.41791045
UT,Garfield ,2018,0,5002,2602,2400,52.01919232
UT,Garfield ,2019,0,5051,2643,2408,52.32627203
UT,Grand ,2015,0,9551,4781,4770,50.05758559
UT,Grand ,2016,0,9622,4830,4792,50.19746414
UT,Grand ,2017,0,9589,4799,4790,50.04692877
UT,Grand ,2018,0,9686,4848,4838,50.0516209
UT,Grand ,2019,0,9754,4907,4847,50.30756613
UT,Iron ,2015,0,48113,24061,24052,50.00935298
UT,Iron ,2016,0,49676,24854,24822,50.03220871
UT,Iron ,2017,0,50761,25402,25359,50.04235535
UT,Iron ,2018,0,52678,26326,26352,49.97532177
UT,Iron ,2019,0,54839,27388,27451,49.94255913
UT,Juab ,2015,0,10551,5430,5121,51.46431618
UT,Juab ,2016,0,11016,5682,5334,51.5795207
UT,Juab ,2017,0,11293,5797,5496,51.33268396
UT,Juab ,2018,0,11629,5955,5674,51.20818643
UT,Juab ,2019,0,12017,6158,5859,51.2440709
UT,Kane ,2015,0,7039,3506,3533,49.80821139
UT,Kane ,2016,0,7297,3680,3617,50.43168425
UT,Kane ,2017,0,7520,3803,3717,50.57180851
UT,Kane ,2018,0,7677,3867,3810,50.37123877
UT,Kane ,2019,0,7886,3973,3913,50.380421
UT,Millard ,2015,0,12620,6409,6211,50.7844691
UT,Millard ,2016,0,12655,6464,6191,51.07862505
UT,Millard ,2017,0,12821,6549,6272,51.08025895
UT,Millard ,2018,0,12987,6659,6328,51.27435127
UT,Millard ,2019,0,13188,6766,6422,51.30421595
UT,Morgan ,2015,0,11039,5631,5408,51.01005526
UT,Morgan ,2016,0,11370,5831,5539,51.28408091
UT,Morgan ,2017,0,11829,6091,5738,51.4920957
UT,Morgan ,2018,0,11956,6162,5794,51.53897625
UT,Morgan ,2019,0,12124,6237,5887,51.44341801
UT,Piute ,2015,0,1491,766,725,51.37491616
UT,Piute ,2016,0,1459,743,716,50.9252913
UT,Piute ,2017,0,1407,713,694,50.67519545
UT,Piute ,2018,0,1438,746,692,51.87760779
UT,Piute ,2019,0,1479,761,718,51.45368492
UT,Rich ,2015,0,2300,1168,1132,50.7826087
UT,Rich ,2016,0,2313,1180,1133,51.01599654
UT,Rich ,2017,0,2395,1222,1173,51.02296451
UT,Rich ,2018,0,2456,1261,1195,51.34364821
UT,Rich ,2019,0,2483,1280,1203,51.5505437
UT,Salt Lake ,2015,0,1102273,553444,548829,50.20934015
UT,Salt Lake ,2016,0,1120109,561942,558167,50.16851039
UT,Salt Lake ,2017,0,1136719,570565,566154,50.19402333
UT,Salt Lake ,2018,0,1148692,576724,571968,50.20701807
UT,Salt Lake ,2019,0,1160437,582594,577843,50.20470736
UT,San Juan ,2015,0,15239,7603,7636,49.89172518
UT,San Juan ,2016,0,15329,7667,7662,50.01630896
UT,San Juan ,2017,0,15277,7650,7627,50.07527656
UT,San Juan ,2018,0,15358,7669,7689,49.93488736
UT,San Juan ,2019,0,15308,7659,7649,50.03266266
UT,Sanpete ,2015,0,28654,15018,13636,52.41153068
UT,Sanpete ,2016,0,29232,15320,13912,52.40831965
UT,Sanpete ,2017,0,29921,15727,14194,52.56174593
UT,Sanpete ,2018,0,30503,16035,14468,52.56859981
UT,Sanpete ,2019,0,30939,16302,14637,52.69077863
UT,Sevier ,2015,0,20858,10613,10245,50.88215553
UT,Sevier ,2016,0,21131,10687,10444,50.57498462
UT,Sevier ,2017,0,21292,10804,10488,50.74206275
UT,Sevier ,2018,0,21497,10926,10571,50.82569661
UT,Sevier ,2019,0,21620,11028,10592,51.00832562
UT,Summit ,2015,0,39640,20308,19332,51.23107972
UT,Summit ,2016,0,40512,20704,19808,51.10584518
UT,Summit ,2017,0,41330,21199,20131,51.29203968
UT,Summit ,2018,0,41890,21444,20446,51.19121509
UT,Summit ,2019,0,42145,21582,20563,51.20892158
UT,Tooele ,2015,0,62639,31591,31048,50.43343604
UT,Tooele ,2016,0,64612,32651,31961,50.53395654
UT,Tooele ,2017,0,67486,34168,33318,50.62976025
UT,Tooele ,2018,0,69989,35436,34553,50.63081341
UT,Tooele ,2019,0,72259,36685,35574,50.76876237
UT,Uintah ,2015,0,37791,19200,18591,50.8057474
UT,Uintah ,2016,0,36264,18399,17865,50.73626737
UT,Uintah ,2017,0,35228,17826,17402,50.60179403
UT,Uintah ,2018,0,35405,17961,17444,50.73012286
UT,Uintah ,2019,0,35734,18134,17600,50.74718755
UT,Utah ,2015,0,572667,289066,283601,50.47715339
UT,Utah ,2016,0,590288,298415,291873,50.55413629
UT,Utah ,2017,0,606742,306907,299835,50.58278478
UT,Utah ,2018,0,621520,314111,307409,50.53916205
UT,Utah ,2019,0,636235,321408,314827,50.51718312
UT,Wasatch ,2015,0,29118,14816,14302,50.88261556
UT,Wasatch ,2016,0,30375,15477,14898,50.95308642
UT,Wasatch ,2017,0,31890,16245,15645,50.94073377
UT,Wasatch ,2018,0,33067,16782,16285,50.75150452
UT,Wasatch ,2019,0,34091,17351,16740,50.89613094
UT,Washington ,2015,0,154650,76525,78125,49.48270288
UT,Washington ,2016,0,159352,78933,80419,49.53373663
UT,Washington ,2017,0,165929,82133,83796,49.49888205
UT,Washington ,2018,0,171567,85002,86565,49.54449282
UT,Washington ,2019,0,177556,88076,89480,49.60463178
UT,Wayne ,2015,0,2690,1372,1318,51.00371747
UT,Wayne ,2016,0,2671,1364,1307,51.0670161
UT,Wayne ,2017,0,2702,1390,1312,51.44337528
UT,Wayne ,2018,0,2671,1366,1305,51.14189442
UT,Wayne ,2019,0,2711,1387,1324,51.16193287
UT,Weber ,2015,0,242872,121968,120904,50.21904542
UT,Weber ,2016,0,247131,124040,123091,50.19200343
UT,Weber ,2017,0,251576,126559,125017,50.30646803
UT,Weber ,2018,0,255697,128620,127077,50.30172431
UT,Weber ,2019,0,260213,130996,129217,50.34183534
VT,Addison ,2015,0,36929,18498,18431,50.09071461
VT,Addison ,2016,0,36931,18464,18467,49.99593837
VT,Addison ,2017,0,36900,18419,18481,49.91598916
VT,Addison ,2018,0,36873,18422,18451,49.96067583
VT,Addison ,2019,0,36777,18367,18410,49.94153955
VT,Bennington ,2015,0,36153,17577,18576,48.61837192
VT,Bennington ,2016,0,35911,17453,18458,48.6007073
VT,Bennington ,2017,0,35675,17362,18313,48.66713385
VT,Bennington ,2018,0,35520,17295,18225,48.69087838
VT,Bennington ,2019,0,35470,17274,18196,48.70031012
VT,Caledonia ,2015,0,30645,15335,15310,50.04078969
VT,Caledonia ,2016,0,30154,15077,15077,50
VT,Caledonia ,2017,0,30141,15086,15055,50.05142497
VT,Caledonia ,2018,0,30236,15134,15102,50.05291705
VT,Caledonia ,2019,0,29993,14972,15021,49.91831427
VT,Chittenden ,2015,0,161293,79055,82238,49.01328638
VT,Chittenden ,2016,0,161563,79246,82317,49.04959675
VT,Chittenden ,2017,0,163031,79851,83180,48.97902853
VT,Chittenden ,2018,0,163571,80011,83560,48.91515
VT,Chittenden ,2019,0,163774,80099,83675,48.90825162
VT,Essex ,2015,0,6193,3134,3059,50.60552236
VT,Essex ,2016,0,6224,3153,3071,50.65874036
VT,Essex ,2017,0,6184,3120,3064,50.45278137
VT,Essex ,2018,0,6234,3127,3107,50.16041065
VT,Essex ,2019,0,6163,3098,3065,50.26772676
VT,Franklin ,2015,0,48988,24315,24673,49.63460439
VT,Franklin ,2016,0,48963,24342,24621,49.71509099
VT,Franklin ,2017,0,48969,24373,24596,49.77230493
VT,Franklin ,2018,0,49258,24532,24726,49.80307767
VT,Franklin ,2019,0,49402,24619,24783,49.83401482
VT,Grand Isle ,2015,0,6871,3437,3434,50.02183088
VT,Grand Isle ,2016,0,6921,3481,3440,50.29619997
VT,Grand Isle ,2017,0,6975,3510,3465,50.32258065
VT,Grand Isle ,2018,0,7110,3599,3511,50.61884669
VT,Grand Isle ,2019,0,7235,3664,3571,50.64270905
VT,Lamoille ,2015,0,25240,12629,12611,50.03565769
VT,Lamoille ,2016,0,25331,12681,12650,50.06118985
VT,Lamoille ,2017,0,25360,12702,12658,50.08675079
VT,Lamoille ,2018,0,25295,12675,12620,50.10871714
VT,Lamoille ,2019,0,25362,12685,12677,50.01577163
VT,Orange ,2015,0,28887,14400,14487,49.84941323
VT,Orange ,2016,0,28908,14461,14447,50.02421475
VT,Orange ,2017,0,28964,14541,14423,50.20370115
VT,Orange ,2018,0,28888,14488,14400,50.15231238
VT,Orange ,2019,0,28892,14506,14386,50.20766994
VT,Orleans ,2015,0,27034,13603,13431,50.31811793
VT,Orleans ,2016,0,26766,13472,13294,50.3325114
VT,Orleans ,2017,0,26811,13459,13352,50.19954496
VT,Orleans ,2018,0,26859,13459,13400,50.10983283
VT,Orleans ,2019,0,27037,13545,13492,50.09801383
VT,Rutland ,2015,0,59544,29299,30245,49.20562945
VT,Rutland ,2016,0,59122,29108,30014,49.23378776
VT,Rutland ,2017,0,59006,29118,29888,49.34752398
VT,Rutland ,2018,0,58596,28905,29691,49.32930575
VT,Rutland ,2019,0,58191,28816,29375,49.51968517
VT,Washington ,2015,0,58652,29054,29598,49.5362477
VT,Washington ,2016,0,58355,28921,29434,49.56044898
VT,Washington ,2017,0,58253,28808,29445,49.45324704
VT,Washington ,2018,0,58079,28758,29321,49.51531535
VT,Washington ,2019,0,58409,29046,29363,49.72863771
VT,Windham ,2015,0,43246,21157,22089,48.92244369
VT,Windham ,2016,0,43163,21153,22010,49.00725158
VT,Windham ,2017,0,42851,20998,21853,49.002357
VT,Windham ,2018,0,42635,20888,21747,48.9926117
VT,Windham ,2019,0,42222,20663,21559,48.93894178
VT,Windsor ,2015,0,55541,27188,28353,48.95122522
VT,Windsor ,2016,0,55345,27040,28305,48.85716867
VT,Windsor ,2017,0,55224,26961,28263,48.82116471
VT,Windsor ,2018,0,55204,26986,28218,48.88413883
VT,Windsor ,2019,0,55062,26962,28100,48.96661945
VA,Accomack ,2015,0,32914,16021,16893,48.67533572
VA,Accomack ,2016,0,32871,15992,16879,48.65078641
VA,Accomack ,2017,0,32685,15920,16765,48.70735812
VA,Accomack ,2018,0,32581,15893,16688,48.77996378
VA,Accomack ,2019,0,32316,15728,16588,48.66938978
VA,Albemarle ,2015,0,105117,50387,54730,47.93420665
VA,Albemarle ,2016,0,106431,50926,55505,47.84884103
VA,Albemarle ,2017,0,107768,51482,56286,47.771138
VA,Albemarle ,2018,0,108377,51811,56566,47.80626886
VA,Albemarle ,2019,0,109330,52319,57011,47.85420287
VA,Alleghany ,2015,0,15425,7557,7868,48.99189627
VA,Alleghany ,2016,0,15387,7523,7864,48.89192175
VA,Alleghany ,2017,0,15128,7396,7732,48.88947647
VA,Alleghany ,2018,0,14986,7325,7661,48.87895369
VA,Alleghany ,2019,0,14860,7260,7600,48.85598923
VA,Amelia ,2015,0,12784,6278,6506,49.10826033
VA,Amelia ,2016,0,12801,6303,6498,49.23834075
VA,Amelia ,2017,0,12980,6407,6573,49.3605547
VA,Amelia ,2018,0,13057,6435,6622,49.28390901
VA,Amelia ,2019,0,13145,6483,6662,49.31913275
VA,Amherst ,2015,0,31836,15475,16361,48.60849353
VA,Amherst ,2016,0,31887,15421,16466,48.3614012
VA,Amherst ,2017,0,31863,15466,16397,48.53905784
VA,Amherst ,2018,0,31684,15425,16259,48.6838783
VA,Amherst ,2019,0,31605,15360,16245,48.59990508
VA,Appomattox ,2015,0,15492,7522,7970,48.55409243
VA,Appomattox ,2016,0,15528,7546,7982,48.59608449
VA,Appomattox ,2017,0,15723,7636,8087,48.56579533
VA,Appomattox ,2018,0,15881,7713,8168,48.56747056
VA,Appomattox ,2019,0,15911,7719,8192,48.51360694
VA,Arlington ,2015,0,228548,114227,114321,49.97943539
VA,Arlington ,2016,0,231259,115703,115556,50.03178255
VA,Arlington ,2017,0,234647,117387,117260,50.02706193
VA,Arlington ,2018,0,236025,118296,117729,50.12011439
VA,Arlington ,2019,0,236842,118687,118155,50.11231116
VA,Augusta ,2015,0,74292,37622,36670,50.64071502
VA,Augusta ,2016,0,74834,37965,36869,50.73228746
VA,Augusta ,2017,0,75177,38129,37048,50.7189699
VA,Augusta ,2018,0,75535,38320,37215,50.731449
VA,Augusta ,2019,0,75558,38356,37202,50.76365176
VA,Bath ,2015,0,4460,2244,2216,50.31390135
VA,Bath ,2016,0,4409,2222,2187,50.3969154
VA,Bath ,2017,0,4266,2150,2116,50.39849977
VA,Bath ,2018,0,4253,2137,2116,50.24688455
VA,Bath ,2019,0,4147,2099,2048,50.61490234
VA,Bedford ,2015,0,77629,38303,39326,49.34109676
VA,Bedford ,2016,0,77993,38458,39535,49.30955342
VA,Bedford ,2017,0,78378,38697,39681,49.37227283
VA,Bedford ,2018,0,78882,38866,40016,49.27106311
VA,Bedford ,2019,0,78997,38873,40124,49.20819778
VA,Bland ,2015,0,6532,3587,2945,54.91426822
VA,Bland ,2016,0,6472,3552,2920,54.88257108
VA,Bland ,2017,0,6354,3489,2865,54.91029273
VA,Bland ,2018,0,6303,3452,2851,54.767571
VA,Bland ,2019,0,6280,3444,2836,54.84076433
VA,Botetourt ,2015,0,33380,16534,16846,49.53265428
VA,Botetourt ,2016,0,33252,16473,16779,49.5398773
VA,Botetourt ,2017,0,33313,16513,16800,49.56923723
VA,Botetourt ,2018,0,33352,16547,16805,49.6132166
VA,Botetourt ,2019,0,33419,16594,16825,49.65438822
VA,Brunswick ,2015,0,16845,8993,7852,53.38676165
VA,Brunswick ,2016,0,16618,8875,7743,53.40594536
VA,Brunswick ,2017,0,16570,8824,7746,53.25286663
VA,Brunswick ,2018,0,16336,8730,7606,53.44025465
VA,Brunswick ,2019,0,16231,8701,7530,53.60729468
VA,Buchanan ,2015,0,22752,11557,11195,50.79553446
VA,Buchanan ,2016,0,22212,11312,10900,50.92742662
VA,Buchanan ,2017,0,21604,10915,10689,50.52305129
VA,Buchanan ,2018,0,21369,10812,10557,50.59665871
VA,Buchanan ,2019,0,21004,10638,10366,50.64749572
VA,Buckingham ,2015,0,17017,9340,7677,54.88629018
VA,Buckingham ,2016,0,17051,9365,7686,54.9234649
VA,Buckingham ,2017,0,17038,9417,7621,55.27057166
VA,Buckingham ,2018,0,17043,9395,7648,55.12527137
VA,Buckingham ,2019,0,17148,9417,7731,54.91602519
VA,Campbell ,2015,0,55356,26846,28510,48.49700123
VA,Campbell ,2016,0,55419,26858,28561,48.46352334
VA,Campbell ,2017,0,55326,26818,28508,48.47268915
VA,Campbell ,2018,0,55137,26765,28372,48.54272086
VA,Campbell ,2019,0,54885,26668,28217,48.58886763
VA,Caroline ,2015,0,29900,14740,15160,49.29765886
VA,Caroline ,2016,0,30099,14807,15292,49.19432539
VA,Caroline ,2017,0,30432,15021,15411,49.35922713
VA,Caroline ,2018,0,30751,15216,15535,49.48131768
VA,Caroline ,2019,0,30725,15213,15512,49.51342555
VA,Carroll ,2015,0,29870,14750,15120,49.38064948
VA,Carroll ,2016,0,29789,14749,15040,49.51156467
VA,Carroll ,2017,0,29812,14790,15022,49.61089494
VA,Carroll ,2018,0,29741,14732,15009,49.5343129
VA,Carroll ,2019,0,29791,14782,15009,49.61901245
VA,Charles City ,2015,0,7046,3464,3582,49.16264547
VA,Charles City ,2016,0,7034,3418,3616,48.59255047
VA,Charles City ,2017,0,7026,3403,3623,48.43438656
VA,Charles City ,2018,0,7000,3396,3604,48.51428571
VA,Charles City ,2019,0,6963,3375,3588,48.47048686
VA,Charlotte ,2015,0,12179,6036,6143,49.56071927
VA,Charlotte ,2016,0,12119,6011,6108,49.59980196
VA,Charlotte ,2017,0,12077,5994,6083,49.63153101
VA,Charlotte ,2018,0,11944,5918,6026,49.54789015
VA,Charlotte ,2019,0,11880,5887,5993,49.55387205
VA,Chesterfield ,2015,0,334915,161434,173481,48.20148396
VA,Chesterfield ,2016,0,338479,163265,175214,48.23489788
VA,Chesterfield ,2017,0,343276,165542,177734,48.22416947
VA,Chesterfield ,2018,0,348281,167931,180350,48.21710056
VA,Chesterfield ,2019,0,352802,169919,182883,48.16270883
VA,Clarke ,2015,0,14239,7084,7155,49.75068474
VA,Clarke ,2016,0,14294,7092,7202,49.61522317
VA,Clarke ,2017,0,14454,7182,7272,49.6886675
VA,Clarke ,2018,0,14511,7225,7286,49.78981462
VA,Clarke ,2019,0,14619,7240,7379,49.52459129
VA,Craig ,2015,0,5136,2560,2576,49.84423676
VA,Craig ,2016,0,5120,2551,2569,49.82421875
VA,Craig ,2017,0,5062,2507,2555,49.5258791
VA,Craig ,2018,0,5102,2535,2567,49.68639749
VA,Craig ,2019,0,5131,2555,2576,49.79536153
VA,Culpeper ,2015,0,49551,24772,24779,49.99293657
VA,Culpeper ,2016,0,50319,25107,25212,49.89566565
VA,Culpeper ,2017,0,51235,25616,25619,49.99707231
VA,Culpeper ,2018,0,51795,25894,25901,49.99324259
VA,Culpeper ,2019,0,52605,26266,26339,49.93061496
VA,Cumberland ,2015,0,9756,4698,5058,48.15498155
VA,Cumberland ,2016,0,9745,4682,5063,48.04515136
VA,Cumberland ,2017,0,9828,4759,5069,48.42287342
VA,Cumberland ,2018,0,9857,4762,5095,48.31084508
VA,Cumberland ,2019,0,9932,4805,5127,48.37897704
VA,Dickenson ,2015,0,15201,7665,7536,50.42431419
VA,Dickenson ,2016,0,15014,7599,7415,50.61276142
VA,Dickenson ,2017,0,14722,7440,7282,50.53661187
VA,Dickenson ,2018,0,14526,7364,7162,50.69530497
VA,Dickenson ,2019,0,14318,7292,7026,50.92890068
VA,Dinwiddie ,2015,0,28148,13702,14446,48.6784141
VA,Dinwiddie ,2016,0,28468,13886,14582,48.77757482
VA,Dinwiddie ,2017,0,28630,13999,14631,48.89626266
VA,Dinwiddie ,2018,0,28633,14024,14609,48.97845144
VA,Dinwiddie ,2019,0,28544,13996,14548,49.03307175
VA,Essex ,2015,0,11096,5203,5893,46.89077145
VA,Essex ,2016,0,11077,5190,5887,46.85384129
VA,Essex ,2017,0,10969,5154,5815,46.98696326
VA,Essex ,2018,0,10896,5118,5778,46.97136564
VA,Essex ,2019,0,10953,5133,5820,46.86387291
VA,Fairfax ,2015,0,1140401,564731,575670,49.520388
VA,Fairfax ,2016,0,1144188,566923,577265,49.54806378
VA,Fairfax ,2017,0,1148728,569427,579301,49.57022028
VA,Fairfax ,2018,0,1148463,569834,578629,49.61709694
VA,Fairfax ,2019,0,1147532,569629,577903,49.63948718
VA,Fauquier ,2015,0,68423,33861,34562,49.48774535
VA,Fauquier ,2016,0,68805,34019,34786,49.44262772
VA,Fauquier ,2017,0,69547,34392,35155,49.4514501
VA,Fauquier ,2018,0,70642,34968,35674,49.50029727
VA,Fauquier ,2019,0,71222,35213,36009,49.4411839
VA,Floyd ,2015,0,15548,7837,7711,50.40519681
VA,Floyd ,2016,0,15677,7899,7778,50.38591567
VA,Floyd ,2017,0,15758,7957,7801,50.49498667
VA,Floyd ,2018,0,15790,7943,7847,50.30398987
VA,Floyd ,2019,0,15749,7931,7818,50.35875294
VA,Fluvanna ,2015,0,26133,11870,14263,45.42149772
VA,Fluvanna ,2016,0,26187,11961,14226,45.67533509
VA,Fluvanna ,2017,0,26480,12049,14431,45.50226586
VA,Fluvanna ,2018,0,26898,12254,14644,45.5572905
VA,Fluvanna ,2019,0,27270,12496,14774,45.82324899
VA,Franklin ,2015,0,56227,27662,28565,49.197005
VA,Franklin ,2016,0,56158,27645,28513,49.22718046
VA,Franklin ,2017,0,56315,27720,28595,49.22311995
VA,Franklin ,2018,0,56191,27655,28536,49.21606663
VA,Franklin ,2019,0,56042,27565,28477,49.18632454
VA,Frederick ,2015,0,83493,41571,41922,49.78980274
VA,Frederick ,2016,0,84638,42111,42527,49.7542475
VA,Frederick ,2017,0,86456,43083,43373,49.83228463
VA,Frederick ,2018,0,88173,43978,44195,49.87694646
VA,Frederick ,2019,0,89313,44495,44818,49.81917526
VA,Giles ,2015,0,16762,8220,8542,49.03949409
VA,Giles ,2016,0,16827,8249,8578,49.02240447
VA,Giles ,2017,0,16754,8264,8490,49.3255342
VA,Giles ,2018,0,16799,8279,8520,49.2826954
VA,Giles ,2019,0,16720,8267,8453,49.4437799
VA,Gloucester ,2015,0,37010,18204,18806,49.1867063
VA,Gloucester ,2016,0,37114,18334,18780,49.39914857
VA,Gloucester ,2017,0,37295,18422,18873,49.39536131
VA,Gloucester ,2018,0,37341,18378,18963,49.21667872
VA,Gloucester ,2019,0,37348,18387,18961,49.23155189
VA,Goochland ,2015,0,22165,10938,11227,49.34807128
VA,Goochland ,2016,0,22485,11048,11437,49.13497887
VA,Goochland ,2017,0,22703,11130,11573,49.02435801
VA,Goochland ,2018,0,23219,11375,11844,48.99005125
VA,Goochland ,2019,0,23753,11660,12093,49.08853618
VA,Grayson ,2015,0,15959,8208,7751,51.43179397
VA,Grayson ,2016,0,15867,8160,7707,51.42749102
VA,Grayson ,2017,0,15697,8093,7604,51.55762248
VA,Grayson ,2018,0,15635,8048,7587,51.47425648
VA,Grayson ,2019,0,15550,7995,7555,51.414791
VA,Greene ,2015,0,19183,9379,9804,48.89224834
VA,Greene ,2016,0,19309,9449,9860,48.93572945
VA,Greene ,2017,0,19593,9579,10014,48.88990966
VA,Greene ,2018,0,19692,9605,10087,48.77615275
VA,Greene ,2019,0,19819,9649,10170,48.68560472
VA,Greensville ,2015,0,11786,7435,4351,63.08331919
VA,Greensville ,2016,0,11500,7238,4262,62.93913043
VA,Greensville ,2017,0,11569,7302,4267,63.11695047
VA,Greensville ,2018,0,11432,7187,4245,62.86738978
VA,Greensville ,2019,0,11336,7123,4213,62.83521524
VA,Halifax ,2015,0,35103,16790,18313,47.83066974
VA,Halifax ,2016,0,34990,16764,18226,47.91083167
VA,Halifax ,2017,0,34575,16577,17998,47.945047
VA,Halifax ,2018,0,34181,16379,17802,47.91843422
VA,Halifax ,2019,0,33911,16258,17653,47.94314529
VA,Hanover ,2015,0,103071,50624,52447,49.11565814
VA,Hanover ,2016,0,104290,51149,53141,49.04497075
VA,Hanover ,2017,0,105674,51819,53855,49.03665992
VA,Hanover ,2018,0,106886,52333,54553,48.96151039
VA,Hanover ,2019,0,107766,52782,54984,48.97834196
VA,Henrico ,2015,0,324375,153676,170699,47.37603083
VA,Henrico ,2016,0,325931,154403,171528,47.37291022
VA,Henrico ,2017,0,327559,155468,172091,47.46259452
VA,Henrico ,2018,0,328993,156120,172873,47.4538972
VA,Henrico ,2019,0,330818,156970,173848,47.44905054
VA,Henry ,2015,0,51940,25055,26885,48.23835194
VA,Henry ,2016,0,51645,24878,26767,48.17116855
VA,Henry ,2017,0,51346,24721,26625,48.14591205
VA,Henry ,2018,0,51050,24540,26510,48.0705191
VA,Henry ,2019,0,50557,24315,26242,48.09423027
VA,Highland ,2015,0,2196,1098,1098,50
VA,Highland ,2016,0,2210,1111,1099,50.27149321
VA,Highland ,2017,0,2217,1106,1111,49.887235
VA,Highland ,2018,0,2208,1100,1108,49.81884058
VA,Highland ,2019,0,2190,1086,1104,49.5890411
VA,Isle of Wight ,2015,0,36159,17707,18452,48.96982771
VA,Isle of Wight ,2016,0,36326,17798,18528,48.99521004
VA,Isle of Wight ,2017,0,36571,17892,18679,48.92401083
VA,Isle of Wight ,2018,0,36972,18092,18880,48.93432868
VA,Isle of Wight ,2019,0,37109,18186,18923,49.00697944
VA,James City ,2015,0,72819,35132,37687,48.24565017
VA,James City ,2016,0,73930,35609,38321,48.16583254
VA,James City ,2017,0,75274,36307,38967,48.23312166
VA,James City ,2018,0,76033,36759,39274,48.34611287
VA,James City ,2019,0,76523,36985,39538,48.33187408
VA,King Queen ,2015,0,7085,3583,3502,50.5716302
VA,King Queen ,2016,0,7054,3597,3457,50.99234477
VA,King Queen ,2017,0,6999,3557,3442,50.82154594
VA,King Queen ,2018,0,7045,3573,3472,50.71682044
VA,King Queen ,2019,0,7025,3580,3445,50.96085409
VA,King George ,2015,0,25414,12775,12639,50.26756906
VA,King George ,2016,0,25947,13146,12801,50.66481674
VA,King George ,2017,0,26337,13352,12985,50.69673843
VA,King George ,2018,0,26612,13469,13143,50.61250564
VA,King George ,2019,0,26836,13586,13250,50.62602474
VA,King William ,2015,0,16282,7981,8301,49.01731974
VA,King William ,2016,0,16405,8014,8391,48.85096007
VA,King William ,2017,0,16684,8133,8551,48.74730281
VA,King William ,2018,0,16919,8271,8648,48.88586796
VA,King William ,2019,0,17148,8388,8760,48.9153254
VA,Lancaster ,2015,0,10825,5115,5710,47.2517321
VA,Lancaster ,2016,0,10771,5067,5704,47.0429858
VA,Lancaster ,2017,0,10725,5063,5662,47.20745921
VA,Lancaster ,2018,0,10696,5051,5645,47.22326103
VA,Lancaster ,2019,0,10603,5010,5593,47.25077808
VA,Lee ,2015,0,24595,12897,11698,52.43748729
VA,Lee ,2016,0,24165,12622,11543,52.23256776
VA,Lee ,2017,0,23900,12436,11464,52.0334728
VA,Lee ,2018,0,23656,12297,11359,51.9825837
VA,Lee ,2019,0,23423,12215,11208,52.14959655
VA,Loudoun ,2015,0,374014,185259,188755,49.53263782
VA,Loudoun ,2016,0,385546,190922,194624,49.51990165
VA,Loudoun ,2017,0,397049,196773,200276,49.55887057
VA,Loudoun ,2018,0,405522,200940,204582,49.55094915
VA,Loudoun ,2019,0,413538,205164,208374,49.61188573
VA,Louisa ,2015,0,34611,17049,17562,49.25890613
VA,Louisa ,2016,0,35304,17426,17878,49.35984591
VA,Louisa ,2017,0,35912,17774,18138,49.49320561
VA,Louisa ,2018,0,36784,18190,18594,49.45084819
VA,Louisa ,2019,0,37591,18594,18997,49.46396744
VA,Lunenburg ,2015,0,12348,6507,5841,52.696793
VA,Lunenburg ,2016,0,12319,6523,5796,52.95072652
VA,Lunenburg ,2017,0,12333,6529,5804,52.93926863
VA,Lunenburg ,2018,0,12215,6468,5747,52.9512894
VA,Lunenburg ,2019,0,12196,6450,5746,52.88619219
VA,Madison ,2015,0,13047,6328,6719,48.50157124
VA,Madison ,2016,0,13081,6343,6738,48.49017659
VA,Madison ,2017,0,13212,6399,6813,48.43324251
VA,Madison ,2018,0,13248,6403,6845,48.33182367
VA,Madison ,2019,0,13261,6424,6837,48.4428022
VA,Mathews ,2015,0,8834,4274,4560,48.38125424
VA,Mathews ,2016,0,8769,4232,4537,48.26091915
VA,Mathews ,2017,0,8709,4209,4500,48.3293145
VA,Mathews ,2018,0,8792,4250,4542,48.33939945
VA,Mathews ,2019,0,8834,4277,4557,48.41521395
VA,Mecklenburg ,2015,0,30922,14946,15976,48.33451911
VA,Mecklenburg ,2016,0,30813,14960,15853,48.55093629
VA,Mecklenburg ,2017,0,30693,14954,15739,48.72120679
VA,Mecklenburg ,2018,0,30624,14905,15719,48.67097701
VA,Mecklenburg ,2019,0,30587,14899,15688,48.71023637
VA,Middlesex ,2015,0,10686,5279,5407,49.40108553
VA,Middlesex ,2016,0,10749,5267,5482,48.99990697
VA,Middlesex ,2017,0,10625,5173,5452,48.68705882
VA,Middlesex ,2018,0,10733,5254,5479,48.9518308
VA,Middlesex ,2019,0,10582,5191,5391,49.05499905
VA,Montgomery ,2015,0,97317,50560,46757,51.95392377
VA,Montgomery ,2016,0,98172,51015,47157,51.96491871
VA,Montgomery ,2017,0,98142,50884,47258,51.84732327
VA,Montgomery ,2018,0,98532,51081,47451,51.84204116
VA,Montgomery ,2019,0,98535,50976,47559,51.73390166
VA,Nelson ,2015,0,14760,7170,7590,48.57723577
VA,Nelson ,2016,0,14805,7199,7606,48.62546437
VA,Nelson ,2017,0,14800,7173,7627,48.46621622
VA,Nelson ,2018,0,14862,7176,7686,48.28421478
VA,Nelson ,2019,0,14930,7216,7714,48.33221701
VA,New Kent ,2015,0,20377,10383,9994,50.95450753
VA,New Kent ,2016,0,21009,10720,10289,51.02575087
VA,New Kent ,2017,0,21638,11029,10609,50.97051484
VA,New Kent ,2018,0,22317,11384,10933,51.01044047
VA,New Kent ,2019,0,23091,11758,11333,50.92027197
VA,Northampton ,2015,0,12080,5785,6295,47.88907285
VA,Northampton ,2016,0,12002,5741,6261,47.83369438
VA,Northampton ,2017,0,11872,5689,6183,47.91947439
VA,Northampton ,2018,0,11761,5610,6151,47.70002551
VA,Northampton ,2019,0,11710,5608,6102,47.89069172
VA,Northumberland ,2015,0,12241,6000,6241,49.0156033
VA,Northumberland ,2016,0,12176,5993,6183,49.21977661
VA,Northumberland ,2017,0,12271,6025,6246,49.09950289
VA,Northumberland ,2018,0,12168,5972,6196,49.07955293
VA,Northumberland ,2019,0,12095,5925,6170,48.98718479
VA,Nottoway ,2015,0,15606,8416,7190,53.92797642
VA,Nottoway ,2016,0,15495,8405,7090,54.24330429
VA,Nottoway ,2017,0,15432,8356,7076,54.14722654
VA,Nottoway ,2018,0,15400,8328,7072,54.07792208
VA,Nottoway ,2019,0,15232,8241,6991,54.10320378
VA,Orange ,2015,0,35178,17200,17978,48.89419524
VA,Orange ,2016,0,35354,17252,18102,48.79787294
VA,Orange ,2017,0,35870,17450,18420,48.64789518
VA,Orange ,2018,0,36598,17825,18773,48.70484726
VA,Orange ,2019,0,37051,18116,18935,48.89476667
VA,Page ,2015,0,23662,11682,11980,49.37029837
VA,Page ,2016,0,23619,11624,11995,49.21461535
VA,Page ,2017,0,23784,11733,12051,49.33148335
VA,Page ,2018,0,23972,11842,12130,49.39929918
VA,Page ,2019,0,23902,11826,12076,49.47703121
VA,Patrick ,2015,0,17960,8871,9089,49.39309577
VA,Patrick ,2016,0,17796,8788,9008,49.38188357
VA,Patrick ,2017,0,17713,8773,8940,49.52859482
VA,Patrick ,2018,0,17663,8741,8922,49.48762951
VA,Patrick ,2019,0,17608,8736,8872,49.6138119
VA,Pittsylvania ,2015,0,62010,30491,31519,49.17110144
VA,Pittsylvania ,2016,0,61704,30368,31336,49.21561001
VA,Pittsylvania ,2017,0,61309,30195,31114,49.25051787
VA,Pittsylvania ,2018,0,60901,30034,30867,49.31610318
VA,Pittsylvania ,2019,0,60354,29721,30633,49.2444577
VA,Powhatan ,2015,0,28056,14653,13403,52.22768748
VA,Powhatan ,2016,0,28443,14869,13574,52.27648279
VA,Powhatan ,2017,0,28716,14890,13826,51.85262571
VA,Powhatan ,2018,0,29210,15149,14061,51.8623759
VA,Powhatan ,2019,0,29652,15325,14327,51.68285444
VA,Prince Edward ,2015,0,23120,11534,11586,49.88754325
VA,Prince Edward ,2016,0,23020,11496,11524,49.93918332
VA,Prince Edward ,2017,0,22678,11297,11381,49.81479848
VA,Prince Edward ,2018,0,22906,11465,11441,50.05238802
VA,Prince Edward ,2019,0,22802,11400,11402,49.99561442
VA,Prince George ,2015,0,38246,21081,17165,55.11948962
VA,Prince George ,2016,0,37972,20616,17356,54.29263668
VA,Prince George ,2017,0,38006,20578,17428,54.14408251
VA,Prince George ,2018,0,37993,20442,17551,53.80464822
VA,Prince George ,2019,0,38353,20598,17755,53.70635935
VA,Prince William ,2015,0,450978,224857,226121,49.85986013
VA,Prince William ,2016,0,456496,227763,228733,49.89375591
VA,Prince William ,2017,0,463069,231589,231480,50.0117693
VA,Prince William ,2018,0,466235,233125,233110,50.00160863
VA,Prince William ,2019,0,470335,235142,235193,49.99457833
VA,Pulaski ,2015,0,34351,17150,17201,49.92576635
VA,Pulaski ,2016,0,34249,17145,17104,50.05985576
VA,Pulaski ,2017,0,34225,17147,17078,50.10080351
VA,Pulaski ,2018,0,34060,17042,17018,50.03523194
VA,Pulaski ,2019,0,34027,17053,16974,50.11608429
VA,Rappahannock ,2015,0,7400,3651,3749,49.33783784
VA,Rappahannock ,2016,0,7380,3645,3735,49.3902439
VA,Rappahannock ,2017,0,7393,3643,3750,49.27634249
VA,Rappahannock ,2018,0,7345,3606,3739,49.09462219
VA,Rappahannock ,2019,0,7370,3623,3747,49.1587517
VA,Richmond ,2015,0,8781,4874,3907,55.50620658
VA,Richmond ,2016,0,8758,4851,3907,55.3893583
VA,Richmond ,2017,0,8889,4989,3900,56.12554843
VA,Richmond ,2018,0,8970,5069,3901,56.51059086
VA,Richmond ,2019,0,9023,5092,3931,56.43355868
VA,Roanoke ,2015,0,93376,44867,48509,48.04982008
VA,Roanoke ,2016,0,93528,44984,48544,48.09682662
VA,Roanoke ,2017,0,93939,45259,48680,48.17913753
VA,Roanoke ,2018,0,94086,45346,48740,48.19633102
VA,Roanoke ,2019,0,94186,45381,48805,48.18232009
VA,Rockbridge ,2015,0,22396,11081,11315,49.47758528
VA,Rockbridge ,2016,0,22450,11152,11298,49.67483296
VA,Rockbridge ,2017,0,22668,11225,11443,49.51914593
VA,Rockbridge ,2018,0,22761,11246,11515,49.40907693
VA,Rockbridge ,2019,0,22573,11166,11407,49.46617641
VA,Rockingham ,2015,0,78445,38539,39906,49.12868889
VA,Rockingham ,2016,0,79367,39067,40300,49.2232288
VA,Rockingham ,2017,0,80397,39519,40878,49.15481921
VA,Rockingham ,2018,0,81261,40019,41242,49.24748649
VA,Rockingham ,2019,0,81948,40245,41703,49.11041148
VA,Russell ,2015,0,27854,13619,14235,48.89423422
VA,Russell ,2016,0,27422,13405,14017,48.88410765
VA,Russell ,2017,0,27046,13270,13776,49.06455668
VA,Russell ,2018,0,26795,13106,13689,48.91211047
VA,Russell ,2019,0,26586,12987,13599,48.84901828
VA,Scott ,2015,0,22296,11170,11126,50.09867241
VA,Scott ,2016,0,22082,11078,11004,50.16755729
VA,Scott ,2017,0,21893,10997,10896,50.23066734
VA,Scott ,2018,0,21672,10896,10776,50.27685493
VA,Scott ,2019,0,21566,10842,10724,50.27357878
VA,Shenandoah ,2015,0,42848,20946,21902,48.88442868
VA,Shenandoah ,2016,0,42907,21032,21875,49.01764281
VA,Shenandoah ,2017,0,43276,21216,22060,49.02486367
VA,Shenandoah ,2018,0,43473,21318,22155,49.03733352
VA,Shenandoah ,2019,0,43616,21400,22216,49.06456346
VA,Smyth ,2015,0,31419,15497,15922,49.32365766
VA,Smyth ,2016,0,31126,15295,15831,49.13898349
VA,Smyth ,2017,0,30731,15095,15636,49.11978133
VA,Smyth ,2018,0,30454,14950,15504,49.09043147
VA,Smyth ,2019,0,30104,14716,15388,48.88386925
VA,Southampton ,2015,0,18136,9418,8718,51.92986326
VA,Southampton ,2016,0,18080,9404,8676,52.01327434
VA,Southampton ,2017,0,17841,9267,8574,51.94215571
VA,Southampton ,2018,0,17713,9195,8518,51.9110258
VA,Southampton ,2019,0,17631,9117,8514,51.71005615
VA,Spotsylvania ,2015,0,129948,63861,66087,49.14350356
VA,Spotsylvania ,2016,0,131252,64546,66706,49.1771554
VA,Spotsylvania ,2017,0,132739,65221,67518,49.13476823
VA,Spotsylvania ,2018,0,134011,65870,68141,49.1526815
VA,Spotsylvania ,2019,0,136215,67033,69182,49.21117351
VA,Stafford ,2015,0,140868,70847,70021,50.29318227
VA,Stafford ,2016,0,143501,72442,71059,50.48187818
VA,Stafford ,2017,0,146792,74135,72657,50.50343343
VA,Stafford ,2018,0,149824,75640,74184,50.48590346
VA,Stafford ,2019,0,152882,77178,75704,50.48207114
VA,Surry ,2015,0,6671,3276,3395,49.10807975
VA,Surry ,2016,0,6554,3197,3357,48.77937138
VA,Surry ,2017,0,6503,3210,3293,49.361833
VA,Surry ,2018,0,6463,3193,3270,49.40430141
VA,Surry ,2019,0,6422,3186,3236,49.61071317
VA,Sussex ,2015,0,11692,6940,4752,59.35682518
VA,Sussex ,2016,0,11414,6735,4679,59.00648327
VA,Sussex ,2017,0,11379,6771,4608,59.50435012
VA,Sussex ,2018,0,11241,6656,4585,59.2118139
VA,Sussex ,2019,0,11159,6648,4511,59.57523076
VA,Tazewell ,2015,0,42905,21325,21580,49.70283184
VA,Tazewell ,2016,0,42155,20958,21197,49.71652236
VA,Tazewell ,2017,0,41303,20490,20813,49.60898724
VA,Tazewell ,2018,0,41058,20313,20745,49.47391495
VA,Tazewell ,2019,0,40595,20126,20469,49.57753418
VA,Warren ,2015,0,38716,19258,19458,49.74170885
VA,Warren ,2016,0,39165,19600,19565,50.04468275
VA,Warren ,2017,0,39409,19671,19738,49.91499404
VA,Warren ,2018,0,40006,19950,20056,49.86751987
VA,Warren ,2019,0,40164,20018,20146,49.84065332
VA,Washington ,2015,0,54268,26767,27501,49.32372669
VA,Washington ,2016,0,54100,26677,27423,49.31053604
VA,Washington ,2017,0,54179,26691,27488,49.26447517
VA,Washington ,2018,0,54067,26627,27440,49.24815507
VA,Washington ,2019,0,53740,26503,27237,49.31708225
VA,Westmoreland ,2015,0,17549,8575,8974,48.86318309
VA,Westmoreland ,2016,0,17649,8585,9064,48.64298261
VA,Westmoreland ,2017,0,17725,8618,9107,48.62059238
VA,Westmoreland ,2018,0,17817,8679,9138,48.71190436
VA,Westmoreland ,2019,0,18015,8789,9226,48.78712184
VA,Wise ,2015,0,39572,20575,18997,51.99383402
VA,Wise ,2016,0,39027,20252,18775,51.8922797
VA,Wise ,2017,0,38574,20126,18448,52.17504018
VA,Wise ,2018,0,37875,19722,18153,52.07128713
VA,Wise ,2019,0,37383,19475,17908,52.09587246
VA,Wythe ,2015,0,29097,14208,14889,48.82977627
VA,Wythe ,2016,0,28912,14126,14786,48.85860542
VA,Wythe ,2017,0,28829,14067,14762,48.79461653
VA,Wythe ,2018,0,28698,13997,14701,48.77343369
VA,Wythe ,2019,0,28684,14014,14670,48.85650537
VA,York ,2015,0,67802,33449,34353,49.333353
VA,York ,2016,0,67832,33282,34550,49.06533789
VA,York ,2017,0,68022,33375,34647,49.06500838
VA,York ,2018,0,67976,33286,34690,48.96728257
VA,York ,2019,0,68280,33516,34764,49.08611599
VA,Alexandria city,2015,0,153654,73973,79681,48.14258008
VA,Alexandria city,2016,0,156698,75564,81134,48.22269589
VA,Alexandria city,2017,0,159215,76842,82373,48.26304054
VA,Alexandria city,2018,0,159069,76671,82398,48.19983781
VA,Alexandria city,2019,0,159428,76899,82529,48.23431267
VA,Bristol city,2015,0,17146,8137,9009,47.45713286
VA,Bristol city,2016,0,17088,8096,8992,47.37827715
VA,Bristol city,2017,0,16880,8016,8864,47.48815166
VA,Bristol city,2018,0,16685,7908,8777,47.39586455
VA,Bristol city,2019,0,16762,7914,8848,47.21393628
VA,Buena Vista city,2015,0,6529,3017,3512,46.2092204
VA,Buena Vista city,2016,0,6435,2957,3478,45.95182595
VA,Buena Vista city,2017,0,6482,2990,3492,46.12773835
VA,Buena Vista city,2018,0,6494,3025,3469,46.58145981
VA,Buena Vista city,2019,0,6478,3026,3452,46.71194813
VA,Charlottesville city,2015,0,46301,22340,23961,48.24949785
VA,Charlottesville city,2016,0,46943,22677,24266,48.30752189
VA,Charlottesville city,2017,0,47463,22982,24481,48.42087521
VA,Charlottesville city,2018,0,47506,23036,24470,48.49071696
VA,Charlottesville city,2019,0,47266,22871,24395,48.3878475
VA,Chesapeake city,2015,0,235111,115074,120037,48.94454109
VA,Chesapeake city,2016,0,237464,116091,121373,48.88783142
VA,Chesapeake city,2017,0,240143,117246,122897,48.82340939
VA,Chesapeake city,2018,0,242359,118341,124018,48.82880355
VA,Chesapeake city,2019,0,244835,119662,125173,48.87454817
VA,Colonial Heights city,2015,0,17444,8089,9355,46.37124513
VA,Colonial Heights city,2016,0,17398,8048,9350,46.2581906
VA,Colonial Heights city,2017,0,17424,8087,9337,46.41299357
VA,Colonial Heights city,2018,0,17504,8011,9493,45.7666819
VA,Colonial Heights city,2019,0,17370,7975,9395,45.9124928
VA,Covington city,2015,0,5663,2750,2913,48.56083348
VA,Covington city,2016,0,5637,2675,2962,47.45431967
VA,Covington city,2017,0,5576,2670,2906,47.88378766
VA,Covington city,2018,0,5578,2667,2911,47.81283614
VA,Covington city,2019,0,5538,2668,2870,48.17623691
VA,Danville city,2015,0,41947,19347,22600,46.1224879
VA,Danville city,2016,0,41665,19214,22451,46.11544462
VA,Danville city,2017,0,41044,18886,22158,46.01403372
VA,Danville city,2018,0,40649,18648,22001,45.8756673
VA,Danville city,2019,0,40044,18392,21652,45.92947757
VA,Emporia city,2015,0,5558,2526,3032,45.44800288
VA,Emporia city,2016,0,5478,2488,2990,45.41803578
VA,Emporia city,2017,0,5467,2489,2978,45.52771172
VA,Emporia city,2018,0,5363,2475,2888,46.14954317
VA,Emporia city,2019,0,5346,2464,2882,46.09053498
VA,Fairfax city,2015,0,23230,11490,11740,49.46190271
VA,Fairfax city,2016,0,23246,11454,11792,49.2729932
VA,Fairfax city,2017,0,23435,11542,11893,49.25112012
VA,Fairfax city,2018,0,23725,11713,12012,49.36986301
VA,Fairfax city,2019,0,24019,11808,12211,49.16108081
VA,Falls Church city,2015,0,13728,6760,6968,49.24242424
VA,Falls Church city,2016,0,13582,6640,6942,48.88823443
VA,Falls Church city,2017,0,14245,6994,7251,49.0979291
VA,Falls Church city,2018,0,14467,7124,7343,49.243105
VA,Falls Church city,2019,0,14617,7194,7423,49.21666553
VA,Franklin city,2015,0,8331,3749,4582,45.00060017
VA,Franklin city,2016,0,8201,3677,4524,44.83599561
VA,Franklin city,2017,0,8145,3672,4473,45.08287293
VA,Franklin city,2018,0,8089,3654,4435,45.17245642
VA,Franklin city,2019,0,7967,3629,4338,45.55039538
VA,Fredericksburg city,2015,0,28043,12830,15213,45.75116785
VA,Fredericksburg city,2016,0,28360,13077,15283,46.11071932
VA,Fredericksburg city,2017,0,28498,13213,15285,46.36465717
VA,Fredericksburg city,2018,0,29171,13484,15687,46.22398958
VA,Fredericksburg city,2019,0,29036,13425,15611,46.2357074
VA,Galax city,2015,0,6800,3164,3636,46.52941176
VA,Galax city,2016,0,6604,3053,3551,46.22955784
VA,Galax city,2017,0,6484,3004,3480,46.32942628
VA,Galax city,2018,0,6348,2947,3401,46.42407057
VA,Galax city,2019,0,6347,2964,3383,46.69922798
VA,Hampton city,2015,0,136264,65790,70474,48.28127752
VA,Hampton city,2016,0,135374,65242,70132,48.19389248
VA,Hampton city,2017,0,134725,64832,69893,48.12172945
VA,Hampton city,2018,0,134330,64625,69705,48.10913422
VA,Hampton city,2019,0,134510,64540,69970,47.98156271
VA,Harrisonburg city,2015,0,52675,25271,27404,47.97532036
VA,Harrisonburg city,2016,0,53542,25648,27894,47.90258115
VA,Harrisonburg city,2017,0,53644,25749,27895,47.9997763
VA,Harrisonburg city,2018,0,53488,25643,27845,47.94159438
VA,Harrisonburg city,2019,0,53016,25496,27520,48.0911423
VA,Hopewell city,2015,0,22231,10363,11868,46.61508704
VA,Hopewell city,2016,0,22539,10502,12037,46.59479125
VA,Hopewell city,2017,0,22505,10510,11995,46.70073317
VA,Hopewell city,2018,0,22478,10488,11990,46.65895542
VA,Hopewell city,2019,0,22529,10512,12017,46.65986062
VA,Lexington city,2015,0,7162,4051,3111,56.56241273
VA,Lexington city,2016,0,7148,4057,3091,56.75713486
VA,Lexington city,2017,0,7154,4084,3070,57.08694437
VA,Lexington city,2018,0,7297,4133,3164,56.63971495
VA,Lexington city,2019,0,7446,4202,3244,56.43298415
VA,Lynchburg city,2015,0,79134,37163,41971,46.96211489
VA,Lynchburg city,2016,0,79710,37359,42351,46.86864885
VA,Lynchburg city,2017,0,80523,37754,42769,46.88598289
VA,Lynchburg city,2018,0,81309,38092,43217,46.84844236
VA,Lynchburg city,2019,0,82168,38559,43609,46.92702755
VA,Manassas city,2015,0,41409,20790,20619,50.20647685
VA,Manassas city,2016,0,41189,20585,20604,49.97693559
VA,Manassas city,2017,0,41141,20610,20531,50.09601128
VA,Manassas city,2018,0,41046,20652,20394,50.31428154
VA,Manassas city,2019,0,41085,20650,20435,50.26165267
VA,Manassas Park city,2015,0,16129,8286,7843,51.37330275
VA,Manassas Park city,2016,0,16456,8539,7917,51.88988819
VA,Manassas Park city,2017,0,17149,8841,8308,51.55402647
VA,Manassas Park city,2018,0,17718,9106,8612,51.39406254
VA,Manassas Park city,2019,0,17478,8965,8513,51.29305413
VA,Martinsville city,2015,0,13259,6063,7196,45.72743042
VA,Martinsville city,2016,0,12996,5971,7025,45.94490612
VA,Martinsville city,2017,0,12823,5906,6917,46.05786477
VA,Martinsville city,2018,0,12627,5846,6781,46.29761622
VA,Martinsville city,2019,0,12554,5842,6712,46.53496893
VA,Newport News city,2015,0,180958,87665,93293,48.44494303
VA,Newport News city,2016,0,180209,87238,92971,48.40934692
VA,Newport News city,2017,0,179447,86953,92494,48.4560901
VA,Newport News city,2018,0,178523,86156,92367,48.26044823
VA,Newport News city,2019,0,179225,86420,92805,48.21871949
VA,Norfolk city,2015,0,246457,128701,117756,52.22046848
VA,Norfolk city,2016,0,245680,128525,117155,52.31398567
VA,Norfolk city,2017,0,244543,127762,116781,52.24520841
VA,Norfolk city,2018,0,243585,127018,116567,52.14524704
VA,Norfolk city,2019,0,242742,126567,116175,52.14054428
VA,Norton city,2015,0,4009,1905,2104,47.51808431
VA,Norton city,2016,0,3972,1877,2095,47.25579053
VA,Norton city,2017,0,3918,1812,2106,46.24808576
VA,Norton city,2018,0,3972,1840,2132,46.32426989
VA,Norton city,2019,0,3981,1864,2117,46.82240643
VA,Petersburg city,2015,0,31892,14646,17246,45.92374263
VA,Petersburg city,2016,0,31380,14428,16952,45.97833015
VA,Petersburg city,2017,0,31137,14278,16859,45.85541317
VA,Petersburg city,2018,0,31056,14231,16825,45.82367336
VA,Petersburg city,2019,0,31346,14347,16999,45.76979519
VA,Poquoson city,2015,0,12021,5955,6066,49.53830796
VA,Poquoson city,2016,0,11952,5936,6016,49.66532798
VA,Poquoson city,2017,0,12039,5974,6065,49.62206163
VA,Poquoson city,2018,0,12169,6086,6083,50.0123264
VA,Poquoson city,2019,0,12271,6152,6119,50.13446337
VA,Portsmouth city,2015,0,96336,46319,50017,48.08067597
VA,Portsmouth city,2016,0,95165,45758,49407,48.08280355
VA,Portsmouth city,2017,0,94838,45605,49233,48.0872646
VA,Portsmouth city,2018,0,94750,45505,49245,48.02638522
VA,Portsmouth city,2019,0,94398,45256,49142,47.94169368
VA,Radford city,2015,0,17295,8218,9077,47.5166233
VA,Radford city,2016,0,17324,8219,9105,47.44285384
VA,Radford city,2017,0,17484,8314,9170,47.55204759
VA,Radford city,2018,0,18101,8488,9613,46.89243688
VA,Radford city,2019,0,18249,8593,9656,47.08751164
VA,Richmond city,2015,0,220856,104709,116147,47.41052994
VA,Richmond city,2016,0,225369,106860,118509,47.4155718
VA,Richmond city,2017,0,227230,107842,119388,47.45940237
VA,Richmond city,2018,0,229221,108681,120540,47.41319513
VA,Richmond city,2019,0,230436,109317,121119,47.43920221
VA,Roanoke city,2015,0,99669,47843,51826,48.00188624
VA,Roanoke city,2016,0,99337,47625,51712,47.94286117
VA,Roanoke city,2017,0,98986,47351,51635,47.83605762
VA,Roanoke city,2018,0,99009,47443,51566,47.91786605
VA,Roanoke city,2019,0,99143,47300,51843,47.70886497
VA,Salem city,2015,0,25364,12085,13279,47.6462703
VA,Salem city,2016,0,25252,12047,13205,47.70711231
VA,Salem city,2017,0,25373,12105,13268,47.70819375
VA,Salem city,2018,0,25293,12032,13261,47.57047404
VA,Salem city,2019,0,25301,12053,13248,47.63843326
VA,Staunton city,2015,0,24185,10991,13194,45.44552409
VA,Staunton city,2016,0,24156,11012,13144,45.58701772
VA,Staunton city,2017,0,24325,11142,13183,45.80472765
VA,Staunton city,2018,0,24562,11280,13282,45.92459897
VA,Staunton city,2019,0,24932,11463,13469,45.9770576
VA,Suffolk city,2015,0,88079,42634,45445,48.40427344
VA,Suffolk city,2016,0,89194,43128,46066,48.35302823
VA,Suffolk city,2017,0,90108,43701,46407,48.4984685
VA,Suffolk city,2018,0,90975,44056,46919,48.42649079
VA,Suffolk city,2019,0,92108,44720,47388,48.55170018
VA,Virginia Beach city,2015,0,450304,221526,228778,49.1947662
VA,Virginia Beach city,2016,0,450983,221683,229300,49.15551141
VA,Virginia Beach city,2017,0,449896,220937,228959,49.10846062
VA,Virginia Beach city,2018,0,449849,220961,228888,49.11892657
VA,Virginia Beach city,2019,0,449974,220738,229236,49.05572322
VA,Waynesboro city,2015,0,21542,10237,11305,47.52112153
VA,Waynesboro city,2016,0,21757,10399,11358,47.7961116
VA,Waynesboro city,2017,0,22242,10679,11563,48.01276864
VA,Waynesboro city,2018,0,22531,10774,11757,47.81856109
VA,Waynesboro city,2019,0,22630,10842,11788,47.90985418
VA,Williamsburg city,2015,0,14800,6803,7997,45.96621622
VA,Williamsburg city,2016,0,14884,6821,8063,45.82773448
VA,Williamsburg city,2017,0,14994,6850,8144,45.68494064
VA,Williamsburg city,2018,0,15002,6893,8109,45.94720704
VA,Williamsburg city,2019,0,14954,6881,8073,46.0144443
VA,Winchester city,2015,0,27480,13517,13963,49.18850073
VA,Winchester city,2016,0,27785,13651,14134,49.13082599
VA,Winchester city,2017,0,28178,13855,14323,49.16956491
VA,Winchester city,2018,0,27962,13693,14269,48.97003076
VA,Winchester city,2019,0,28078,13812,14266,49.19153786
WA,Adams ,2015,0,19233,9825,9408,51.08407425
WA,Adams ,2016,0,19369,9864,9505,50.9267386
WA,Adams ,2017,0,19651,9978,9673,50.77604193
WA,Adams ,2018,0,19736,10024,9712,50.79043373
WA,Adams ,2019,0,19983,10206,9777,51.0734124
WA,Asotin ,2015,0,22113,10755,11358,48.63654864
WA,Asotin ,2016,0,22286,10838,11448,48.6314278
WA,Asotin ,2017,0,22509,10940,11569,48.60278111
WA,Asotin ,2018,0,22616,11028,11588,48.76193845
WA,Asotin ,2019,0,22582,11050,11532,48.93277832
WA,Benton ,2015,0,190218,95092,95126,49.99106289
WA,Benton ,2016,0,193494,96887,96607,50.07235366
WA,Benton ,2017,0,198200,99384,98816,50.14328961
WA,Benton ,2018,0,201286,100868,100418,50.11178125
WA,Benton ,2019,0,204390,102423,101967,50.11155145
WA,Chelan ,2015,0,75041,37449,37592,49.90471875
WA,Chelan ,2016,0,75855,37864,37991,49.91628765
WA,Chelan ,2017,0,76298,38210,38088,50.07994967
WA,Chelan ,2018,0,76752,38449,38303,50.09511153
WA,Chelan ,2019,0,77200,38686,38514,50.11139896
WA,Clallam ,2015,0,73202,36184,37018,49.43034343
WA,Clallam ,2016,0,74240,36691,37549,49.4221444
WA,Clallam ,2017,0,75637,37371,38266,49.40835834
WA,Clallam ,2018,0,76551,37787,38764,49.36186333
WA,Clallam ,2019,0,77331,38189,39142,49.38381762
WA,Clark ,2015,0,456939,225627,231312,49.37792572
WA,Clark ,2016,0,465272,229878,235394,49.40722846
WA,Clark ,2017,0,474381,234500,239881,49.43283985
WA,Clark ,2018,0,481427,237864,243563,49.4081138
WA,Clark ,2019,0,488241,241344,246897,49.43132592
WA,Columbia ,2015,0,3960,1931,2029,48.76262626
WA,Columbia ,2016,0,3975,1939,2036,48.77987421
WA,Columbia ,2017,0,4002,1948,2054,48.67566217
WA,Columbia ,2018,0,4039,1976,2063,48.92300074
WA,Columbia ,2019,0,3985,1944,2041,48.78293601
WA,Cowlitz ,2015,0,102999,50970,52029,49.48591734
WA,Cowlitz ,2016,0,104740,51799,52941,49.45484056
WA,Cowlitz ,2017,0,106805,52907,53898,49.53607041
WA,Cowlitz ,2018,0,108752,53805,54947,49.47495218
WA,Cowlitz ,2019,0,110593,54755,55838,49.51036684
WA,Douglas ,2015,0,40545,20472,20073,50.49204587
WA,Douglas ,2016,0,41366,20935,20431,50.60919596
WA,Douglas ,2017,0,42027,21221,20806,50.49373022
WA,Douglas ,2018,0,42749,21629,21120,50.59533556
WA,Douglas ,2019,0,43429,21972,21457,50.59292178
WA,Ferry ,2015,0,7520,3888,3632,51.70212766
WA,Ferry ,2016,0,7531,3907,3624,51.87890054
WA,Ferry ,2017,0,7576,3899,3677,51.46515312
WA,Ferry ,2018,0,7638,3921,3717,51.33542812
WA,Ferry ,2019,0,7627,3921,3706,51.40946637
WA,Franklin ,2015,0,88727,45854,42873,51.67987197
WA,Franklin ,2016,0,90199,46528,43671,51.58372044
WA,Franklin ,2017,0,91896,47481,44415,51.66819013
WA,Franklin ,2018,0,94003,48545,45458,51.64196887
WA,Franklin ,2019,0,95222,49124,46098,51.58891853
WA,Garfield ,2015,0,2222,1081,1141,48.64986499
WA,Garfield ,2016,0,2246,1102,1144,49.06500445
WA,Garfield ,2017,0,2215,1085,1130,48.98419865
WA,Garfield ,2018,0,2240,1100,1140,49.10714286
WA,Garfield ,2019,0,2225,1085,1140,48.76404494
WA,Grant ,2015,0,93527,47398,46129,50.67841372
WA,Grant ,2016,0,94221,47811,46410,50.74346483
WA,Grant ,2017,0,95357,48430,46927,50.78809107
WA,Grant ,2018,0,96672,49166,47506,50.85857332
WA,Grant ,2019,0,97733,49686,48047,50.838509
WA,Grays Harbor ,2015,0,71011,36490,34521,51.38640492
WA,Grays Harbor ,2016,0,71531,36661,34870,51.25190477
WA,Grays Harbor ,2017,0,72490,37164,35326,51.26776107
WA,Grays Harbor ,2018,0,73801,37735,36066,51.13074349
WA,Grays Harbor ,2019,0,75061,38370,36691,51.11842368
WA,Island ,2015,0,80022,39923,40099,49.89003024
WA,Island ,2016,0,81692,40662,41030,49.77476375
WA,Island ,2017,0,83250,41444,41806,49.78258258
WA,Island ,2018,0,84227,41993,42234,49.85693424
WA,Island ,2019,0,85141,42398,42743,49.79739491
WA,Jefferson ,2015,0,30339,14965,15374,49.3259501
WA,Jefferson ,2016,0,30910,15202,15708,49.18149466
WA,Jefferson ,2017,0,31210,15304,15906,49.03556552
WA,Jefferson ,2018,0,31746,15511,16235,48.85969886
WA,Jefferson ,2019,0,32221,15766,16455,48.93082151
WA,King ,2015,0,2126178,1062666,1063512,49.98010515
WA,King ,2016,0,2166350,1084724,1081626,50.07150276
WA,King ,2017,0,2203836,1104960,1098876,50.13803205
WA,King ,2018,0,2228364,1118654,1109710,50.20068535
WA,King ,2019,0,2252782,1132272,1120510,50.261055
WA,Kitsap ,2015,0,259232,132419,126813,51.08127083
WA,Kitsap ,2016,0,263142,134614,128528,51.15640985
WA,Kitsap ,2017,0,266289,136261,130028,51.170345
WA,Kitsap ,2018,0,269276,137727,131549,51.14715014
WA,Kitsap ,2019,0,271473,138788,132685,51.12405285
WA,Kittitas ,2015,0,43095,21743,21352,50.45364892
WA,Kittitas ,2016,0,44922,22712,22210,50.55874627
WA,Kittitas ,2017,0,46176,23324,22852,50.51108801
WA,Kittitas ,2018,0,47358,23933,23425,50.53634022
WA,Kittitas ,2019,0,47935,24205,23730,50.49546261
WA,Klickitat ,2015,0,21005,10616,10389,50.54034754
WA,Klickitat ,2016,0,21286,10778,10508,50.63421967
WA,Klickitat ,2017,0,21751,10997,10754,50.55859501
WA,Klickitat ,2018,0,22136,11207,10929,50.62793639
WA,Klickitat ,2019,0,22425,11356,11069,50.63991081
WA,Lewis ,2015,0,75437,37758,37679,50.05236157
WA,Lewis ,2016,0,76693,38398,38295,50.06715085
WA,Lewis ,2017,0,78320,39135,39185,49.96807967
WA,Lewis ,2018,0,79569,39762,39807,49.97172266
WA,Lewis ,2019,0,80707,40413,40294,50.07372347
WA,Lincoln ,2015,0,10285,5216,5069,50.71463296
WA,Lincoln ,2016,0,10335,5221,5114,50.51765844
WA,Lincoln ,2017,0,10585,5369,5216,50.72272083
WA,Lincoln ,2018,0,10726,5481,5245,51.10013052
WA,Lincoln ,2019,0,10939,5572,5367,50.93701435
WA,Mason ,2015,0,60991,31467,29524,51.59285796
WA,Mason ,2016,0,62142,32086,30056,51.63335586
WA,Mason ,2017,0,63740,32952,30788,51.69752118
WA,Mason ,2018,0,65380,33933,31447,51.90119303
WA,Mason ,2019,0,66768,34638,32130,51.87814522
WA,Okanogan ,2015,0,41356,20807,20549,50.31192572
WA,Okanogan ,2016,0,41579,20901,20678,50.26816422
WA,Okanogan ,2017,0,41915,21146,20769,50.44971967
WA,Okanogan ,2018,0,42117,21248,20869,50.44993708
WA,Okanogan ,2019,0,42243,21333,20910,50.50067467
WA,Pacific ,2015,0,20869,10486,10383,50.24677752
WA,Pacific ,2016,0,21285,10694,10591,50.24195443
WA,Pacific ,2017,0,21742,10880,10862,50.04139454
WA,Pacific ,2018,0,22074,10999,11075,49.82785177
WA,Pacific ,2019,0,22471,11159,11312,49.65956121
WA,Pend Oreille ,2015,0,13087,6661,6426,50.89783755
WA,Pend Oreille ,2016,0,13131,6686,6445,50.91767573
WA,Pend Oreille ,2017,0,13358,6816,6542,51.02560264
WA,Pend Oreille ,2018,0,13586,6926,6660,50.97894892
WA,Pend Oreille ,2019,0,13724,7012,6712,51.09297581
WA,Pierce ,2015,0,843778,420306,423472,49.81239141
WA,Pierce ,2016,0,862895,430482,432413,49.88810921
WA,Pierce ,2017,0,879654,438886,440768,49.89302612
WA,Pierce ,2018,0,893756,446092,447664,49.91205653
WA,Pierce ,2019,0,904980,451617,453363,49.90353378
WA,San Juan ,2015,0,16198,7839,8359,48.39486356
WA,San Juan ,2016,0,16309,7879,8430,48.31074867
WA,San Juan ,2017,0,16729,8077,8652,48.28142746
WA,San Juan ,2018,0,17124,8284,8840,48.37654754
WA,San Juan ,2019,0,17582,8499,9083,48.33921056
WA,Skagit ,2015,0,121559,60215,61344,49.53561645
WA,Skagit ,2016,0,123603,61178,62425,49.49556241
WA,Skagit ,2017,0,125860,62333,63527,49.52566344
WA,Skagit ,2018,0,127835,63319,64516,49.53181836
WA,Skagit ,2019,0,129205,63932,65273,49.48105723
WA,Skamania ,2015,0,11375,5768,5607,50.70769231
WA,Skamania ,2016,0,11581,5895,5686,50.90234004
WA,Skamania ,2017,0,11809,6007,5802,50.86798205
WA,Skamania ,2018,0,11919,6062,5857,50.85997147
WA,Skamania ,2019,0,12083,6153,5930,50.92278408
WA,Snohomish ,2015,0,769698,385712,383986,50.1121219
WA,Snohomish ,2016,0,787110,394636,392474,50.13733786
WA,Snohomish ,2017,0,802089,402197,399892,50.1436873
WA,Snohomish ,2018,0,813059,407797,405262,50.15589275
WA,Snohomish ,2019,0,822083,412656,409427,50.19639136
WA,Spokane ,2015,0,488610,242256,246354,49.58064714
WA,Spokane ,2016,0,496889,246488,250401,49.60625009
WA,Spokane ,2017,0,505623,250710,254913,49.58437413
WA,Spokane ,2018,0,513603,254628,258975,49.57681322
WA,Spokane ,2019,0,522798,259299,263499,49.59831522
WA,Stevens ,2015,0,43553,21685,21868,49.78991114
WA,Stevens ,2016,0,44141,21904,22237,49.62279966
WA,Stevens ,2017,0,44636,22207,22429,49.7513218
WA,Stevens ,2018,0,45224,22551,22673,49.86511587
WA,Stevens ,2019,0,45723,22820,22903,49.90923605
WA,Thurston ,2015,0,267978,131032,136946,48.89655121
WA,Thurston ,2016,0,273714,133814,139900,48.88825562
WA,Thurston ,2017,0,280269,137093,143176,48.91479257
WA,Thurston ,2018,0,286056,139924,146132,48.91489778
WA,Thurston ,2019,0,290536,142056,148480,48.89445714
WA,Wahkiakum ,2015,0,4023,2026,1997,50.36042754
WA,Wahkiakum ,2016,0,4161,2103,2058,50.5407354
WA,Wahkiakum ,2017,0,4251,2135,2116,50.22347683
WA,Wahkiakum ,2018,0,4415,2215,2200,50.16987542
WA,Wahkiakum ,2019,0,4488,2238,2250,49.86631016
WA,Walla Walla ,2015,0,59932,30677,29255,51.18634452
WA,Walla Walla ,2016,0,60008,30685,29323,51.13484869
WA,Walla Walla ,2017,0,60512,30937,29575,51.12539662
WA,Walla Walla ,2018,0,60615,30958,29657,51.07316671
WA,Walla Walla ,2019,0,60760,30952,29808,50.94140882
WA,Whatcom ,2015,0,211836,105056,106780,49.59308144
WA,Whatcom ,2016,0,216417,107347,109070,49.60192591
WA,Whatcom ,2017,0,221410,109649,111761,49.52305677
WA,Whatcom ,2018,0,225197,111390,113807,49.46335875
WA,Whatcom ,2019,0,229247,113255,115992,49.40304562
WA,Whitman ,2015,0,48164,24588,23576,51.05057719
WA,Whitman ,2016,0,48824,24912,23912,51.02408651
WA,Whitman ,2017,0,49382,25160,24222,50.94973877
WA,Whitman ,2018,0,49683,25297,24386,50.91681259
WA,Whitman ,2019,0,50104,25502,24602,50.89813189
WA,Yakima ,2015,0,247800,124056,123744,50.062954
WA,Yakima ,2016,0,249327,124810,124517,50.05875818
WA,Yakima ,2017,0,249922,125001,124921,50.01600499
WA,Yakima ,2018,0,250562,125163,125399,49.95290587
WA,Yakima ,2019,0,250873,125337,125536,49.9603385
WV,Barbour ,2015,0,16973,8280,8693,48.78336181
WV,Barbour ,2016,0,16749,8187,8562,48.88053018
WV,Barbour ,2017,0,16515,8114,8401,49.13109295
WV,Barbour ,2018,0,16487,8078,8409,48.99617881
WV,Barbour ,2019,0,16441,8032,8409,48.85347607
WV,Berkeley ,2015,0,111678,55160,56518,49.39200201
WV,Berkeley ,2016,0,113489,56158,57331,49.48320983
WV,Berkeley ,2017,0,115073,57023,58050,49.55376153
WV,Berkeley ,2018,0,117236,58119,59117,49.57436282
WV,Berkeley ,2019,0,119171,59257,59914,49.72434569
WV,Boone ,2015,0,23252,11582,11670,49.81076897
WV,Boone ,2016,0,22809,11372,11437,49.85751239
WV,Boone ,2017,0,22369,11174,11195,49.95306004
WV,Boone ,2018,0,21953,10953,11000,49.89295313
WV,Boone ,2019,0,21457,10686,10771,49.80192944
WV,Braxton ,2015,0,14375,7277,7098,50.6226087
WV,Braxton ,2016,0,14323,7226,7097,50.45032465
WV,Braxton ,2017,0,14217,7198,7019,50.62952803
WV,Braxton ,2018,0,14076,7118,6958,50.56834328
WV,Braxton ,2019,0,13957,7040,6917,50.44063911
WV,Brooke ,2015,0,23190,11346,11844,48.92626132
WV,Brooke ,2016,0,22663,11113,11550,49.03587345
WV,Brooke ,2017,0,22373,10987,11386,49.10830018
WV,Brooke ,2018,0,22129,10878,11251,49.15721451
WV,Brooke ,2019,0,21939,10836,11103,49.3914946
WV,Cabell ,2015,0,96582,47242,49340,48.91387629
WV,Cabell ,2016,0,95681,46843,48838,48.95747327
WV,Cabell ,2017,0,94452,46194,48258,48.90738153
WV,Cabell ,2018,0,93035,45487,47548,48.89235234
WV,Cabell ,2019,0,91945,44858,47087,48.78786231
WV,Calhoun ,2015,0,7463,3719,3744,49.83250703
WV,Calhoun ,2016,0,7374,3659,3715,49.6202875
WV,Calhoun ,2017,0,7310,3643,3667,49.83584131
WV,Calhoun ,2018,0,7217,3592,3625,49.77137315
WV,Calhoun ,2019,0,7109,3560,3549,50.07736672
WV,Clay ,2015,0,8875,4459,4416,50.24225352
WV,Clay ,2016,0,8829,4433,4396,50.20953675
WV,Clay ,2017,0,8693,4365,4328,50.21281491
WV,Clay ,2018,0,8639,4362,4277,50.49195509
WV,Clay ,2019,0,8508,4302,4206,50.56417489
WV,Doddridge ,2015,0,8703,4790,3913,55.03849247
WV,Doddridge ,2016,0,8576,4698,3878,54.78078358
WV,Doddridge ,2017,0,8518,4680,3838,54.94247476
WV,Doddridge ,2018,0,8556,4753,3803,55.55165965
WV,Doddridge ,2019,0,8448,4702,3746,55.65814394
WV,Fayette ,2015,0,44707,22528,22179,50.39031919
WV,Fayette ,2016,0,44179,22254,21925,50.37234885
WV,Fayette ,2017,0,43607,22016,21591,50.48730708
WV,Fayette ,2018,0,42982,21649,21333,50.36759574
WV,Fayette ,2019,0,42406,21341,21065,50.32542565
WV,Gilmer ,2015,0,8306,4934,3372,59.40284132
WV,Gilmer ,2016,0,8134,4825,3309,59.31890829
WV,Gilmer ,2017,0,8042,4799,3243,59.6742104
WV,Gilmer ,2018,0,7898,4682,3216,59.28083059
WV,Gilmer ,2019,0,7823,4635,3188,59.24837019
WV,Grant ,2015,0,11651,5837,5814,50.09870397
WV,Grant ,2016,0,11602,5797,5805,49.96552319
WV,Grant ,2017,0,11627,5805,5822,49.9268943
WV,Grant ,2018,0,11630,5796,5834,49.83662941
WV,Grant ,2019,0,11568,5769,5799,49.87033195
WV,Greenbrier ,2015,0,35580,17377,18203,48.83923553
WV,Greenbrier ,2016,0,35532,17328,18204,48.76730834
WV,Greenbrier ,2017,0,35208,17230,17978,48.93774142
WV,Greenbrier ,2018,0,34792,17004,17788,48.87330421
WV,Greenbrier ,2019,0,34662,16973,17689,48.96716866
WV,Hampshire ,2015,0,23311,11863,11448,50.8901377
WV,Hampshire ,2016,0,23316,11864,11452,50.88351347
WV,Hampshire ,2017,0,23386,11918,11468,50.96211409
WV,Hampshire ,2018,0,23357,11926,11431,51.05963951
WV,Hampshire ,2019,0,23175,11802,11373,50.92556634
WV,Hancock ,2015,0,29980,14595,15385,48.68245497
WV,Hancock ,2016,0,29662,14467,15195,48.77284067
WV,Hancock ,2017,0,29383,14328,15055,48.76289011
WV,Hancock ,2018,0,29079,14158,14921,48.68805667
WV,Hancock ,2019,0,28810,14022,14788,48.67060049
WV,Hardy ,2015,0,13826,6953,6873,50.28931
WV,Hardy ,2016,0,13812,6966,6846,50.43440487
WV,Hardy ,2017,0,13849,6980,6869,50.40075096
WV,Hardy ,2018,0,13764,6961,6803,50.57396106
WV,Hardy ,2019,0,13776,6952,6824,50.46457607
WV,Harrison ,2015,0,68535,33633,34902,49.07419567
WV,Harrison ,2016,0,68349,33551,34798,49.08777012
WV,Harrison ,2017,0,67905,33349,34556,49.11125838
WV,Harrison ,2018,0,67494,33167,34327,49.14066436
WV,Harrison ,2019,0,67256,33101,34155,49.21642679
WV,Jackson ,2015,0,29170,14422,14748,49.44120672
WV,Jackson ,2016,0,29188,14435,14753,49.45525558
WV,Jackson ,2017,0,28908,14331,14577,49.57451225
WV,Jackson ,2018,0,28695,14248,14447,49.6532497
WV,Jackson ,2019,0,28576,14213,14363,49.73754199
WV,Jefferson ,2015,0,56070,27695,28375,49.39361512
WV,Jefferson ,2016,0,55979,27702,28277,49.48641455
WV,Jefferson ,2017,0,56444,27976,28468,49.5641698
WV,Jefferson ,2018,0,56890,28213,28677,49.59219546
WV,Jefferson ,2019,0,57146,28361,28785,49.6290204
WV,Kanawha ,2015,0,188282,90839,97443,48.24624765
WV,Kanawha ,2016,0,186196,89775,96421,48.21532149
WV,Kanawha ,2017,0,183385,88414,94971,48.2122311
WV,Kanawha ,2018,0,180410,86909,93501,48.17305027
WV,Kanawha ,2019,0,178124,85820,92304,48.17991961
WV,Lewis ,2015,0,16440,8151,8289,49.58029197
WV,Lewis ,2016,0,16289,8137,8152,49.95395666
WV,Lewis ,2017,0,16178,8019,8159,49.56731364
WV,Lewis ,2018,0,16017,7962,8055,49.70968346
WV,Lewis ,2019,0,15907,7915,7992,49.75796819
WV,Lincoln ,2015,0,21279,10597,10682,49.80027257
WV,Lincoln ,2016,0,21108,10498,10610,49.73469774
WV,Lincoln ,2017,0,20872,10353,10519,49.60233806
WV,Lincoln ,2018,0,20583,10204,10379,49.5748919
WV,Lincoln ,2019,0,20409,10104,10305,49.50757019
WV,Logan ,2015,0,34441,16965,17476,49.25815162
WV,Logan ,2016,0,33674,16535,17139,49.10316565
WV,Logan ,2017,0,33028,16284,16744,49.30362117
WV,Logan ,2018,0,32609,16080,16529,49.31153976
WV,Logan ,2019,0,32019,15787,16232,49.3051001
WV,McDowell ,2015,0,19762,9643,10119,48.79566845
WV,McDowell ,2016,0,19192,9384,9808,48.89537307
WV,McDowell ,2017,0,18505,9032,9473,48.80843015
WV,McDowell ,2018,0,18221,8921,9300,48.95999122
WV,McDowell ,2019,0,17624,8631,8993,48.97299138
WV,Marion ,2015,0,56761,27955,28806,49.25036557
WV,Marion ,2016,0,56504,27851,28653,49.29031573
WV,Marion ,2017,0,56349,27764,28585,49.27150437
WV,Marion ,2018,0,56091,27708,28383,49.39829919
WV,Marion ,2019,0,56072,27748,28324,49.48637466
WV,Marshall ,2015,0,32215,15891,16324,49.32795282
WV,Marshall ,2016,0,31720,15645,16075,49.3221942
WV,Marshall ,2017,0,31252,15407,15845,49.29924485
WV,Marshall ,2018,0,30821,15263,15558,49.52143019
WV,Marshall ,2019,0,30531,15158,15373,49.64789886
WV,Mason ,2015,0,27089,13065,14024,48.22990882
WV,Mason ,2016,0,26938,13006,13932,48.2812384
WV,Mason ,2017,0,26806,12947,13859,48.29888831
WV,Mason ,2018,0,26752,12940,13812,48.37021531
WV,Mason ,2019,0,26516,12805,13711,48.29159753
WV,Mercer ,2015,0,61133,29272,31861,47.88248573
WV,Mercer ,2016,0,60632,29030,31602,47.87900778
WV,Mercer ,2017,0,59869,28675,31194,47.89624012
WV,Mercer ,2018,0,59202,28411,30791,47.98993277
WV,Mercer ,2019,0,58758,28193,30565,47.98155145
WV,Mineral ,2015,0,27417,13666,13751,49.84498669
WV,Mineral ,2016,0,27375,13614,13761,49.73150685
WV,Mineral ,2017,0,27223,13590,13633,49.92102266
WV,Mineral ,2018,0,26953,13416,13537,49.77553519
WV,Mineral ,2019,0,26868,13382,13486,49.80646122
WV,Mingo ,2015,0,25317,12449,12868,49.17249279
WV,Mingo ,2016,0,24716,12169,12547,49.23531316
WV,Mingo ,2017,0,24142,11847,12295,49.07215641
WV,Mingo ,2018,0,23851,11759,12092,49.30191606
WV,Mingo ,2019,0,23424,11577,11847,49.42366803
WV,Monongalia ,2015,0,104681,54088,50593,51.66935738
WV,Monongalia ,2016,0,105643,54574,51069,51.6588889
WV,Monongalia ,2017,0,105782,54578,51204,51.59478928
WV,Monongalia ,2018,0,105651,54367,51284,51.45904913
WV,Monongalia ,2019,0,105612,54272,51340,51.38809984
WV,Monroe ,2015,0,13573,6763,6810,49.82686215
WV,Monroe ,2016,0,13487,6734,6753,49.9295618
WV,Monroe ,2017,0,13382,6688,6694,49.97758183
WV,Monroe ,2018,0,13289,6644,6645,49.99623749
WV,Monroe ,2019,0,13275,6614,6661,49.82297552
WV,Morgan ,2015,0,17490,8705,8785,49.77129788
WV,Morgan ,2016,0,17626,8775,8851,49.7844094
WV,Morgan ,2017,0,17716,8826,8890,49.81937232
WV,Morgan ,2018,0,17830,8926,8904,50.06169377
WV,Morgan ,2019,0,17884,8983,8901,50.2292552
WV,Nicholas ,2015,0,25551,12585,12966,49.25443231
WV,Nicholas ,2016,0,25381,12457,12924,49.08002049
WV,Nicholas ,2017,0,25125,12347,12778,49.14228856
WV,Nicholas ,2018,0,24835,12248,12587,49.31749547
WV,Nicholas ,2019,0,24496,12066,12430,49.25702155
WV,Ohio ,2015,0,42969,20620,22349,47.98808443
WV,Ohio ,2016,0,42629,20514,22115,48.12217035
WV,Ohio ,2017,0,42001,20271,21730,48.26313659
WV,Ohio ,2018,0,41705,20127,21578,48.26040043
WV,Ohio ,2019,0,41411,20032,21379,48.37362054
WV,Pendleton ,2015,0,7103,3577,3526,50.35900324
WV,Pendleton ,2016,0,6977,3518,3459,50.42281783
WV,Pendleton ,2017,0,6973,3517,3456,50.43740141
WV,Pendleton ,2018,0,6984,3514,3470,50.31500573
WV,Pendleton ,2019,0,6969,3508,3461,50.33720763
WV,Pleasants ,2015,0,7499,4043,3456,53.91385518
WV,Pleasants ,2016,0,7490,4051,3439,54.08544726
WV,Pleasants ,2017,0,7455,4036,3419,54.13816231
WV,Pleasants ,2018,0,7505,4073,3432,54.27048634
WV,Pleasants ,2019,0,7460,4045,3415,54.22252011
WV,Pocahontas ,2015,0,8573,4399,4174,51.31225942
WV,Pocahontas ,2016,0,8528,4369,4159,51.23123827
WV,Pocahontas ,2017,0,8493,4363,4130,51.37171789
WV,Pocahontas ,2018,0,8408,4312,4096,51.28449096
WV,Pocahontas ,2019,0,8247,4220,4027,51.17012247
WV,Preston ,2015,0,33842,17422,16420,51.48040896
WV,Preston ,2016,0,33760,17336,16424,51.3507109
WV,Preston ,2017,0,33826,17392,16434,51.41607048
WV,Preston ,2018,0,33553,17165,16388,51.15786964
WV,Preston ,2019,0,33432,17129,16303,51.23534338
WV,Putnam ,2015,0,56592,27808,28784,49.13768731
WV,Putnam ,2016,0,56675,27814,28861,49.07631231
WV,Putnam ,2017,0,56692,27931,28761,49.26797432
WV,Putnam ,2018,0,56642,27860,28782,49.18611631
WV,Putnam ,2019,0,56450,27834,28616,49.30735164
WV,Raleigh ,2015,0,77363,38754,38609,50.09371405
WV,Raleigh ,2016,0,76296,38244,38052,50.12582573
WV,Raleigh ,2017,0,75066,37614,37452,50.10790504
WV,Raleigh ,2018,0,74172,37152,37020,50.08898237
WV,Raleigh ,2019,0,73361,36818,36543,50.18742929
WV,Randolph ,2015,0,29212,15100,14112,51.69108586
WV,Randolph ,2016,0,29034,15009,14025,51.69456499
WV,Randolph ,2017,0,28894,14950,13944,51.74084585
WV,Randolph ,2018,0,28814,14921,13893,51.78385507
WV,Randolph ,2019,0,28695,14918,13777,51.98815125
WV,Ritchie ,2015,0,10084,5041,5043,49.9900833
WV,Ritchie ,2016,0,9985,4999,4986,50.06509765
WV,Ritchie ,2017,0,9851,4903,4948,49.77159679
WV,Ritchie ,2018,0,9748,4868,4880,49.93844891
WV,Ritchie ,2019,0,9554,4765,4789,49.87439816
WV,Roane ,2015,0,14375,7120,7255,49.53043478
WV,Roane ,2016,0,14114,6972,7142,49.39776109
WV,Roane ,2017,0,14004,6923,7081,49.43587546
WV,Roane ,2018,0,13918,6853,7065,49.23839632
WV,Roane ,2019,0,13688,6748,6940,49.29865576
WV,Summers ,2015,0,13137,5961,7176,45.37565654
WV,Summers ,2016,0,12978,5850,7128,45.07628294
WV,Summers ,2017,0,12882,5836,7046,45.3035243
WV,Summers ,2018,0,12672,5754,6918,45.40719697
WV,Summers ,2019,0,12573,5718,6855,45.47840611
WV,Taylor ,2015,0,16930,8554,8376,50.52569403
WV,Taylor ,2016,0,16952,8593,8359,50.69018405
WV,Taylor ,2017,0,16914,8566,8348,50.64443656
WV,Taylor ,2018,0,16828,8547,8281,50.79034942
WV,Taylor ,2019,0,16695,8465,8230,50.70380353
WV,Tucker ,2015,0,7089,3623,3466,51.10734941
WV,Tucker ,2016,0,7053,3612,3441,51.21225011
WV,Tucker ,2017,0,6992,3578,3414,51.17276888
WV,Tucker ,2018,0,6937,3534,3403,50.9442122
WV,Tucker ,2019,0,6839,3478,3361,50.85538821
WV,Tyler ,2015,0,8958,4441,4517,49.57579817
WV,Tyler ,2016,0,8967,4461,4506,49.74907996
WV,Tyler ,2017,0,8800,4412,4388,50.13636364
WV,Tyler ,2018,0,8740,4388,4352,50.20594966
WV,Tyler ,2019,0,8591,4328,4263,50.37830288
WV,Upshur ,2015,0,24727,12257,12470,49.56929672
WV,Upshur ,2016,0,24680,12243,12437,49.60696921
WV,Upshur ,2017,0,24555,12159,12396,49.5174099
WV,Upshur ,2018,0,24372,12080,12292,49.56507468
WV,Upshur ,2019,0,24176,11985,12191,49.57395764
WV,Wayne ,2015,0,41211,20073,21138,48.70786926
WV,Wayne ,2016,0,40724,19834,20890,48.70346724
WV,Wayne ,2017,0,40215,19664,20551,48.89717767
WV,Wayne ,2018,0,39961,19542,20419,48.90268011
WV,Wayne ,2019,0,39402,19274,20128,48.91629867
WV,Webster ,2015,0,8635,4280,4355,49.5657209
WV,Webster ,2016,0,8557,4259,4298,49.7721164
WV,Webster ,2017,0,8348,4187,4161,50.15572592
WV,Webster ,2018,0,8274,4136,4138,49.98791395
WV,Webster ,2019,0,8114,4081,4033,50.29578506
WV,Wetzel ,2015,0,15777,7777,8000,49.29327502
WV,Wetzel ,2016,0,15644,7720,7924,49.34799284
WV,Wetzel ,2017,0,15433,7583,7850,49.13497052
WV,Wetzel ,2018,0,15259,7493,7766,49.10544597
WV,Wetzel ,2019,0,15065,7374,7691,48.94789247
WV,Wirt ,2015,0,5804,2946,2858,50.75809786
WV,Wirt ,2016,0,5767,2931,2836,50.82365181
WV,Wirt ,2017,0,5786,2945,2841,50.89872105
WV,Wirt ,2018,0,5811,2948,2863,50.73137154
WV,Wirt ,2019,0,5821,2961,2860,50.86754853
WV,Wood ,2015,0,86335,41781,44554,48.39404645
WV,Wood ,2016,0,85709,41485,44224,48.40215147
WV,Wood ,2017,0,85060,41233,43827,48.47519398
WV,Wood ,2018,0,84180,40864,43316,48.54359705
WV,Wood ,2019,0,83518,40519,42999,48.51529012
WV,Wyoming ,2015,0,22177,10938,11239,49.32136899
WV,Wyoming ,2016,0,21777,10738,11039,49.30890389
WV,Wyoming ,2017,0,21271,10503,10768,49.37708617
WV,Wyoming ,2018,0,20784,10276,10508,49.44187837
WV,Wyoming ,2019,0,20394,10073,10321,49.39197803
WI,Adams ,2015,0,20028,10704,9324,53.44517675
WI,Adams ,2016,0,19982,10701,9281,53.55319788
WI,Adams ,2017,0,19900,10630,9270,53.41708543
WI,Adams ,2018,0,20341,10912,9429,53.64534684
WI,Adams ,2019,0,20220,10760,9460,53.21463897
WI,Ashland ,2015,0,15804,7963,7841,50.38597823
WI,Ashland ,2016,0,15633,7865,7768,50.31024116
WI,Ashland ,2017,0,15501,7780,7721,50.1903103
WI,Ashland ,2018,0,15587,7831,7756,50.2405851
WI,Ashland ,2019,0,15562,7807,7755,50.16707364
WI,Barron ,2015,0,45367,22712,22655,50.06282099
WI,Barron ,2016,0,45242,22664,22578,50.09504443
WI,Barron ,2017,0,45141,22578,22563,50.01661461
WI,Barron ,2018,0,45150,22576,22574,50.00221484
WI,Barron ,2019,0,45244,22617,22627,49.98894881
WI,Bayfield ,2015,0,14976,7675,7301,51.24866453
WI,Bayfield ,2016,0,14923,7604,7319,50.95490183
WI,Bayfield ,2017,0,15006,7644,7362,50.93962415
WI,Bayfield ,2018,0,15026,7653,7373,50.93171835
WI,Bayfield ,2019,0,15036,7639,7397,50.8047353
WI,Brown ,2015,0,257856,127919,129937,49.60869633
WI,Brown ,2016,0,259514,128720,130794,49.60040691
WI,Brown ,2017,0,261762,129725,132037,49.55837746
WI,Brown ,2018,0,263165,130496,132669,49.58714115
WI,Brown ,2019,0,264542,131249,133293,49.61367193
WI,Buffalo ,2015,0,13245,6717,6528,50.71347678
WI,Buffalo ,2016,0,13134,6683,6451,50.8832039
WI,Buffalo ,2017,0,13105,6656,6449,50.7897749
WI,Buffalo ,2018,0,13114,6662,6452,50.80067104
WI,Buffalo ,2019,0,13031,6647,6384,51.00913207
WI,Burnett ,2015,0,15142,7708,7434,50.90476819
WI,Burnett ,2016,0,15222,7752,7470,50.92629089
WI,Burnett ,2017,0,15295,7813,7482,51.08205296
WI,Burnett ,2018,0,15374,7872,7502,51.2033303
WI,Burnett ,2019,0,15414,7887,7527,51.16776956
WI,Calumet ,2015,0,49818,24952,24866,50.08631418
WI,Calumet ,2016,0,49607,24880,24727,50.15421211
WI,Calumet ,2017,0,49995,25117,24878,50.2390239
WI,Calumet ,2018,0,50132,25234,24898,50.3351153
WI,Calumet ,2019,0,50089,25257,24832,50.42424484
WI,Chippewa ,2015,0,63421,32901,30520,51.87713849
WI,Chippewa ,2016,0,63523,32991,30532,51.93551942
WI,Chippewa ,2017,0,63747,33093,30654,51.9130312
WI,Chippewa ,2018,0,64109,33252,30857,51.86791246
WI,Chippewa ,2019,0,64658,33590,31068,51.95026138
WI,Clark ,2015,0,34358,17384,16974,50.59665871
WI,Clark ,2016,0,34485,17429,17056,50.54081485
WI,Clark ,2017,0,34571,17407,17164,50.35145064
WI,Clark ,2018,0,34705,17515,17190,50.46823224
WI,Clark ,2019,0,34774,17575,17199,50.54063381
WI,Columbia ,2015,0,56682,28856,27826,50.90857768
WI,Columbia ,2016,0,56875,29037,27838,51.05406593
WI,Columbia ,2017,0,57244,29261,27983,51.11627419
WI,Columbia ,2018,0,57333,29317,28016,51.13459962
WI,Columbia ,2019,0,57532,29402,28130,51.10547174
WI,Crawford ,2015,0,16328,8424,7904,51.59235669
WI,Crawford ,2016,0,16250,8429,7821,51.87076923
WI,Crawford ,2017,0,16199,8417,7782,51.95999753
WI,Crawford ,2018,0,16265,8456,7809,51.98893329
WI,Crawford ,2019,0,16131,8379,7752,51.9434629
WI,Dane ,2015,0,523000,259855,263145,49.68546845
WI,Dane ,2016,0,531296,264243,267053,49.73555231
WI,Dane ,2017,0,537453,267140,270313,49.7048114
WI,Dane ,2018,0,541948,269311,272637,49.69314399
WI,Dane ,2019,0,546695,271554,275141,49.67193773
WI,Dodge ,2015,0,87816,46374,41442,52.8081443
WI,Dodge ,2016,0,87382,46125,41257,52.78547069
WI,Dodge ,2017,0,87705,46357,41348,52.85559546
WI,Dodge ,2018,0,87833,46436,41397,52.86851183
WI,Dodge ,2019,0,87839,46381,41458,52.802286
WI,Door ,2015,0,27311,13458,13853,49.27684816
WI,Door ,2016,0,27338,13483,13855,49.31962836
WI,Door ,2017,0,27454,13547,13907,49.34435783
WI,Door ,2018,0,27589,13601,13988,49.29863351
WI,Door ,2019,0,27668,13684,13984,49.45785745
WI,Douglas ,2015,0,43495,21711,21784,49.91608231
WI,Douglas ,2016,0,43359,21725,21634,50.10493784
WI,Douglas ,2017,0,43328,21697,21631,50.07616322
WI,Douglas ,2018,0,43143,21602,21541,50.07069513
WI,Douglas ,2019,0,43150,21611,21539,50.0834299
WI,Dunn ,2015,0,44267,22307,21960,50.39193982
WI,Dunn ,2016,0,44354,22332,22022,50.34946115
WI,Dunn ,2017,0,44714,22450,22264,50.20798855
WI,Dunn ,2018,0,45091,22609,22482,50.14082633
WI,Dunn ,2019,0,45368,22753,22615,50.15208958
WI,Eau Claire ,2015,0,102080,50338,51742,49.31230408
WI,Eau Claire ,2016,0,102907,50680,52227,49.24835045
WI,Eau Claire ,2017,0,103582,51130,52452,49.36185824
WI,Eau Claire ,2018,0,104355,51530,52825,49.37952182
WI,Eau Claire ,2019,0,104646,51838,52808,49.53653269
WI,Florence ,2015,0,4338,2215,2123,51.0603965
WI,Florence ,2016,0,4313,2213,2100,51.30999304
WI,Florence ,2017,0,4335,2224,2111,51.30334487
WI,Florence ,2018,0,4294,2205,2089,51.35072194
WI,Florence ,2019,0,4295,2210,2085,51.45518044
WI,Fond du Lac ,2015,0,101955,50130,51825,49.16875092
WI,Fond du Lac ,2016,0,102211,50228,51983,49.14148184
WI,Fond du Lac ,2017,0,102417,50433,51984,49.24280149
WI,Fond du Lac ,2018,0,103001,50703,52298,49.22573567
WI,Fond du Lac ,2019,0,103403,50864,52539,49.19006218
WI,Forest ,2015,0,9004,4567,4437,50.72190138
WI,Forest ,2016,0,9021,4572,4449,50.6817426
WI,Forest ,2017,0,8969,4548,4421,50.7079942
WI,Forest ,2018,0,8977,4552,4425,50.70736326
WI,Forest ,2019,0,9004,4553,4451,50.56641493
WI,Grant ,2015,0,52071,27099,24972,52.04240364
WI,Grant ,2016,0,51985,27005,24980,51.94767721
WI,Grant ,2017,0,51728,26836,24892,51.8790597
WI,Grant ,2018,0,51444,26707,24737,51.91470337
WI,Grant ,2019,0,51439,26711,24728,51.92752581
WI,Green ,2015,0,36931,18332,18599,49.63851507
WI,Green ,2016,0,36787,18276,18511,49.68059369
WI,Green ,2017,0,36877,18319,18558,49.67594978
WI,Green ,2018,0,36924,18367,18557,49.74271477
WI,Green ,2019,0,36960,18370,18590,49.70238095
WI,Green Lake ,2015,0,18698,9394,9304,50.24066745
WI,Green Lake ,2016,0,18596,9342,9254,50.23661002
WI,Green Lake ,2017,0,18720,9367,9353,50.03739316
WI,Green Lake ,2018,0,18849,9471,9378,50.24669744
WI,Green Lake ,2019,0,18913,9508,9405,50.27229948
WI,Iowa ,2015,0,23585,11857,11728,50.27347891
WI,Iowa ,2016,0,23430,11740,11690,50.10670081
WI,Iowa ,2017,0,23676,11894,11782,50.23652644
WI,Iowa ,2018,0,23722,11891,11831,50.12646488
WI,Iowa ,2019,0,23678,11919,11759,50.33786637
WI,Iron ,2015,0,5727,2863,2864,49.99126943
WI,Iron ,2016,0,5660,2824,2836,49.89399293
WI,Iron ,2017,0,5675,2846,2829,50.14977974
WI,Iron ,2018,0,5687,2860,2827,50.2901354
WI,Iron ,2019,0,5687,2867,2820,50.41322314
WI,Jackson ,2015,0,20524,10968,9556,53.43987527
WI,Jackson ,2016,0,20484,10950,9534,53.45635618
WI,Jackson ,2017,0,20485,10911,9574,53.26336344
WI,Jackson ,2018,0,20472,10936,9536,53.41930442
WI,Jackson ,2019,0,20643,11053,9590,53.54357409
WI,Jefferson ,2015,0,84488,42160,42328,49.9005776
WI,Jefferson ,2016,0,84464,42205,42259,49.96803372
WI,Jefferson ,2017,0,84733,42381,42352,50.01711258
WI,Jefferson ,2018,0,85049,42486,42563,49.95473198
WI,Jefferson ,2019,0,84769,42370,42399,49.98289469
WI,Juneau ,2015,0,26307,13923,12384,52.92507698
WI,Juneau ,2016,0,26345,13979,12366,53.06130195
WI,Juneau ,2017,0,26460,14075,12385,53.19349962
WI,Juneau ,2018,0,26593,14134,12459,53.14932501
WI,Juneau ,2019,0,26687,14224,12463,53.29935924
WI,Kenosha ,2015,0,167910,83049,84861,49.46042523
WI,Kenosha ,2016,0,167867,83048,84819,49.47249906
WI,Kenosha ,2017,0,168356,83276,85080,49.46423056
WI,Kenosha ,2018,0,168926,83630,85296,49.50688467
WI,Kenosha ,2019,0,169561,83854,85707,49.45358897
WI,Kewaunee ,2015,0,20324,10285,10039,50.60519583
WI,Kewaunee ,2016,0,20380,10331,10049,50.69185476
WI,Kewaunee ,2017,0,20401,10336,10065,50.66418313
WI,Kewaunee ,2018,0,20395,10345,10050,50.72321647
WI,Kewaunee ,2019,0,20434,10387,10047,50.83194676
WI,La Crosse ,2015,0,117699,57548,60151,48.8942132
WI,La Crosse ,2016,0,117681,57402,60279,48.77762765
WI,La Crosse ,2017,0,118033,57550,60483,48.75755085
WI,La Crosse ,2018,0,118041,57580,60461,48.7796613
WI,La Crosse ,2019,0,118016,57548,60468,48.76287961
WI,Lafayette ,2015,0,16791,8485,8306,50.53302364
WI,Lafayette ,2016,0,16757,8440,8317,50.3670108
WI,Lafayette ,2017,0,16689,8428,8261,50.50032956
WI,Lafayette ,2018,0,16672,8438,8234,50.61180422
WI,Lafayette ,2019,0,16665,8432,8233,50.59705971
WI,Langlade ,2015,0,19048,9615,9433,50.47774045
WI,Langlade ,2016,0,19083,9608,9475,50.3484777
WI,Langlade ,2017,0,19175,9642,9533,50.28422425
WI,Langlade ,2018,0,19236,9702,9534,50.43668122
WI,Langlade ,2019,0,19189,9670,9519,50.39345458
WI,Lincoln ,2015,0,27867,14082,13785,50.53288836
WI,Lincoln ,2016,0,27834,14075,13759,50.56765107
WI,Lincoln ,2017,0,27751,14038,13713,50.58556448
WI,Lincoln ,2018,0,27673,14004,13669,50.60528313
WI,Lincoln ,2019,0,27593,13980,13613,50.66502374
WI,Manitowoc ,2015,0,79483,39640,39843,49.87229974
WI,Manitowoc ,2016,0,79348,39581,39767,49.88279478
WI,Manitowoc ,2017,0,79099,39441,39658,49.86283012
WI,Manitowoc ,2018,0,79015,39503,39512,49.99430488
WI,Manitowoc ,2019,0,78981,39477,39504,49.98290728
WI,Marathon ,2015,0,135314,67881,67433,50.16554089
WI,Marathon ,2016,0,135101,67902,67199,50.26017572
WI,Marathon ,2017,0,135452,68054,67398,50.2421522
WI,Marathon ,2018,0,135421,67982,67439,50.20048589
WI,Marathon ,2019,0,135692,68158,67534,50.22993249
WI,Marinette ,2015,0,40649,20364,20285,50.09717336
WI,Marinette ,2016,0,40255,20151,20104,50.05837784
WI,Marinette ,2017,0,40300,20206,20094,50.13895782
WI,Marinette ,2018,0,40402,20288,20114,50.21533587
WI,Marinette ,2019,0,40350,20292,20058,50.28996283
WI,Marquette ,2015,0,15119,7652,7467,50.61181295
WI,Marquette ,2016,0,15130,7650,7480,50.56179775
WI,Marquette ,2017,0,15280,7767,7513,50.83115183
WI,Marquette ,2018,0,15418,7862,7556,50.99234661
WI,Marquette ,2019,0,15574,7915,7659,50.82188262
WI,Menominee ,2015,0,4509,2220,2289,49.23486361
WI,Menominee ,2016,0,4527,2258,2269,49.87850674
WI,Menominee ,2017,0,4599,2282,2317,49.6194825
WI,Menominee ,2018,0,4595,2284,2311,49.70620239
WI,Menominee ,2019,0,4556,2267,2289,49.75856014
WI,Milwaukee ,2015,0,958421,463436,494985,48.35411578
WI,Milwaukee ,2016,0,954841,462115,492726,48.39706297
WI,Milwaukee ,2017,0,950172,460010,490162,48.4133399
WI,Milwaukee ,2018,0,946969,458625,488344,48.43083565
WI,Milwaukee ,2019,0,945726,457789,487937,48.40609225
WI,Monroe ,2015,0,45322,22946,22376,50.62883368
WI,Monroe ,2016,0,45423,22993,22430,50.61973009
WI,Monroe ,2017,0,45715,23146,22569,50.63108389
WI,Monroe ,2018,0,46141,23342,22799,50.58841378
WI,Monroe ,2019,0,46253,23467,22786,50.73616846
WI,Oconto ,2015,0,37472,19160,18312,51.13151153
WI,Oconto ,2016,0,37475,19152,18323,51.10607071
WI,Oconto ,2017,0,37531,19171,18360,51.08044017
WI,Oconto ,2018,0,37824,19386,18438,51.25317259
WI,Oconto ,2019,0,37930,19471,18459,51.33403638
WI,Oneida ,2015,0,35303,17677,17626,50.07223182
WI,Oneida ,2016,0,35329,17681,17648,50.04670384
WI,Oneida ,2017,0,35236,17646,17590,50.07946418
WI,Oneida ,2018,0,35444,17798,17646,50.21442275
WI,Oneida ,2019,0,35595,17852,17743,50.15311139
WI,Outagamie ,2015,0,183328,91450,91878,49.88326933
WI,Outagamie ,2016,0,184593,92214,92379,49.95530708
WI,Outagamie ,2017,0,185816,92899,92917,49.9951565
WI,Outagamie ,2018,0,186879,93396,93483,49.97672291
WI,Outagamie ,2019,0,187885,93922,93963,49.98908907
WI,Ozaukee ,2015,0,87932,43273,44659,49.21189101
WI,Ozaukee ,2016,0,88332,43444,44888,49.18262917
WI,Ozaukee ,2017,0,88443,43574,44869,49.26789005
WI,Ozaukee ,2018,0,89059,43782,45277,49.16066877
WI,Ozaukee ,2019,0,89221,43904,45317,49.20814606
WI,Pepin ,2015,0,7237,3652,3585,50.46289899
WI,Pepin ,2016,0,7250,3660,3590,50.48275862
WI,Pepin ,2017,0,7246,3680,3566,50.78664091
WI,Pepin ,2018,0,7304,3732,3572,51.09529025
WI,Pepin ,2019,0,7287,3693,3594,50.67929189
WI,Pierce ,2015,0,41069,20461,20608,49.8210329
WI,Pierce ,2016,0,41456,20670,20786,49.86009263
WI,Pierce ,2017,0,42016,20951,21065,49.8643374
WI,Pierce ,2018,0,42592,21241,21351,49.87086777
WI,Pierce ,2019,0,42754,21276,21478,49.76376479
WI,Polk ,2015,0,43218,21794,21424,50.42806238
WI,Polk ,2016,0,43224,21771,21453,50.36785119
WI,Polk ,2017,0,43397,21872,21525,50.39979722
WI,Polk ,2018,0,43568,21935,21633,50.34658465
WI,Polk ,2019,0,43783,22063,21720,50.39170454
WI,Portage ,2015,0,70520,35472,35048,50.30062394
WI,Portage ,2016,0,70451,35485,34966,50.36834112
WI,Portage ,2017,0,70565,35587,34978,50.43151704
WI,Portage ,2018,0,70850,35724,35126,50.42201835
WI,Portage ,2019,0,70772,35740,35032,50.50019782
WI,Price ,2015,0,13578,6911,6667,50.8985123
WI,Price ,2016,0,13413,6846,6567,51.04003579
WI,Price ,2017,0,13380,6818,6562,50.95665172
WI,Price ,2018,0,13357,6822,6535,51.07434304
WI,Price ,2019,0,13351,6829,6522,51.14972661
WI,Racine ,2015,0,194672,96274,98398,49.454467
WI,Racine ,2016,0,194846,96383,98463,49.46624514
WI,Racine ,2017,0,195825,96981,98844,49.52432018
WI,Racine ,2018,0,196357,97259,99098,49.53172028
WI,Racine ,2019,0,196311,97344,98967,49.5866253
WI,Richland ,2015,0,17574,8858,8716,50.40400592
WI,Richland ,2016,0,17556,8824,8732,50.26201868
WI,Richland ,2017,0,17517,8801,8716,50.24262145
WI,Richland ,2018,0,17397,8757,8640,50.33626487
WI,Richland ,2019,0,17252,8704,8548,50.45212149
WI,Rock ,2015,0,161006,79153,81853,49.16152193
WI,Rock ,2016,0,161320,79511,81809,49.28775105
WI,Rock ,2017,0,162205,79882,82323,49.2475571
WI,Rock ,2018,0,162874,80271,82603,49.28410919
WI,Rock ,2019,0,163354,80510,82844,49.2856006
WI,Rusk ,2015,0,14124,7099,7025,50.26196545
WI,Rusk ,2016,0,14101,7143,6958,50.65598185
WI,Rusk ,2017,0,14148,7160,6988,50.60785977
WI,Rusk ,2018,0,14110,7165,6945,50.77958894
WI,Rusk ,2019,0,14178,7212,6966,50.86754126
WI,St. Croix ,2015,0,87129,43477,43652,49.89957419
WI,St. Croix ,2016,0,87598,43728,43870,49.91894792
WI,St. Croix ,2017,0,88560,44232,44328,49.94579946
WI,St. Croix ,2018,0,89688,44823,44865,49.9765855
WI,St. Croix ,2019,0,90687,45345,45342,50.00165404
WI,Sauk ,2015,0,63271,31538,31733,49.84590097
WI,Sauk ,2016,0,63614,31731,31883,49.88052944
WI,Sauk ,2017,0,63967,31862,32105,49.81005831
WI,Sauk ,2018,0,64318,32037,32281,49.81031748
WI,Sauk ,2019,0,64442,32086,32356,49.7905093
WI,Sawyer ,2015,0,16288,8297,7991,50.93934185
WI,Sawyer ,2016,0,16320,8298,8022,50.84558824
WI,Sawyer ,2017,0,16367,8344,8023,50.98063176
WI,Sawyer ,2018,0,16464,8412,8052,51.09329446
WI,Sawyer ,2019,0,16558,8483,8075,51.23203285
WI,Shawano ,2015,0,41051,20497,20554,49.93057416
WI,Shawano ,2016,0,40952,20488,20464,50.0293026
WI,Shawano ,2017,0,40846,20450,20396,50.06610194
WI,Shawano ,2018,0,40771,20428,20343,50.10424076
WI,Shawano ,2019,0,40899,20617,20282,50.40954547
WI,Sheboygan ,2015,0,115196,57911,57285,50.27171082
WI,Sheboygan ,2016,0,115030,57839,57191,50.28166565
WI,Sheboygan ,2017,0,115089,57900,57189,50.30889138
WI,Sheboygan ,2018,0,115233,58041,57192,50.36838406
WI,Sheboygan ,2019,0,115340,58166,57174,50.43003295
WI,Taylor ,2015,0,20314,10336,9978,50.8811657
WI,Taylor ,2016,0,20290,10307,9983,50.79842287
WI,Taylor ,2017,0,20314,10317,9997,50.78763414
WI,Taylor ,2018,0,20364,10377,9987,50.95757219
WI,Taylor ,2019,0,20343,10347,9996,50.86270462
WI,Trempealeau ,2015,0,29441,14902,14539,50.61648721
WI,Trempealeau ,2016,0,29540,14950,14590,50.60934326
WI,Trempealeau ,2017,0,29372,14899,14473,50.72518044
WI,Trempealeau ,2018,0,29494,14983,14511,50.80016274
WI,Trempealeau ,2019,0,29649,15007,14642,50.61553509
WI,Vernon ,2015,0,30317,15150,15167,49.97196293
WI,Vernon ,2016,0,30553,15318,15235,50.13582954
WI,Vernon ,2017,0,30702,15444,15258,50.30291186
WI,Vernon ,2018,0,30772,15509,15263,50.39971403
WI,Vernon ,2019,0,30822,15548,15274,50.4444877
WI,Vilas ,2015,0,21447,10872,10575,50.69240453
WI,Vilas ,2016,0,21500,10899,10601,50.69302326
WI,Vilas ,2017,0,21684,10997,10687,50.71481277
WI,Vilas ,2018,0,21928,11123,10805,50.72510033
WI,Vilas ,2019,0,22195,11267,10928,50.76368551
WI,Walworth ,2015,0,102475,51200,51275,49.96340571
WI,Walworth ,2016,0,102627,51217,51410,49.90597016
WI,Walworth ,2017,0,102850,51275,51575,49.85415654
WI,Walworth ,2018,0,103550,51691,51859,49.91887977
WI,Walworth ,2019,0,103868,51928,51940,49.99422344
WI,Washburn ,2015,0,15522,7733,7789,49.81961087
WI,Washburn ,2016,0,15621,7750,7871,49.61270085
WI,Washburn ,2017,0,15739,7814,7925,49.64737277
WI,Washburn ,2018,0,15837,7853,7984,49.58641157
WI,Washburn ,2019,0,15720,7791,7929,49.5610687
WI,Washington ,2015,0,133906,66603,67303,49.73862262
WI,Washington ,2016,0,134310,66799,67511,49.73494155
WI,Washington ,2017,0,134930,67072,67858,49.70873786
WI,Washington ,2018,0,135445,67275,68170,49.66960759
WI,Washington ,2019,0,136034,67598,68436,49.69198877
WI,Waukesha ,2015,0,396237,194909,201328,49.19000497
WI,Waukesha ,2016,0,398521,195859,202662,49.14646907
WI,Waukesha ,2017,0,400899,197103,203796,49.1652511
WI,Waukesha ,2018,0,402522,197976,204546,49.18389554
WI,Waukesha ,2019,0,404198,198880,205318,49.20360813
WI,Waupaca ,2015,0,51680,26182,25498,50.66176471
WI,Waupaca ,2016,0,51306,26018,25288,50.71141777
WI,Waupaca ,2017,0,51118,25918,25200,50.70229665
WI,Waupaca ,2018,0,51130,25974,25156,50.79992177
WI,Waupaca ,2019,0,50990,25865,25125,50.72563248
WI,Waushara ,2015,0,23959,12625,11334,52.6941859
WI,Waushara ,2016,0,24103,12695,11408,52.66979214
WI,Waushara ,2017,0,24193,12757,11436,52.73012855
WI,Waushara ,2018,0,24267,12792,11475,52.71356163
WI,Waushara ,2019,0,24443,12867,11576,52.64083787
WI,Winnebago ,2015,0,169246,85219,84027,50.35215012
WI,Winnebago ,2016,0,169629,85354,84275,50.31804703
WI,Winnebago ,2017,0,170394,85765,84629,50.33334507
WI,Winnebago ,2018,0,170878,85991,84887,50.32303749
WI,Winnebago ,2019,0,171907,86428,85479,50.27602134
WI,Wood ,2015,0,73350,36145,37205,49.27743695
WI,Wood ,2016,0,73219,36001,37218,49.16893156
WI,Wood ,2017,0,73038,35887,37151,49.13469701
WI,Wood ,2018,0,72954,35910,37044,49.22279793
WI,Wood ,2019,0,72999,35951,37048,49.24861984
WY,Albany ,2015,0,37960,19918,18042,52.47102213
WY,Albany ,2016,0,37923,19849,18074,52.34026844
WY,Albany ,2017,0,38459,20016,18443,52.04503497
WY,Albany ,2018,0,38728,20120,18608,51.95207602
WY,Albany ,2019,0,38880,20143,18737,51.80812757
WY,Big Horn ,2015,0,11945,5997,5948,50.20510674
WY,Big Horn ,2016,0,11941,5981,5960,50.08793233
WY,Big Horn ,2017,0,11859,5903,5956,49.77654102
WY,Big Horn ,2018,0,11877,5945,5932,50.05472762
WY,Big Horn ,2019,0,11790,5912,5878,50.14418999
WY,Campbell ,2015,0,49258,25634,23624,52.04027772
WY,Campbell ,2016,0,48745,25283,23462,51.86788389
WY,Campbell ,2017,0,46402,23937,22465,51.58613853
WY,Campbell ,2018,0,46299,23885,22414,51.58858723
WY,Campbell ,2019,0,46341,23831,22510,51.42530373
WY,Carbon ,2015,0,15613,8433,7180,54.01268174
WY,Carbon ,2016,0,15689,8448,7241,53.84664415
WY,Carbon ,2017,0,15252,8178,7074,53.61919748
WY,Carbon ,2018,0,14879,7957,6922,53.47805632
WY,Carbon ,2019,0,14800,7877,6923,53.22297297
WY,Converse ,2015,0,14297,7282,7015,50.93376233
WY,Converse ,2016,0,14094,7137,6957,50.6385696
WY,Converse ,2017,0,13733,6973,6760,50.77550426
WY,Converse ,2018,0,13658,6938,6720,50.79806707
WY,Converse ,2019,0,13822,7066,6756,51.12140067
WY,Crook ,2015,0,7435,3809,3626,51.23066577
WY,Crook ,2016,0,7499,3831,3668,51.08681157
WY,Crook ,2017,0,7397,3788,3609,51.20994998
WY,Crook ,2018,0,7445,3775,3670,50.70517126
WY,Crook ,2019,0,7584,3837,3747,50.59335443
WY,Fremont ,2015,0,40219,20124,20095,50.03605261
WY,Fremont ,2016,0,40200,20178,20022,50.19402985
WY,Fremont ,2017,0,39818,19990,19828,50.20342559
WY,Fremont ,2018,0,39561,19846,19715,50.1655671
WY,Fremont ,2019,0,39261,19730,19531,50.25343216
WY,Goshen ,2015,0,13542,7097,6445,52.40732536
WY,Goshen ,2016,0,13306,6949,6357,52.22456035
WY,Goshen ,2017,0,13361,6977,6384,52.21914527
WY,Goshen ,2018,0,13292,6973,6319,52.46012639
WY,Goshen ,2019,0,13211,6946,6265,52.57739762
WY,Hot Springs ,2015,0,4716,2385,2331,50.57251908
WY,Hot Springs ,2016,0,4654,2355,2299,50.601633
WY,Hot Springs ,2017,0,4686,2388,2298,50.9603073
WY,Hot Springs ,2018,0,4568,2307,2261,50.50350263
WY,Hot Springs ,2019,0,4413,2227,2186,50.4645366
WY,Johnson ,2015,0,8611,4391,4220,50.99291604
WY,Johnson ,2016,0,8484,4316,4168,50.87223008
WY,Johnson ,2017,0,8447,4268,4179,50.52681425
WY,Johnson ,2018,0,8446,4253,4193,50.35519773
WY,Johnson ,2019,0,8445,4255,4190,50.3848431
WY,Laramie ,2015,0,96969,49042,47927,50.57492601
WY,Laramie ,2016,0,97887,49704,48183,50.77691624
WY,Laramie ,2017,0,98377,49952,48425,50.77609604
WY,Laramie ,2018,0,98865,50159,48706,50.73484044
WY,Laramie ,2019,0,99500,50413,49087,50.66633166
WY,Lincoln ,2015,0,18747,9578,9169,51.0908412
WY,Lincoln ,2016,0,19072,9742,9330,51.08011745
WY,Lincoln ,2017,0,19278,9806,9472,50.86627243
WY,Lincoln ,2018,0,19445,9918,9527,51.00539985
WY,Lincoln ,2019,0,19830,10104,9726,50.95310136
WY,Natrona ,2015,0,82137,41566,40571,50.60569536
WY,Natrona ,2016,0,80909,40829,40080,50.46286569
WY,Natrona ,2017,0,79586,40077,39509,50.35684668
WY,Natrona ,2018,0,79175,39876,39299,50.3643827
WY,Natrona ,2019,0,79858,40251,39607,50.40321571
WY,Niobrara ,2015,0,2496,1159,1337,46.43429487
WY,Niobrara ,2016,0,2468,1150,1318,46.59643436
WY,Niobrara ,2017,0,2392,1099,1293,45.94481605
WY,Niobrara ,2018,0,2400,1090,1310,45.41666667
WY,Niobrara ,2019,0,2356,1078,1278,45.75551783
WY,Park ,2015,0,28928,14428,14500,49.8755531
WY,Park ,2016,0,29213,14555,14658,49.82370862
WY,Park ,2017,0,29194,14585,14609,49.95889566
WY,Park ,2018,0,29210,14539,14671,49.77404998
WY,Park ,2019,0,29194,14527,14667,49.7602247
WY,Platte ,2015,0,8798,4459,4339,50.68197318
WY,Platte ,2016,0,8662,4388,4274,50.65804664
WY,Platte ,2017,0,8541,4318,4223,50.55614097
WY,Platte ,2018,0,8516,4274,4242,50.18788163
WY,Platte ,2019,0,8393,4221,4172,50.29190992
WY,Sheridan ,2015,0,29883,14954,14929,50.0418298
WY,Sheridan ,2016,0,29964,15049,14915,50.22360166
WY,Sheridan ,2017,0,30147,15145,15002,50.23717119
WY,Sheridan ,2018,0,30219,15148,15071,50.12740329
WY,Sheridan ,2019,0,30485,15282,15203,50.12957192
WY,Sublette ,2015,0,10044,5399,4645,53.75348467
WY,Sublette ,2016,0,9982,5358,4624,53.67661791
WY,Sublette ,2017,0,9745,5240,4505,53.7711647
WY,Sublette ,2018,0,9798,5285,4513,53.93957951
WY,Sublette ,2019,0,9831,5269,4562,53.59576849
WY,Sweetwater ,2015,0,44719,23162,21557,51.79453923
WY,Sweetwater ,2016,0,44222,22873,21349,51.72312424
WY,Sweetwater ,2017,0,43464,22438,21026,51.62433278
WY,Sweetwater ,2018,0,42858,22053,20805,51.45597088
WY,Sweetwater ,2019,0,42343,21808,20535,51.50320006
WY,Teton ,2015,0,23047,11936,11111,51.7898208
WY,Teton ,2016,0,23234,12033,11201,51.79047947
WY,Teton ,2017,0,23384,12133,11251,51.88590489
WY,Teton ,2018,0,23269,12023,11246,51.66960333
WY,Teton ,2019,0,23464,12142,11322,51.74735765
WY,Uinta ,2015,0,20763,10503,10260,50.58517555
WY,Uinta ,2016,0,20682,10476,10206,50.65274151
WY,Uinta ,2017,0,20431,10339,10092,50.60447359
WY,Uinta ,2018,0,20292,10301,9991,50.76384782
WY,Uinta ,2019,0,20226,10224,10002,50.54879858
WY,Washakie ,2015,0,8278,4191,4087,50.62817106
WY,Washakie ,2016,0,8165,4125,4040,50.52051439
WY,Washakie ,2017,0,8010,4055,3955,50.62421973
WY,Washakie ,2018,0,7877,3984,3893,50.57763108
WY,Washakie ,2019,0,7805,3963,3842,50.77514414
WY,Weston ,2015,0,7208,3799,3409,52.70532741
WY,Weston ,2016,0,7220,3788,3432,52.46537396
WY,Weston ,2017,0,6968,3660,3308,52.52583238
WY,Weston ,2018,0,6924,3627,3297,52.3830156
WY,Weston ,2019,0,6927,3624,3303,52.31702036
